,period,pct,trimethoprim_items,nitrofurantoin_items,all_items,trimethoprim_percent
0,2011-01-01,00C,731,258,989,0.7391304347826086
1,2011-01-01,00D,2050,751,2801,0.7318814709032488
2,2011-01-01,00F,26,11,37,0.7027027027027027
3,2011-01-01,00J,1566,639,2205,0.710204081632653
4,2011-01-01,00K,2065,805,2870,0.7195121951219512
5,2011-01-01,00L,2272,1285,3557,0.6387405116671352
6,2011-01-01,00M,1730,582,2312,0.7482698961937716
7,2011-01-01,00N,1059,512,1571,0.6740929344366645
8,2011-01-01,00P,1716,450,2166,0.7922437673130194
9,2011-01-01,00Q,947,233,1180,0.8025423728813559
10,2011-01-01,00R,1123,197,1320,0.8507575757575757
11,2011-01-01,00T,1627,651,2278,0.7142230026338894
12,2011-01-01,00V,1205,452,1657,0.7272178636089318
13,2011-01-01,00W,53,30,83,0.6385542168674698
14,2011-01-01,00X,826,115,941,0.8777895855472901
15,2011-01-01,00Y,1570,567,2137,0.7346747777257838
16,2011-01-01,01A,2327,804,3131,0.7432130309805174
17,2011-01-01,01C,1280,513,1793,0.7138873396542108
18,2011-01-01,01D,1489,442,1931,0.7711030554117038
19,2011-01-01,01E,902,89,991,0.9101917255297679
20,2011-01-01,01F,789,274,1063,0.742238946378175
21,2011-01-01,01G,1076,891,1967,0.547025927808846
22,2011-01-01,01H,2166,385,2551,0.849078792630341
23,2011-01-01,01J,926,299,1225,0.7559183673469387
24,2011-01-01,01K,1978,623,2601,0.760476739715494
25,2011-01-01,01N,21,8,29,0.7241379310344828
26,2011-01-01,01R,1016,414,1430,0.7104895104895105
27,2011-01-01,01T,784,288,1072,0.7313432835820896
28,2011-01-01,01V,743,192,935,0.7946524064171123
29,2011-01-01,01W,1710,536,2246,0.761353517364203
30,2011-01-01,01X,1429,480,1909,0.748559455212153
31,2011-01-01,01Y,1424,343,1767,0.8058856819468024
32,2011-01-01,02A,1310,511,1821,0.7193849533223503
33,2011-01-01,02D,571,268,839,0.6805721096543504
34,2011-01-01,02E,1036,312,1348,0.7685459940652819
35,2011-01-01,02F,1560,392,1952,0.7991803278688525
36,2011-01-01,02G,569,139,708,0.8036723163841808
37,2011-01-01,02H,1738,1024,2762,0.6292541636495294
38,2011-01-01,02M,809,205,1014,0.7978303747534516
39,2011-01-01,02N,1047,349,1396,0.75
40,2011-01-01,02P,1166,725,1891,0.6166049709148599
41,2011-01-01,02Q,521,138,659,0.7905918057663126
42,2011-01-01,02R,1867,433,2300,0.8117391304347826
43,2011-01-01,02T,883,295,1178,0.7495755517826825
44,2011-01-01,02V,1227,411,1638,0.7490842490842491
45,2011-01-01,02W,582,109,691,0.8422575976845152
46,2011-01-01,02X,1354,325,1679,0.806432400238237
47,2011-01-01,02Y,1760,519,2279,0.7722685388328214
48,2011-01-01,03A,1101,260,1361,0.8089639970609845
49,2011-01-01,03C,1838,725,2563,0.7171283651970347
50,2011-01-01,03D,792,213,1005,0.7880597014925373
51,2011-01-01,03E,831,304,1135,0.73215859030837
52,2011-01-01,03F,1561,277,1838,0.8492927094668118
53,2011-01-01,03G,1481,434,1915,0.7733681462140992
54,2011-01-01,03H,1186,327,1513,0.7838730998017185
55,2011-01-01,03J,941,203,1144,0.8225524475524476
56,2011-01-01,03K,899,182,1081,0.8316373728029602
57,2011-01-01,03L,1223,624,1847,0.6621548456957228
58,2011-01-01,03M,782,280,1062,0.736346516007533
59,2011-01-01,03N,3101,637,3738,0.8295880149812734
60,2011-01-01,03Q,1708,680,2388,0.7152428810720268
61,2011-01-01,03R,2111,451,2562,0.8239656518345043
62,2011-01-01,03T,1715,360,2075,0.8265060240963855
63,2011-01-01,03V,284,161,445,0.6382022471910113
64,2011-01-01,03W,1950,954,2904,0.6714876033057852
65,2011-01-01,03X,489,104,593,0.8246205733558178
66,2011-01-01,03Y,558,237,795,0.7018867924528301
67,2011-01-01,04C,1860,777,2637,0.7053469852104665
68,2011-01-01,04D,1416,425,1841,0.7691472026072786
69,2011-01-01,04E,1001,232,1233,0.8118410381184104
70,2011-01-01,04F,1489,748,2237,0.6656236030397854
71,2011-01-01,04G,3957,1403,5360,0.7382462686567164
72,2011-01-01,04H,653,191,844,0.773696682464455
73,2011-01-01,04J,1812,744,2556,0.7089201877934272
74,2011-01-01,04K,1646,389,2035,0.8088452088452088
75,2011-01-01,04L,829,214,1043,0.7948226270373921
76,2011-01-01,04M,490,100,590,0.8305084745762712
77,2011-01-01,04N,661,167,828,0.7983091787439613
78,2011-01-01,04Q,728,209,937,0.7769477054429029
79,2011-01-01,04R,2506,857,3363,0.7451680047576569
80,2011-01-01,04V,2053,948,3001,0.6841052982339221
81,2011-01-01,04X,1380,700,2080,0.6634615384615384
82,2011-01-01,04Y,709,197,906,0.782560706401766
83,2011-01-01,05A,2480,917,3397,0.730055931704445
84,2011-01-01,05C,1102,1211,2313,0.4764375270211846
85,2011-01-01,05D,678,284,962,0.7047817047817048
86,2011-01-01,05F,1166,337,1503,0.7757817697937458
87,2011-01-01,05G,1123,414,1537,0.730644111906311
88,2011-01-01,05H,991,336,1327,0.7467972871137905
89,2011-01-01,05J,1203,305,1508,0.7977453580901857
90,2011-01-01,05L,2366,802,3168,0.7468434343434344
91,2011-01-01,05N,1971,430,2401,0.8209079550187421
92,2011-01-01,05P,1254,186,1440,0.8708333333333333
93,2011-01-01,05Q,1214,281,1495,0.8120401337792642
94,2011-01-01,05R,1680,659,2339,0.718255664814023
95,2011-01-01,05T,1980,580,2560,0.7734375
96,2011-01-01,05V,914,269,1183,0.7726120033812341
97,2011-01-01,05W,1297,514,1811,0.7161789066813915
98,2011-01-01,05X,1148,266,1414,0.8118811881188119
99,2011-01-01,05Y,1551,541,2092,0.7413957934990439
100,2011-01-01,06A,1567,357,1924,0.8144490644490644
101,2011-01-01,06D,764,268,1032,0.7403100775193798
102,2011-01-01,06F,1929,1555,3484,0.5536739380022963
103,2011-01-01,06H,5018,1824,6842,0.7334112832505115
104,2011-01-01,06K,3016,1172,4188,0.720152817574021
105,2011-01-01,06L,2326,776,3102,0.749838813668601
106,2011-01-01,06M,1833,701,2534,0.72336227308603
107,2011-01-01,06N,3245,1209,4454,0.7285585990121239
108,2011-01-01,06P,976,467,1443,0.6763686763686764
109,2011-01-01,06Q,2281,931,3212,0.7101494396014943
110,2011-01-01,06T,2119,820,2939,0.7209935352160599
111,2011-01-01,06V,1477,384,1861,0.7936593229446535
112,2011-01-01,06W,1506,339,1845,0.816260162601626
113,2011-01-01,06Y,1271,286,1557,0.8163134232498395
114,2011-01-01,07G,875,265,1140,0.7675438596491229
115,2011-01-01,07H,1531,673,2204,0.6946460980036298
116,2011-01-01,07J,737,310,1047,0.7039159503342884
117,2011-01-01,07K,1361,598,1959,0.6947422154160285
118,2011-01-01,07L,785,151,936,0.8386752136752137
119,2011-01-01,07M,1199,472,1671,0.7175344105326152
120,2011-01-01,07N,1292,413,1705,0.7577712609970675
121,2011-01-01,07P,649,200,849,0.7644287396937574
122,2011-01-01,07Q,1755,576,2331,0.752895752895753
123,2011-01-01,07R,810,333,1143,0.7086614173228346
124,2011-01-01,07T,726,276,1002,0.7245508982035929
125,2011-01-01,07V,1669,564,2233,0.7474249888042992
126,2011-01-01,07W,899,439,1338,0.671898355754858
127,2011-01-01,07X,1152,356,1508,0.7639257294429708
128,2011-01-01,07Y,808,372,1180,0.6847457627118644
129,2011-01-01,08A,1264,481,1745,0.7243553008595989
130,2011-01-01,08C,524,192,716,0.7318435754189944
131,2011-01-01,08D,844,288,1132,0.7455830388692579
132,2011-01-01,08E,622,194,816,0.7622549019607843
133,2011-01-01,08F,1266,348,1614,0.7843866171003717
134,2011-01-01,08G,481,1064,1545,0.31132686084142397
135,2011-01-01,08H,848,365,1213,0.6990931574608409
136,2011-01-01,08J,724,278,1002,0.7225548902195609
137,2011-01-01,08K,922,206,1128,0.8173758865248227
138,2011-01-01,08L,912,444,1356,0.672566371681416
139,2011-01-01,08M,1031,280,1311,0.7864225781845919
140,2011-01-01,08N,1081,230,1311,0.8245614035087719
141,2011-01-01,08P,837,326,1163,0.7196904557179707
142,2011-01-01,08Q,802,154,956,0.8389121338912134
143,2011-01-01,08R,844,231,1075,0.7851162790697674
144,2011-01-01,08T,909,303,1212,0.75
145,2011-01-01,08V,1049,275,1324,0.7922960725075529
146,2011-01-01,08W,1139,240,1379,0.8259608411892676
147,2011-01-01,08X,1106,398,1504,0.7353723404255319
148,2011-01-01,08Y,674,251,925,0.7286486486486486
149,2011-01-01,09A,559,280,839,0.66626936829559
150,2011-01-01,09C,704,180,884,0.7963800904977375
151,2011-01-01,09D,1530,533,2063,0.7416383906931653
152,2011-01-01,09E,1342,295,1637,0.8197923029932804
153,2011-01-01,09F,1210,494,1704,0.710093896713615
154,2011-01-01,09G,2963,1288,4251,0.6970124676546695
155,2011-01-01,09H,597,159,756,0.7896825396825397
156,2011-01-01,09J,1461,505,1966,0.7431332655137335
157,2011-01-01,09L,719,424,1143,0.6290463692038495
158,2011-01-01,09N,1135,579,1714,0.6621936989498249
159,2011-01-01,09P,1144,525,1669,0.6854403834631516
160,2011-01-01,09W,1357,328,1685,0.8053412462908012
161,2011-01-01,09X,1129,482,1611,0.7008069522036002
162,2011-01-01,09Y,1698,970,2668,0.636431784107946
163,2011-01-01,10A,1008,393,1401,0.7194860813704497
164,2011-01-01,10C,450,290,740,0.6081081081081081
165,2011-01-01,10D,549,113,662,0.8293051359516617
166,2011-01-01,10E,680,170,850,0.8
167,2011-01-01,10G,623,237,860,0.7244186046511628
168,2011-01-01,10H,1641,522,2163,0.7586685159500693
169,2011-01-01,10J,988,853,1841,0.5366648560564911
170,2011-01-01,10K,1162,593,1755,0.6621082621082621
171,2011-01-01,10L,905,250,1155,0.7835497835497836
172,2011-01-01,10M,533,207,740,0.7202702702702702
173,2011-01-01,10N,434,204,638,0.6802507836990596
174,2011-01-01,10Q,2531,2211,4742,0.5337410375369043
175,2011-01-01,10R,1308,434,1742,0.7508610792192881
176,2011-01-01,10T,474,126,600,0.79
177,2011-01-01,10V,1200,643,1843,0.6511123168746609
178,2011-01-01,10W,539,172,711,0.7580872011251758
179,2011-01-01,10X,1208,478,1686,0.7164887307236062
180,2011-01-01,10Y,1105,491,1596,0.6923558897243107
181,2011-01-01,11A,3283,1453,4736,0.6932010135135135
182,2011-01-01,11C,824,218,1042,0.7907869481765835
183,2011-01-01,11D,625,276,901,0.6936736958934517
184,2011-01-01,11E,1210,401,1611,0.7510862818125388
185,2011-01-01,11H,2471,1061,3532,0.6996036240090601
186,2011-01-01,11J,4734,2081,6815,0.6946441672780631
187,2011-01-01,11M,3441,1491,4932,0.6976885644768857
188,2011-01-01,11N,3882,1061,4943,0.7853530244790613
189,2011-01-01,11T,1335,638,1973,0.676634566649772
190,2011-01-01,11X,3432,1437,4869,0.7048675292667899
191,2011-01-01,12A,1414,542,1956,0.7229038854805726
192,2011-01-01,12D,1128,342,1470,0.7673469387755102
193,2011-01-01,12F,2443,348,2791,0.8753135077033322
194,2011-01-01,13P,2907,966,3873,0.750580945003873
195,2011-01-01,13T,3003,1112,4115,0.7297691373025517
196,2011-01-01,14L,2852,1105,3957,0.7207480414455395
197,2011-01-01,99A,2676,542,3218,0.8315724052206339
198,2011-01-01,99C,1504,691,2195,0.6851936218678816
199,2011-01-01,99D,1080,365,1445,0.7474048442906575
200,2011-01-01,99E,1520,389,1909,0.7962283918281823
201,2011-01-01,99F,1159,238,1397,0.8296349319971367
202,2011-01-01,99G,911,221,1132,0.8047703180212014
203,2011-01-01,99H,1603,739,2342,0.6844577284372332
204,2011-01-01,99J,2852,952,3804,0.7497371188222923
205,2011-01-01,99K,1051,416,1467,0.7164280845262441
206,2011-01-01,99M,1032,661,1693,0.609568812758417
207,2011-01-01,99N,2600,1755,4355,0.5970149253731343
208,2011-01-01,99P,6044,1710,7754,0.7794686613360846
209,2011-01-01,99Q,1858,631,2489,0.7464845319405383
210,2011-02-01,00C,693,257,950,0.7294736842105263
211,2011-02-01,00D,1891,729,2620,0.7217557251908397
212,2011-02-01,00F,25,8,33,0.7575757575757576
213,2011-02-01,00J,1553,570,2123,0.7315120113047574
214,2011-02-01,00K,1982,783,2765,0.7168173598553346
215,2011-02-01,00L,2130,1182,3312,0.6431159420289855
216,2011-02-01,00M,1736,595,2331,0.7447447447447447
217,2011-02-01,00N,979,476,1455,0.672852233676976
218,2011-02-01,00P,1612,388,2000,0.806
219,2011-02-01,00Q,851,245,1096,0.7764598540145985
220,2011-02-01,00R,1041,230,1271,0.8190401258851299
221,2011-02-01,00T,1602,663,2265,0.7072847682119205
222,2011-02-01,00V,1158,484,1642,0.705237515225335
223,2011-02-01,00W,58,20,78,0.7435897435897436
224,2011-02-01,00X,787,132,919,0.8563656147986942
225,2011-02-01,00Y,1536,566,2102,0.730732635585157
226,2011-02-01,01A,2057,870,2927,0.7027673385719166
227,2011-02-01,01C,1271,509,1780,0.7140449438202248
228,2011-02-01,01D,1404,453,1857,0.7560581583198708
229,2011-02-01,01E,907,78,985,0.9208121827411168
230,2011-02-01,01F,778,282,1060,0.7339622641509433
231,2011-02-01,01G,1064,890,1954,0.5445240532241555
232,2011-02-01,01H,1905,429,2334,0.8161953727506427
233,2011-02-01,01J,927,317,1244,0.7451768488745981
234,2011-02-01,01K,2005,662,2667,0.7517810273715786
235,2011-02-01,01N,24,20,44,0.5454545454545454
236,2011-02-01,01R,874,432,1306,0.669218989280245
237,2011-02-01,01T,749,280,1029,0.7278911564625851
238,2011-02-01,01V,731,187,918,0.7962962962962963
239,2011-02-01,01W,1677,536,2213,0.7577948486217804
240,2011-02-01,01X,1344,488,1832,0.7336244541484717
241,2011-02-01,01Y,1320,404,1724,0.765661252900232
242,2011-02-01,02A,1229,512,1741,0.7059161401493395
243,2011-02-01,02D,499,289,788,0.633248730964467
244,2011-02-01,02E,1011,304,1315,0.7688212927756654
245,2011-02-01,02F,1465,387,1852,0.791036717062635
246,2011-02-01,02G,505,156,661,0.7639939485627837
247,2011-02-01,02H,1653,998,2651,0.6235382874387023
248,2011-02-01,02M,833,210,1043,0.7986577181208053
249,2011-02-01,02N,901,369,1270,0.7094488188976378
250,2011-02-01,02P,1055,680,1735,0.6080691642651297
251,2011-02-01,02Q,471,137,608,0.774671052631579
252,2011-02-01,02R,1769,463,2232,0.7925627240143369
253,2011-02-01,02T,836,292,1128,0.7411347517730497
254,2011-02-01,02V,1177,453,1630,0.7220858895705522
255,2011-02-01,02W,542,115,657,0.8249619482496194
256,2011-02-01,02X,1207,332,1539,0.7842755035737492
257,2011-02-01,02Y,1654,527,2181,0.7583677212287941
258,2011-02-01,03A,990,241,1231,0.8042242079610074
259,2011-02-01,03C,1693,735,2428,0.6972817133443163
260,2011-02-01,03D,697,211,908,0.7676211453744494
261,2011-02-01,03E,817,303,1120,0.7294642857142857
262,2011-02-01,03F,1478,337,1815,0.8143250688705234
263,2011-02-01,03G,1386,494,1880,0.7372340425531915
264,2011-02-01,03H,1052,325,1377,0.7639796659404503
265,2011-02-01,03J,885,202,1087,0.8141674333026679
266,2011-02-01,03K,903,173,1076,0.8392193308550185
267,2011-02-01,03L,1179,594,1773,0.6649746192893401
268,2011-02-01,03M,691,255,946,0.7304439746300211
269,2011-02-01,03N,2910,689,3599,0.8085579327590997
270,2011-02-01,03Q,1612,657,2269,0.7104451300132217
271,2011-02-01,03R,1917,453,2370,0.8088607594936709
272,2011-02-01,03T,1520,417,1937,0.7847186370676303
273,2011-02-01,03V,249,136,385,0.6467532467532467
274,2011-02-01,03W,1838,919,2757,0.6666666666666666
275,2011-02-01,03X,448,117,565,0.7929203539823009
276,2011-02-01,03Y,576,258,834,0.6906474820143885
277,2011-02-01,04C,1819,815,2634,0.690584662110858
278,2011-02-01,04D,1321,394,1715,0.7702623906705539
279,2011-02-01,04E,972,276,1248,0.7788461538461539
280,2011-02-01,04F,1384,765,2149,0.6440204746393672
281,2011-02-01,04G,3668,1377,5045,0.7270564915758176
282,2011-02-01,04H,683,180,863,0.7914252607184241
283,2011-02-01,04J,1698,731,2429,0.6990531082750103
284,2011-02-01,04K,1637,450,2087,0.7843794920939147
285,2011-02-01,04L,771,241,1012,0.7618577075098815
286,2011-02-01,04M,471,113,584,0.8065068493150684
287,2011-02-01,04N,661,191,852,0.7758215962441315
288,2011-02-01,04Q,721,253,974,0.7402464065708418
289,2011-02-01,04R,2332,826,3158,0.7384420519316023
290,2011-02-01,04V,1968,925,2893,0.6802627030763913
291,2011-02-01,04X,1283,678,1961,0.6542580316165222
292,2011-02-01,04Y,729,173,902,0.8082039911308204
293,2011-02-01,05A,2427,874,3301,0.7352317479551651
294,2011-02-01,05C,1046,1109,2155,0.4853828306264501
295,2011-02-01,05D,651,309,960,0.678125
296,2011-02-01,05F,1050,300,1350,0.7777777777777778
297,2011-02-01,05G,1095,387,1482,0.7388663967611336
298,2011-02-01,05H,976,320,1296,0.7530864197530864
299,2011-02-01,05J,1169,344,1513,0.7726371447455387
300,2011-02-01,05L,2305,750,3055,0.7545008183306056
301,2011-02-01,05N,1910,418,2328,0.820446735395189
302,2011-02-01,05P,1092,169,1261,0.865979381443299
303,2011-02-01,05Q,1118,287,1405,0.7957295373665481
304,2011-02-01,05R,1558,627,2185,0.7130434782608696
305,2011-02-01,05T,1754,493,2247,0.7805963506898086
306,2011-02-01,05V,852,310,1162,0.7332185886402753
307,2011-02-01,05W,1178,501,1679,0.7016081000595593
308,2011-02-01,05X,1094,233,1327,0.8244159758854559
309,2011-02-01,05Y,1447,510,1957,0.7393970362800204
310,2011-02-01,06A,1389,345,1734,0.801038062283737
311,2011-02-01,06D,722,238,960,0.7520833333333333
312,2011-02-01,06F,1560,1722,3282,0.4753199268738574
313,2011-02-01,06H,4824,1924,6748,0.7148784825133373
314,2011-02-01,06K,2875,1170,4045,0.7107540173053152
315,2011-02-01,06L,2122,752,2874,0.7383437717466945
316,2011-02-01,06M,1763,697,2460,0.7166666666666667
317,2011-02-01,06N,2946,1112,4058,0.7259733859043864
318,2011-02-01,06P,905,511,1416,0.6391242937853108
319,2011-02-01,06Q,2118,946,3064,0.6912532637075718
320,2011-02-01,06T,1958,746,2704,0.724112426035503
321,2011-02-01,06V,1314,380,1694,0.7756788665879575
322,2011-02-01,06W,1392,308,1700,0.8188235294117647
323,2011-02-01,06Y,1262,285,1547,0.8157724628312863
324,2011-02-01,07G,886,262,1148,0.7717770034843205
325,2011-02-01,07H,1528,687,2215,0.6898419864559819
326,2011-02-01,07J,649,328,977,0.6642784032753326
327,2011-02-01,07K,1288,540,1828,0.7045951859956237
328,2011-02-01,07L,706,174,880,0.8022727272727272
329,2011-02-01,07M,1166,532,1698,0.6866902237926973
330,2011-02-01,07N,1123,414,1537,0.730644111906311
331,2011-02-01,07P,672,201,873,0.7697594501718213
332,2011-02-01,07Q,1512,520,2032,0.7440944881889764
333,2011-02-01,07R,659,317,976,0.6752049180327869
334,2011-02-01,07T,614,273,887,0.6922209695603156
335,2011-02-01,07V,1581,530,2111,0.7489341544291804
336,2011-02-01,07W,973,462,1435,0.6780487804878049
337,2011-02-01,07X,1107,316,1423,0.7779339423752635
338,2011-02-01,07Y,819,346,1165,0.7030042918454935
339,2011-02-01,08A,1035,454,1489,0.6950973807924782
340,2011-02-01,08C,494,208,702,0.7037037037037037
341,2011-02-01,08D,774,291,1065,0.7267605633802817
342,2011-02-01,08E,551,184,735,0.7496598639455783
343,2011-02-01,08F,1267,380,1647,0.769277474195507
344,2011-02-01,08G,443,1089,1532,0.2891644908616188
345,2011-02-01,08H,822,369,1191,0.690176322418136
346,2011-02-01,08J,735,296,1031,0.7129000969932104
347,2011-02-01,08K,930,199,1129,0.8237378210806023
348,2011-02-01,08L,943,425,1368,0.689327485380117
349,2011-02-01,08M,1018,274,1292,0.7879256965944272
350,2011-02-01,08N,997,205,1202,0.829450915141431
351,2011-02-01,08P,758,310,1068,0.7097378277153558
352,2011-02-01,08Q,834,167,1001,0.8331668331668332
353,2011-02-01,08R,786,233,1019,0.7713444553483808
354,2011-02-01,08T,817,275,1092,0.7481684981684982
355,2011-02-01,08V,900,253,1153,0.7805724197745013
356,2011-02-01,08W,937,247,1184,0.7913851351351351
357,2011-02-01,08X,1074,384,1458,0.7366255144032922
358,2011-02-01,08Y,684,243,927,0.7378640776699029
359,2011-02-01,09A,568,277,845,0.672189349112426
360,2011-02-01,09C,673,209,882,0.7630385487528345
361,2011-02-01,09D,1353,570,1923,0.7035881435257411
362,2011-02-01,09E,1227,275,1502,0.8169107856191744
363,2011-02-01,09F,1195,485,1680,0.7113095238095238
364,2011-02-01,09G,2903,1298,4201,0.691025946203285
365,2011-02-01,09H,538,182,720,0.7472222222222222
366,2011-02-01,09J,1457,483,1940,0.7510309278350515
367,2011-02-01,09L,747,351,1098,0.680327868852459
368,2011-02-01,09N,1133,603,1736,0.6526497695852534
369,2011-02-01,09P,1118,501,1619,0.6905497220506486
370,2011-02-01,09W,1297,354,1651,0.7855844942459116
371,2011-02-01,09X,1034,412,1446,0.715076071922545
372,2011-02-01,09Y,1612,975,2587,0.6231155778894473
373,2011-02-01,10A,1015,405,1420,0.7147887323943662
374,2011-02-01,10C,453,247,700,0.6471428571428571
375,2011-02-01,10D,592,137,729,0.8120713305898491
376,2011-02-01,10E,727,176,903,0.805094130675526
377,2011-02-01,10G,610,231,841,0.7253269916765755
378,2011-02-01,10H,1481,542,2023,0.7320810677212062
379,2011-02-01,10J,959,794,1753,0.547062179121506
380,2011-02-01,10K,1108,521,1629,0.6801718845917741
381,2011-02-01,10L,832,244,1076,0.7732342007434945
382,2011-02-01,10M,467,210,677,0.689807976366322
383,2011-02-01,10N,406,216,622,0.6527331189710611
384,2011-02-01,10Q,2338,2088,4426,0.5282422051513782
385,2011-02-01,10R,1287,430,1717,0.749563191613279
386,2011-02-01,10T,461,166,627,0.7352472089314195
387,2011-02-01,10V,1143,590,1733,0.6595499134448932
388,2011-02-01,10W,538,164,702,0.7663817663817664
389,2011-02-01,10X,1176,451,1627,0.7228027043638598
390,2011-02-01,10Y,1098,451,1549,0.7088444157520981
391,2011-02-01,11A,3006,1410,4416,0.6807065217391305
392,2011-02-01,11C,765,241,1006,0.7604373757455268
393,2011-02-01,11D,584,308,892,0.6547085201793722
394,2011-02-01,11E,1172,433,1605,0.7302180685358255
395,2011-02-01,11H,2388,1033,3421,0.6980415083308974
396,2011-02-01,11J,4373,1971,6344,0.689312736443884
397,2011-02-01,11M,3321,1463,4784,0.6941889632107023
398,2011-02-01,11N,3571,965,4536,0.7872574955908289
399,2011-02-01,11T,1317,651,1968,0.6692073170731707
400,2011-02-01,11X,3333,1298,4631,0.7197149643705463
401,2011-02-01,12A,1418,504,1922,0.7377731529656608
402,2011-02-01,12D,1051,300,1351,0.7779422649888971
403,2011-02-01,12F,2257,347,2604,0.8667434715821812
404,2011-02-01,13P,2752,926,3678,0.7482327351821643
405,2011-02-01,13T,2861,1051,3912,0.7313394683026585
406,2011-02-01,14L,2608,1103,3711,0.702775532201563
407,2011-02-01,99A,2424,552,2976,0.8145161290322581
408,2011-02-01,99C,1312,606,1918,0.6840458811261731
409,2011-02-01,99D,988,333,1321,0.7479182437547313
410,2011-02-01,99E,1414,406,1820,0.7769230769230769
411,2011-02-01,99F,991,259,1250,0.7928
412,2011-02-01,99G,851,179,1030,0.8262135922330097
413,2011-02-01,99H,1513,717,2230,0.6784753363228699
414,2011-02-01,99J,2767,937,3704,0.7470302375809935
415,2011-02-01,99K,1021,454,1475,0.6922033898305084
416,2011-02-01,99M,1019,615,1634,0.6236230110159119
417,2011-02-01,99N,2547,1702,4249,0.5994351612144034
418,2011-02-01,99P,5547,1695,7242,0.7659486329743165
419,2011-02-01,99Q,1808,641,2449,0.7382605144957125
420,2011-03-01,00C,734,258,992,0.7399193548387096
421,2011-03-01,00D,2114,917,3031,0.6974595842956121
422,2011-03-01,00F,19,7,26,0.7307692307692307
423,2011-03-01,00J,1620,635,2255,0.7184035476718403
424,2011-03-01,00K,2250,993,3243,0.6938020351526365
425,2011-03-01,00L,2450,1327,3777,0.6486629600211808
426,2011-03-01,00M,1907,620,2527,0.7546497823506134
427,2011-03-01,00N,1098,562,1660,0.6614457831325301
428,2011-03-01,00P,1924,500,2424,0.7937293729372937
429,2011-03-01,00Q,993,280,1273,0.7800471327572663
430,2011-03-01,00R,1153,265,1418,0.81311706629055
431,2011-03-01,00T,1870,736,2606,0.7175748273215656
432,2011-03-01,00V,1283,543,1826,0.7026286966046003
433,2011-03-01,00W,55,25,80,0.6875
434,2011-03-01,00X,922,150,1072,0.8600746268656716
435,2011-03-01,00Y,1606,622,2228,0.7208258527827648
436,2011-03-01,01A,2388,971,3359,0.7109258707948795
437,2011-03-01,01C,1318,620,1938,0.6800825593395253
438,2011-03-01,01D,1560,525,2085,0.7482014388489209
439,2011-03-01,01E,987,99,1086,0.9088397790055248
440,2011-03-01,01F,973,335,1308,0.7438837920489296
441,2011-03-01,01G,1140,948,2088,0.5459770114942529
442,2011-03-01,01H,2152,515,2667,0.8068991376077991
443,2011-03-01,01J,986,345,1331,0.7407963936889557
444,2011-03-01,01K,2107,760,2867,0.7349145448203698
445,2011-03-01,01N,34,8,42,0.8095238095238095
446,2011-03-01,01R,979,444,1423,0.6879831342234716
447,2011-03-01,01T,786,279,1065,0.7380281690140845
448,2011-03-01,01V,743,225,968,0.7675619834710744
449,2011-03-01,01W,1778,648,2426,0.7328936521022259
450,2011-03-01,01X,1498,562,2060,0.7271844660194174
451,2011-03-01,01Y,1532,424,1956,0.7832310838445807
452,2011-03-01,02A,1451,578,2029,0.7151306062099556
453,2011-03-01,02D,612,313,925,0.6616216216216216
454,2011-03-01,02E,1151,349,1500,0.7673333333333333
455,2011-03-01,02F,1598,485,2083,0.7671627460393663
456,2011-03-01,02G,561,204,765,0.7333333333333333
457,2011-03-01,02H,1837,1248,3085,0.5954619124797407
458,2011-03-01,02M,964,239,1203,0.801330008312552
459,2011-03-01,02N,992,408,1400,0.7085714285714285
460,2011-03-01,02P,1148,783,1931,0.5945106162610047
461,2011-03-01,02Q,558,200,758,0.7361477572559367
462,2011-03-01,02R,1996,547,2543,0.7848997247345655
463,2011-03-01,02T,919,383,1302,0.705837173579109
464,2011-03-01,02V,1383,464,1847,0.7487818083378451
465,2011-03-01,02W,627,119,746,0.8404825737265416
466,2011-03-01,02X,1397,346,1743,0.8014916810097533
467,2011-03-01,02Y,1855,581,2436,0.7614942528735632
468,2011-03-01,03A,1136,277,1413,0.8039631988676574
469,2011-03-01,03C,1877,766,2643,0.7101778282255014
470,2011-03-01,03D,779,279,1058,0.7362948960302458
471,2011-03-01,03E,964,399,1363,0.7072633895818048
472,2011-03-01,03F,1638,391,2029,0.8072942336126171
473,2011-03-01,03G,1599,511,2110,0.7578199052132701
474,2011-03-01,03H,1234,377,1611,0.765983860955928
475,2011-03-01,03J,1023,254,1277,0.8010963194988254
476,2011-03-01,03K,1013,206,1219,0.8310090237899918
477,2011-03-01,03L,1315,720,2035,0.6461916461916462
478,2011-03-01,03M,776,297,1073,0.723205964585275
479,2011-03-01,03N,3233,734,3967,0.814973531635997
480,2011-03-01,03Q,1819,793,2612,0.6964012251148545
481,2011-03-01,03R,2147,565,2712,0.7916666666666666
482,2011-03-01,03T,1766,467,2233,0.7908643081056874
483,2011-03-01,03V,277,149,426,0.6502347417840375
484,2011-03-01,03W,2189,1050,3239,0.6758258721827725
485,2011-03-01,03X,451,116,567,0.7954144620811288
486,2011-03-01,03Y,655,264,919,0.7127312295973884
487,2011-03-01,04C,2081,897,2978,0.6987911349899262
488,2011-03-01,04D,1475,460,1935,0.7622739018087855
489,2011-03-01,04E,1060,276,1336,0.7934131736526946
490,2011-03-01,04F,1535,751,2286,0.6714785651793526
491,2011-03-01,04G,3970,1533,5503,0.7214246774486643
492,2011-03-01,04H,703,229,932,0.7542918454935622
493,2011-03-01,04J,1876,824,2700,0.6948148148148148
494,2011-03-01,04K,1820,490,2310,0.7878787878787878
495,2011-03-01,04L,845,253,1098,0.7695810564663024
496,2011-03-01,04M,560,143,703,0.7965860597439545
497,2011-03-01,04N,726,228,954,0.7610062893081762
498,2011-03-01,04Q,800,235,1035,0.7729468599033816
499,2011-03-01,04R,2624,952,3576,0.7337807606263982
500,2011-03-01,04V,2245,994,3239,0.6931151589996912
501,2011-03-01,04X,1304,729,2033,0.6414166256763404
502,2011-03-01,04Y,830,200,1030,0.8058252427184466
503,2011-03-01,05A,2595,1030,3625,0.7158620689655173
504,2011-03-01,05C,1155,1328,2483,0.46516310914216674
505,2011-03-01,05D,747,321,1068,0.699438202247191
506,2011-03-01,05F,1141,355,1496,0.7627005347593583
507,2011-03-01,05G,1219,424,1643,0.7419354838709677
508,2011-03-01,05H,1070,361,1431,0.7477288609364081
509,2011-03-01,05J,1339,406,1745,0.7673352435530086
510,2011-03-01,05L,2587,935,3522,0.7345258375922771
511,2011-03-01,05N,2068,550,2618,0.7899159663865546
512,2011-03-01,05P,1242,248,1490,0.8335570469798658
513,2011-03-01,05Q,1256,337,1593,0.7884494664155681
514,2011-03-01,05R,1808,779,2587,0.6988790104367993
515,2011-03-01,05T,2012,631,2643,0.7612561483163073
516,2011-03-01,05V,998,304,1302,0.7665130568356375
517,2011-03-01,05W,1446,585,2031,0.7119645494830132
518,2011-03-01,05X,1157,301,1458,0.7935528120713305
519,2011-03-01,05Y,1732,592,2324,0.7452667814113597
520,2011-03-01,06A,1494,387,1881,0.7942583732057417
521,2011-03-01,06D,840,295,1135,0.7400881057268722
522,2011-03-01,06F,1727,1998,3725,0.4636241610738255
523,2011-03-01,06H,5269,2038,7307,0.7210893663610237
524,2011-03-01,06K,3281,1369,4650,0.7055913978494623
525,2011-03-01,06L,2319,861,3180,0.7292452830188679
526,2011-03-01,06M,2007,818,2825,0.7104424778761061
527,2011-03-01,06N,3162,1346,4508,0.7014196983141082
528,2011-03-01,06P,951,553,1504,0.632313829787234
529,2011-03-01,06Q,2330,1027,3357,0.6940720881739648
530,2011-03-01,06T,2263,955,3218,0.7032318210068366
531,2011-03-01,06V,1384,482,1866,0.7416934619506966
532,2011-03-01,06W,1476,381,1857,0.7948303715670436
533,2011-03-01,06Y,1338,344,1682,0.7954815695600476
534,2011-03-01,07G,956,280,1236,0.7734627831715211
535,2011-03-01,07H,1623,808,2431,0.6676264911559029
536,2011-03-01,07J,773,377,1150,0.6721739130434783
537,2011-03-01,07K,1477,617,2094,0.7053486150907354
538,2011-03-01,07L,864,200,1064,0.8120300751879699
539,2011-03-01,07M,1261,613,1874,0.6728922091782283
540,2011-03-01,07N,1348,489,1837,0.7338051170386499
541,2011-03-01,07P,717,197,914,0.7844638949671773
542,2011-03-01,07Q,1754,605,2359,0.7435353963543875
543,2011-03-01,07R,780,350,1130,0.6902654867256637
544,2011-03-01,07T,688,306,994,0.6921529175050302
545,2011-03-01,07V,1841,612,2453,0.7505095801059927
546,2011-03-01,07W,1030,522,1552,0.663659793814433
547,2011-03-01,07X,1239,442,1681,0.737061273051755
548,2011-03-01,07Y,917,439,1356,0.6762536873156342
549,2011-03-01,08A,1210,502,1712,0.7067757009345794
550,2011-03-01,08C,515,215,730,0.7054794520547946
551,2011-03-01,08D,843,389,1232,0.6842532467532467
552,2011-03-01,08E,589,257,846,0.6962174940898345
553,2011-03-01,08F,1310,420,1730,0.7572254335260116
554,2011-03-01,08G,513,1198,1711,0.2998246639392168
555,2011-03-01,08H,842,462,1304,0.6457055214723927
556,2011-03-01,08J,730,360,1090,0.6697247706422018
557,2011-03-01,08K,1043,267,1310,0.7961832061068702
558,2011-03-01,08L,884,566,1450,0.6096551724137931
559,2011-03-01,08M,1156,297,1453,0.7955953200275292
560,2011-03-01,08N,1066,255,1321,0.8069644208932627
561,2011-03-01,08P,879,323,1202,0.7312811980033278
562,2011-03-01,08Q,970,195,1165,0.8326180257510729
563,2011-03-01,08R,837,275,1112,0.7526978417266187
564,2011-03-01,08T,887,348,1235,0.7182186234817813
565,2011-03-01,08V,1015,296,1311,0.7742181540808543
566,2011-03-01,08W,1164,322,1486,0.7833109017496636
567,2011-03-01,08X,1306,437,1743,0.7492828456683879
568,2011-03-01,08Y,765,299,1064,0.7189849624060151
569,2011-03-01,09A,600,280,880,0.6818181818181818
570,2011-03-01,09C,721,263,984,0.7327235772357723
571,2011-03-01,09D,1552,608,2160,0.7185185185185186
572,2011-03-01,09E,1442,375,1817,0.7936158503026968
573,2011-03-01,09F,1349,486,1835,0.735149863760218
574,2011-03-01,09G,3192,1514,4706,0.6782830429239269
575,2011-03-01,09H,671,261,932,0.7199570815450643
576,2011-03-01,09J,1623,523,2146,0.7562907735321528
577,2011-03-01,09L,786,463,1249,0.6293034427542034
578,2011-03-01,09N,1196,686,1882,0.6354941551540914
579,2011-03-01,09P,1251,592,1843,0.6787845903418339
580,2011-03-01,09W,1422,384,1806,0.7873754152823921
581,2011-03-01,09X,1144,592,1736,0.6589861751152074
582,2011-03-01,09Y,1729,1072,2801,0.6172795430203499
583,2011-03-01,10A,1178,486,1664,0.7079326923076923
584,2011-03-01,10C,495,284,779,0.6354300385109114
585,2011-03-01,10D,648,128,776,0.8350515463917526
586,2011-03-01,10E,796,225,1021,0.7796278158667973
587,2011-03-01,10G,634,265,899,0.7052280311457174
588,2011-03-01,10H,1764,614,2378,0.7417998317914214
589,2011-03-01,10J,1092,868,1960,0.5571428571428572
590,2011-03-01,10K,1179,646,1825,0.646027397260274
591,2011-03-01,10L,986,282,1268,0.777602523659306
592,2011-03-01,10M,486,259,745,0.6523489932885906
593,2011-03-01,10N,426,289,715,0.5958041958041959
594,2011-03-01,10Q,2657,2422,5079,0.5231344752904115
595,2011-03-01,10R,1406,462,1868,0.7526766595289079
596,2011-03-01,10T,536,157,693,0.7734487734487735
597,2011-03-01,10V,1267,727,1994,0.6354062186559679
598,2011-03-01,10W,575,222,797,0.7214554579673776
599,2011-03-01,10X,1284,521,1805,0.7113573407202216
600,2011-03-01,10Y,1279,519,1798,0.7113459399332592
601,2011-03-01,11A,3376,1646,5022,0.672242134607726
602,2011-03-01,11C,768,249,1017,0.7551622418879056
603,2011-03-01,11D,666,330,996,0.6686746987951807
604,2011-03-01,11E,1338,480,1818,0.735973597359736
605,2011-03-01,11H,2587,1207,3794,0.6818661043753295
606,2011-03-01,11J,4825,2319,7144,0.6753919372900336
607,2011-03-01,11M,3635,1639,5274,0.6892301858172165
608,2011-03-01,11N,4014,1106,5120,0.783984375
609,2011-03-01,11T,1431,723,2154,0.6643454038997214
610,2011-03-01,11X,3726,1519,5245,0.7103908484270735
611,2011-03-01,12A,1561,630,2191,0.7124600638977636
612,2011-03-01,12D,1200,363,1563,0.7677543186180422
613,2011-03-01,12F,2480,365,2845,0.8717047451669596
614,2011-03-01,13P,3148,1118,4266,0.7379278012189404
615,2011-03-01,13T,3183,1185,4368,0.7287087912087912
616,2011-03-01,14L,3047,1338,4385,0.6948688711516534
617,2011-03-01,99A,2786,614,3400,0.8194117647058824
618,2011-03-01,99C,1577,748,2325,0.6782795698924731
619,2011-03-01,99D,1090,429,1519,0.717577353522054
620,2011-03-01,99E,1628,467,2095,0.7770883054892601
621,2011-03-01,99F,1062,285,1347,0.7884187082405345
622,2011-03-01,99G,951,232,1183,0.8038884192730347
623,2011-03-01,99H,1630,762,2392,0.681438127090301
624,2011-03-01,99J,3026,1134,4160,0.7274038461538461
625,2011-03-01,99K,1043,470,1513,0.6893588896232651
626,2011-03-01,99M,1108,762,1870,0.5925133689839572
627,2011-03-01,99N,2878,1949,4827,0.5962295421586907
628,2011-03-01,99P,6285,1981,8266,0.7603435760948464
629,2011-03-01,99Q,1970,696,2666,0.7389347336834209
630,2011-04-01,00C,625,242,867,0.720876585928489
631,2011-04-01,00D,1816,773,2589,0.701429123213596
632,2011-04-01,00F,15,9,24,0.625
633,2011-04-01,00J,1315,546,1861,0.706609349811929
634,2011-04-01,00K,1780,883,2663,0.668419076229816
635,2011-04-01,00L,2012,1168,3180,0.6327044025157232
636,2011-04-01,00M,1614,616,2230,0.7237668161434978
637,2011-04-01,00N,924,517,1441,0.6412213740458015
638,2011-04-01,00P,1588,433,2021,0.7857496288965858
639,2011-04-01,00Q,810,252,1062,0.7627118644067796
640,2011-04-01,00R,939,183,1122,0.8368983957219251
641,2011-04-01,00T,1605,668,2273,0.7061152661680599
642,2011-04-01,00V,1048,456,1504,0.6968085106382979
643,2011-04-01,00W,63,13,76,0.8289473684210527
644,2011-04-01,00X,738,108,846,0.8723404255319149
645,2011-04-01,00Y,1469,581,2050,0.7165853658536585
646,2011-04-01,01A,2024,904,2928,0.6912568306010929
647,2011-04-01,01C,1083,538,1621,0.6681061073411474
648,2011-04-01,01D,1200,462,1662,0.7220216606498195
649,2011-04-01,01E,857,89,946,0.9059196617336153
650,2011-04-01,01F,777,316,1093,0.7108874656907593
651,2011-04-01,01G,986,837,1823,0.5408667032364235
652,2011-04-01,01H,1771,422,2193,0.8075695394436845
653,2011-04-01,01J,777,299,1076,0.7221189591078067
654,2011-04-01,01K,1787,685,2472,0.7228964401294499
655,2011-04-01,01N,17,7,24,0.7083333333333334
656,2011-04-01,01R,869,350,1219,0.7128794093519278
657,2011-04-01,01T,618,286,904,0.6836283185840708
658,2011-04-01,01V,649,199,848,0.7653301886792453
659,2011-04-01,01W,1467,497,1964,0.7469450101832994
660,2011-04-01,01X,1247,458,1705,0.7313782991202346
661,2011-04-01,01Y,1293,419,1712,0.7552570093457944
662,2011-04-01,02A,1187,559,1746,0.6798396334478809
663,2011-04-01,02D,477,282,759,0.6284584980237155
664,2011-04-01,02E,904,336,1240,0.7290322580645161
665,2011-04-01,02F,1256,430,1686,0.7449584816132859
666,2011-04-01,02G,458,152,610,0.7508196721311475
667,2011-04-01,02H,1514,945,2459,0.6156974379829199
668,2011-04-01,02M,719,224,943,0.7624602332979852
669,2011-04-01,02N,847,338,1185,0.7147679324894515
670,2011-04-01,02P,937,671,1608,0.5827114427860697
671,2011-04-01,02Q,482,194,676,0.7130177514792899
672,2011-04-01,02R,1711,493,2204,0.7763157894736842
673,2011-04-01,02T,796,297,1093,0.7282708142726441
674,2011-04-01,02V,1106,442,1548,0.7144702842377261
675,2011-04-01,02W,514,113,627,0.8197767145135566
676,2011-04-01,02X,1284,346,1630,0.7877300613496933
677,2011-04-01,02Y,1556,497,2053,0.7579152459814905
678,2011-04-01,03A,958,315,1273,0.7525530243519246
679,2011-04-01,03C,1483,665,2148,0.6904096834264432
680,2011-04-01,03D,662,257,919,0.720348204570185
681,2011-04-01,03E,725,330,1055,0.6872037914691943
682,2011-04-01,03F,1356,409,1765,0.7682719546742209
683,2011-04-01,03G,1274,453,1727,0.7376954255935148
684,2011-04-01,03H,916,296,1212,0.7557755775577558
685,2011-04-01,03J,783,207,990,0.7909090909090909
686,2011-04-01,03K,791,132,923,0.856988082340195
687,2011-04-01,03L,1131,637,1768,0.6397058823529411
688,2011-04-01,03M,681,299,980,0.6948979591836735
689,2011-04-01,03N,2678,623,3301,0.8112693123295971
690,2011-04-01,03Q,1409,652,2061,0.6836487142163998
691,2011-04-01,03R,1842,509,2351,0.7834963845172267
692,2011-04-01,03T,1457,386,1843,0.7905588714053174
693,2011-04-01,03V,294,185,479,0.6137787056367432
694,2011-04-01,03W,1711,820,2531,0.6760173844330304
695,2011-04-01,03X,403,109,512,0.787109375
696,2011-04-01,03Y,626,226,852,0.7347417840375586
697,2011-04-01,04C,1586,751,2337,0.6786478391099701
698,2011-04-01,04D,1238,414,1652,0.7493946731234867
699,2011-04-01,04E,904,272,1176,0.7687074829931972
700,2011-04-01,04F,1301,632,1933,0.6730470770822555
701,2011-04-01,04G,3282,1374,4656,0.7048969072164949
702,2011-04-01,04H,555,176,731,0.759233926128591
703,2011-04-01,04J,1648,813,2461,0.6696464851686307
704,2011-04-01,04K,1337,436,1773,0.7540891144952059
705,2011-04-01,04L,692,226,918,0.7538126361655774
706,2011-04-01,04M,441,132,573,0.7696335078534031
707,2011-04-01,04N,594,183,777,0.7644787644787645
708,2011-04-01,04Q,639,194,833,0.7671068427370948
709,2011-04-01,04R,2066,881,2947,0.7010519172039362
710,2011-04-01,04V,1792,885,2677,0.6694060515502428
711,2011-04-01,04X,1036,604,1640,0.6317073170731707
712,2011-04-01,04Y,662,191,853,0.776084407971864
713,2011-04-01,05A,2043,963,3006,0.6796407185628742
714,2011-04-01,05C,927,1086,2013,0.46050670640834573
715,2011-04-01,05D,559,270,829,0.6743063932448733
716,2011-04-01,05F,990,335,1325,0.7471698113207547
717,2011-04-01,05G,919,398,1317,0.6977980258162491
718,2011-04-01,05H,864,338,1202,0.718801996672213
719,2011-04-01,05J,1091,319,1410,0.7737588652482269
720,2011-04-01,05L,2024,774,2798,0.72337383845604
721,2011-04-01,05N,1829,435,2264,0.8078621908127208
722,2011-04-01,05P,986,210,1196,0.8244147157190636
723,2011-04-01,05Q,1029,287,1316,0.7819148936170213
724,2011-04-01,05R,1482,677,2159,0.6864289022695692
725,2011-04-01,05T,1609,547,2156,0.7462894248608535
726,2011-04-01,05V,825,266,1091,0.7561869844179652
727,2011-04-01,05W,1121,513,1634,0.686046511627907
728,2011-04-01,05X,968,287,1255,0.7713147410358566
729,2011-04-01,05Y,1411,520,1931,0.7307094769549456
730,2011-04-01,06A,1334,379,1713,0.7787507297139521
731,2011-04-01,06D,642,274,916,0.7008733624454149
732,2011-04-01,06F,1513,1719,3232,0.4681311881188119
733,2011-04-01,06H,4418,1806,6224,0.7098329048843187
734,2011-04-01,06K,2650,1297,3947,0.6713959969597162
735,2011-04-01,06L,1974,738,2712,0.7278761061946902
736,2011-04-01,06M,1652,703,2355,0.7014861995753715
737,2011-04-01,06N,2726,1269,3995,0.6823529411764706
738,2011-04-01,06P,817,474,1291,0.632842757552285
739,2011-04-01,06Q,1946,925,2871,0.6778126088470916
740,2011-04-01,06T,1852,767,2619,0.7071401298205422
741,2011-04-01,06V,1214,426,1640,0.7402439024390244
742,2011-04-01,06W,1320,301,1621,0.8143121529919802
743,2011-04-01,06Y,1085,333,1418,0.7651622002820875
744,2011-04-01,07G,766,230,996,0.7690763052208835
745,2011-04-01,07H,1357,603,1960,0.6923469387755102
746,2011-04-01,07J,634,285,919,0.6898803046789989
747,2011-04-01,07K,1202,551,1753,0.6856816885339418
748,2011-04-01,07L,657,179,836,0.7858851674641149
749,2011-04-01,07M,1077,516,1593,0.6760828625235404
750,2011-04-01,07N,1151,401,1552,0.7416237113402062
751,2011-04-01,07P,589,183,772,0.7629533678756477
752,2011-04-01,07Q,1426,556,1982,0.7194752774974773
753,2011-04-01,07R,591,297,888,0.6655405405405406
754,2011-04-01,07T,514,277,791,0.649810366624526
755,2011-04-01,07V,1580,525,2105,0.7505938242280285
756,2011-04-01,07W,869,430,1299,0.6689761354888376
757,2011-04-01,07X,1107,385,1492,0.7419571045576407
758,2011-04-01,07Y,718,382,1100,0.6527272727272727
759,2011-04-01,08A,955,405,1360,0.7022058823529411
760,2011-04-01,08C,444,206,650,0.683076923076923
761,2011-04-01,08D,713,331,1044,0.6829501915708812
762,2011-04-01,08E,535,222,757,0.7067371202113606
763,2011-04-01,08F,1064,365,1429,0.7445766270118964
764,2011-04-01,08G,475,1091,1566,0.3033205619412516
765,2011-04-01,08H,682,439,1121,0.6083853702051739
766,2011-04-01,08J,592,265,857,0.690781796966161
767,2011-04-01,08K,834,222,1056,0.7897727272727273
768,2011-04-01,08L,804,493,1297,0.6198920585967618
769,2011-04-01,08M,895,271,1166,0.7675814751286449
770,2011-04-01,08N,935,228,1163,0.8039552880481513
771,2011-04-01,08P,702,327,1029,0.6822157434402333
772,2011-04-01,08Q,732,170,902,0.811529933481153
773,2011-04-01,08R,749,261,1010,0.7415841584158416
774,2011-04-01,08T,740,295,1035,0.714975845410628
775,2011-04-01,08V,839,289,1128,0.7437943262411347
776,2011-04-01,08W,951,266,1217,0.7814297452752671
777,2011-04-01,08X,965,364,1329,0.7261098570353649
778,2011-04-01,08Y,704,244,948,0.7426160337552743
779,2011-04-01,09A,469,241,710,0.6605633802816901
780,2011-04-01,09C,611,199,810,0.754320987654321
781,2011-04-01,09D,1200,535,1735,0.69164265129683
782,2011-04-01,09E,1188,332,1520,0.781578947368421
783,2011-04-01,09F,1185,459,1644,0.7208029197080292
784,2011-04-01,09G,2637,1307,3944,0.6686105476673428
785,2011-04-01,09H,551,236,787,0.7001270648030495
786,2011-04-01,09J,1328,477,1805,0.7357340720221607
787,2011-04-01,09L,663,401,1064,0.6231203007518797
788,2011-04-01,09N,928,584,1512,0.6137566137566137
789,2011-04-01,09P,1013,525,1538,0.6586475942782835
790,2011-04-01,09W,1170,384,1554,0.752895752895753
791,2011-04-01,09X,883,484,1367,0.6459400146305779
792,2011-04-01,09Y,1475,947,2422,0.6090008257638315
793,2011-04-01,10A,961,439,1400,0.6864285714285714
794,2011-04-01,10C,402,252,654,0.6146788990825688
795,2011-04-01,10D,479,139,618,0.7750809061488673
796,2011-04-01,10E,619,189,808,0.7660891089108911
797,2011-04-01,10G,522,187,709,0.7362482369534555
798,2011-04-01,10H,1495,517,2012,0.7430417495029821
799,2011-04-01,10J,919,759,1678,0.5476758045292014
800,2011-04-01,10K,1018,521,1539,0.6614684860298895
801,2011-04-01,10L,831,235,1066,0.7795497185741088
802,2011-04-01,10M,430,243,673,0.6389301634472511
803,2011-04-01,10N,370,242,612,0.6045751633986928
804,2011-04-01,10Q,2040,1920,3960,0.5151515151515151
805,2011-04-01,10R,1134,413,1547,0.7330316742081447
806,2011-04-01,10T,409,136,545,0.7504587155963303
807,2011-04-01,10V,1047,652,1699,0.6162448499117128
808,2011-04-01,10W,534,195,729,0.7325102880658436
809,2011-04-01,10X,958,453,1411,0.6789510985116939
810,2011-04-01,10Y,935,509,1444,0.6475069252077562
811,2011-04-01,11A,2695,1399,4094,0.6582804103566194
812,2011-04-01,11C,737,207,944,0.7807203389830508
813,2011-04-01,11D,542,323,865,0.6265895953757226
814,2011-04-01,11E,1097,480,1577,0.6956246036778694
815,2011-04-01,11H,2150,1034,3184,0.675251256281407
816,2011-04-01,11J,4120,1979,6099,0.6755205771437941
817,2011-04-01,11M,2960,1378,4338,0.6823420931304749
818,2011-04-01,11N,3424,919,4343,0.7883951185816256
819,2011-04-01,11T,1155,628,1783,0.6477846326416152
820,2011-04-01,11X,2995,1326,4321,0.6931265910668827
821,2011-04-01,12A,1238,557,1795,0.6896935933147632
822,2011-04-01,12D,954,334,1288,0.7406832298136646
823,2011-04-01,12F,2049,332,2381,0.8605627887442251
824,2011-04-01,13P,2512,909,3421,0.7342882198187665
825,2011-04-01,13T,2614,984,3598,0.726514730405781
826,2011-04-01,14L,2356,1119,3475,0.6779856115107914
827,2011-04-01,99A,2347,500,2847,0.8243765367053039
828,2011-04-01,99C,1212,593,1805,0.6714681440443213
829,2011-04-01,99D,911,333,1244,0.7323151125401929
830,2011-04-01,99E,1360,367,1727,0.787492762015055
831,2011-04-01,99F,901,270,1171,0.7694278394534586
832,2011-04-01,99G,760,186,946,0.8033826638477801
833,2011-04-01,99H,1301,706,2007,0.6482311908320877
834,2011-04-01,99J,2521,945,3466,0.7273514137334103
835,2011-04-01,99K,838,439,1277,0.6562255285826155
836,2011-04-01,99M,904,625,1529,0.5912361020274689
837,2011-04-01,99N,2417,1702,4119,0.5867929109007041
838,2011-04-01,99P,5240,1764,7004,0.7481439177612793
839,2011-04-01,99Q,1614,580,2194,0.7356426618049225
840,2011-05-01,00C,648,264,912,0.7105263157894737
841,2011-05-01,00D,1933,848,2781,0.6950737144911903
842,2011-05-01,00F,28,8,36,0.7777777777777778
843,2011-05-01,00J,1562,625,2187,0.7142203932327389
844,2011-05-01,00K,1968,970,2938,0.6698434309053778
845,2011-05-01,00L,2213,1336,3549,0.6235559312482389
846,2011-05-01,00M,1867,682,2549,0.7324440957238133
847,2011-05-01,00N,1037,553,1590,0.6522012578616352
848,2011-05-01,00P,1648,490,2138,0.7708138447146866
849,2011-05-01,00Q,888,267,1155,0.7688311688311689
850,2011-05-01,00R,1282,290,1572,0.8155216284987278
851,2011-05-01,00T,1807,736,2543,0.7105780574125049
852,2011-05-01,00V,1131,584,1715,0.6594752186588921
853,2011-05-01,00W,63,21,84,0.75
854,2011-05-01,00X,774,144,918,0.8431372549019608
855,2011-05-01,00Y,1696,624,2320,0.7310344827586207
856,2011-05-01,01A,2246,998,3244,0.6923551171393342
857,2011-05-01,01C,1251,595,1846,0.6776814734561214
858,2011-05-01,01D,1270,566,1836,0.6917211328976035
859,2011-05-01,01E,1010,110,1120,0.9017857142857143
860,2011-05-01,01F,826,393,1219,0.6776045939294504
861,2011-05-01,01G,1095,960,2055,0.5328467153284672
862,2011-05-01,01H,2090,553,2643,0.7907680665909951
863,2011-05-01,01J,906,362,1268,0.7145110410094637
864,2011-05-01,01K,1927,761,2688,0.7168898809523809
865,2011-05-01,01N,23,6,29,0.7931034482758621
866,2011-05-01,01R,951,453,1404,0.6773504273504274
867,2011-05-01,01T,794,296,1090,0.728440366972477
868,2011-05-01,01V,679,269,948,0.7162447257383966
869,2011-05-01,01W,1586,607,2193,0.7232102143182855
870,2011-05-01,01X,1389,515,1904,0.729516806722689
871,2011-05-01,01Y,1387,506,1893,0.7326994189117803
872,2011-05-01,02A,1208,595,1803,0.6699944536882972
873,2011-05-01,02D,520,329,849,0.6124852767962309
874,2011-05-01,02E,1036,392,1428,0.7254901960784313
875,2011-05-01,02F,1476,463,1939,0.7612171222279526
876,2011-05-01,02G,487,177,664,0.733433734939759
877,2011-05-01,02H,1503,1109,2612,0.5754211332312404
878,2011-05-01,02M,830,222,1052,0.7889733840304183
879,2011-05-01,02N,961,381,1342,0.7160953800298062
880,2011-05-01,02P,1088,847,1935,0.5622739018087856
881,2011-05-01,02Q,546,288,834,0.6546762589928058
882,2011-05-01,02R,1816,582,2398,0.7572977481234362
883,2011-05-01,02T,912,369,1281,0.711943793911007
884,2011-05-01,02V,1257,537,1794,0.7006688963210702
885,2011-05-01,02W,558,120,678,0.8230088495575221
886,2011-05-01,02X,1514,433,1947,0.7776065742167437
887,2011-05-01,02Y,1670,677,2347,0.7115466553046442
888,2011-05-01,03A,1061,355,1416,0.7492937853107344
889,2011-05-01,03C,1648,749,2397,0.6875260742594911
890,2011-05-01,03D,758,259,1017,0.7453294001966568
891,2011-05-01,03E,811,368,1179,0.6878710771840543
892,2011-05-01,03F,1529,428,1957,0.7812979049565661
893,2011-05-01,03G,1484,524,2008,0.7390438247011952
894,2011-05-01,03H,1098,385,1483,0.7403910991233985
895,2011-05-01,03J,1023,258,1281,0.7985948477751756
896,2011-05-01,03K,925,184,1109,0.8340847610459874
897,2011-05-01,03L,1159,741,1900,0.61
898,2011-05-01,03M,699,296,995,0.7025125628140704
899,2011-05-01,03N,3061,677,3738,0.8188871054039594
900,2011-05-01,03Q,1665,733,2398,0.6943286071726439
901,2011-05-01,03R,2059,572,2631,0.7825921702774611
902,2011-05-01,03T,1648,479,2127,0.7748001880582981
903,2011-05-01,03V,316,209,525,0.6019047619047619
904,2011-05-01,03W,1833,989,2822,0.6495393338058115
905,2011-05-01,03X,399,139,538,0.741635687732342
906,2011-05-01,03Y,641,266,907,0.7067254685777288
907,2011-05-01,04C,1816,891,2707,0.6708533431843369
908,2011-05-01,04D,1378,433,1811,0.7609055770292656
909,2011-05-01,04E,986,341,1327,0.7430293896006028
910,2011-05-01,04F,1392,755,2147,0.648346530041919
911,2011-05-01,04G,3755,1597,5352,0.7016068759342302
912,2011-05-01,04H,613,216,829,0.7394451145958987
913,2011-05-01,04J,1842,869,2711,0.6794540759867208
914,2011-05-01,04K,1675,501,2176,0.7697610294117647
915,2011-05-01,04L,809,245,1054,0.7675521821631879
916,2011-05-01,04M,516,163,679,0.759941089837997
917,2011-05-01,04N,637,216,853,0.7467760844079718
918,2011-05-01,04Q,777,235,1012,0.7677865612648221
919,2011-05-01,04R,2385,938,3323,0.7177249473367439
920,2011-05-01,04V,1974,1045,3019,0.6538588936734018
921,2011-05-01,04X,1255,764,2019,0.6215948489351164
922,2011-05-01,04Y,779,211,990,0.7868686868686868
923,2011-05-01,05A,2456,994,3450,0.7118840579710145
924,2011-05-01,05C,1054,1253,2307,0.4568703944516688
925,2011-05-01,05D,660,328,988,0.6680161943319838
926,2011-05-01,05F,1084,335,1419,0.7639182522903453
927,2011-05-01,05G,1052,429,1481,0.7103308575286968
928,2011-05-01,05H,981,390,1371,0.7155361050328227
929,2011-05-01,05J,1241,361,1602,0.7746566791510612
930,2011-05-01,05L,2393,856,3249,0.7365343182517697
931,2011-05-01,05N,2078,531,2609,0.7964737447297815
932,2011-05-01,05P,1180,283,1463,0.8065618591934381
933,2011-05-01,05Q,1128,349,1477,0.7637102234258633
934,2011-05-01,05R,1557,733,2290,0.6799126637554586
935,2011-05-01,05T,1806,645,2451,0.7368421052631579
936,2011-05-01,05V,914,325,1239,0.7376916868442293
937,2011-05-01,05W,1252,572,1824,0.6864035087719298
938,2011-05-01,05X,1138,271,1409,0.8076650106458482
939,2011-05-01,05Y,1500,580,2080,0.7211538461538461
940,2011-05-01,06A,1439,398,1837,0.7833424060968971
941,2011-05-01,06D,729,263,992,0.7348790322580645
942,2011-05-01,06F,1529,1837,3366,0.4542483660130719
943,2011-05-01,06H,4628,2035,6663,0.6945820201110611
944,2011-05-01,06K,2938,1447,4385,0.6700114025085518
945,2011-05-01,06L,2122,807,2929,0.7244793444861728
946,2011-05-01,06M,1796,775,2571,0.6985608712563205
947,2011-05-01,06N,2939,1380,4319,0.6804815929613336
948,2011-05-01,06P,958,616,1574,0.6086404066073697
949,2011-05-01,06Q,2108,1030,3138,0.6717654557042703
950,2011-05-01,06T,2056,878,2934,0.7007498295841854
951,2011-05-01,06V,1240,453,1693,0.7324276432368576
952,2011-05-01,06W,1426,326,1752,0.8139269406392694
953,2011-05-01,06Y,1124,319,1443,0.7789327789327789
954,2011-05-01,07G,878,263,1141,0.7695004382120947
955,2011-05-01,07H,1495,755,2250,0.6644444444444444
956,2011-05-01,07J,656,329,985,0.665989847715736
957,2011-05-01,07K,1299,623,1922,0.6758584807492196
958,2011-05-01,07L,777,195,972,0.7993827160493827
959,2011-05-01,07M,1066,590,1656,0.643719806763285
960,2011-05-01,07N,1211,467,1678,0.7216924910607867
961,2011-05-01,07P,647,249,896,0.7220982142857143
962,2011-05-01,07Q,1523,566,2089,0.7290569650550502
963,2011-05-01,07R,751,362,1113,0.6747529200359389
964,2011-05-01,07T,604,317,921,0.6558089033659066
965,2011-05-01,07V,1584,593,2177,0.7276067983463482
966,2011-05-01,07W,844,544,1388,0.6080691642651297
967,2011-05-01,07X,1164,459,1623,0.7171903881700554
968,2011-05-01,07Y,765,426,1191,0.6423173803526449
969,2011-05-01,08A,1143,495,1638,0.6978021978021978
970,2011-05-01,08C,417,220,637,0.6546310832025117
971,2011-05-01,08D,797,362,1159,0.6876617773943055
972,2011-05-01,08E,652,276,928,0.7025862068965517
973,2011-05-01,08F,1185,403,1588,0.7462216624685138
974,2011-05-01,08G,455,1146,1601,0.28419737663960026
975,2011-05-01,08H,774,473,1247,0.6206896551724138
976,2011-05-01,08J,650,309,959,0.6777893639207507
977,2011-05-01,08K,867,233,1100,0.7881818181818182
978,2011-05-01,08L,897,569,1466,0.611869031377899
979,2011-05-01,08M,1023,355,1378,0.7423802612481858
980,2011-05-01,08N,1086,305,1391,0.7807332854061826
981,2011-05-01,08P,710,326,1036,0.6853281853281853
982,2011-05-01,08Q,871,224,1095,0.7954337899543379
983,2011-05-01,08R,789,291,1080,0.7305555555555555
984,2011-05-01,08T,857,359,1216,0.7047697368421053
985,2011-05-01,08V,950,324,1274,0.7456828885400314
986,2011-05-01,08W,1032,341,1373,0.7516387472687546
987,2011-05-01,08X,1094,395,1489,0.7347212894560108
988,2011-05-01,08Y,722,272,994,0.7263581488933601
989,2011-05-01,09A,551,307,858,0.6421911421911422
990,2011-05-01,09C,652,282,934,0.6980728051391863
991,2011-05-01,09D,1455,611,2066,0.7042594385285575
992,2011-05-01,09E,1286,307,1593,0.8072818581293157
993,2011-05-01,09F,1270,545,1815,0.699724517906336
994,2011-05-01,09G,2814,1541,4355,0.6461538461538462
995,2011-05-01,09H,614,246,860,0.713953488372093
996,2011-05-01,09J,1421,566,1987,0.7151484650226472
997,2011-05-01,09L,737,410,1147,0.6425457715780296
998,2011-05-01,09N,1041,719,1760,0.5914772727272727
999,2011-05-01,09P,1164,563,1727,0.6740011580775912
1000,2011-05-01,09W,1276,395,1671,0.7636146020347098
1001,2011-05-01,09X,1054,521,1575,0.6692063492063492
1002,2011-05-01,09Y,1612,1095,2707,0.5954931658662727
1003,2011-05-01,10A,1030,496,1526,0.6749672346002621
1004,2011-05-01,10C,455,290,745,0.610738255033557
1005,2011-05-01,10D,527,122,649,0.8120184899845917
1006,2011-05-01,10E,694,216,910,0.7626373626373626
1007,2011-05-01,10G,560,219,779,0.7188703465982028
1008,2011-05-01,10H,1751,691,2442,0.717035217035217
1009,2011-05-01,10J,919,905,1824,0.5038377192982456
1010,2011-05-01,10K,1107,599,1706,0.6488862837045721
1011,2011-05-01,10L,894,295,1189,0.751892346509672
1012,2011-05-01,10M,517,271,788,0.6560913705583756
1013,2011-05-01,10N,407,306,713,0.5708274894810659
1014,2011-05-01,10Q,2243,2226,4469,0.5019019914969792
1015,2011-05-01,10R,1372,456,1828,0.75054704595186
1016,2011-05-01,10T,483,152,635,0.7606299212598425
1017,2011-05-01,10V,1103,742,1845,0.5978319783197832
1018,2011-05-01,10W,523,233,756,0.6917989417989417
1019,2011-05-01,10X,1062,472,1534,0.6923076923076923
1020,2011-05-01,10Y,1111,538,1649,0.6737416616130989
1021,2011-05-01,11A,3090,1526,4616,0.6694107452339688
1022,2011-05-01,11C,730,272,1002,0.7285429141716567
1023,2011-05-01,11D,554,359,913,0.6067907995618839
1024,2011-05-01,11E,1126,534,1660,0.6783132530120481
1025,2011-05-01,11H,2442,1155,3597,0.6788990825688074
1026,2011-05-01,11J,4462,2208,6670,0.6689655172413793
1027,2011-05-01,11M,3238,1513,4751,0.6815407282677332
1028,2011-05-01,11N,3910,1166,5076,0.7702915681639085
1029,2011-05-01,11T,1352,744,2096,0.6450381679389313
1030,2011-05-01,11X,3320,1562,4882,0.680049160180254
1031,2011-05-01,12A,1344,629,1973,0.6811961479979727
1032,2011-05-01,12D,1039,382,1421,0.7311752287121746
1033,2011-05-01,12F,2237,375,2612,0.8564318529862175
1034,2011-05-01,13P,2931,1102,4033,0.7267542772129928
1035,2011-05-01,13T,2849,1063,3912,0.7282719836400818
1036,2011-05-01,14L,2744,1331,4075,0.6733742331288344
1037,2011-05-01,99A,2572,624,3196,0.804755944931164
1038,2011-05-01,99C,1467,696,2163,0.6782246879334258
1039,2011-05-01,99D,958,364,1322,0.7246596066565809
1040,2011-05-01,99E,1360,434,1794,0.758082497212932
1041,2011-05-01,99F,985,266,1251,0.7873701039168665
1042,2011-05-01,99G,900,228,1128,0.7978723404255319
1043,2011-05-01,99H,1362,730,2092,0.6510516252390057
1044,2011-05-01,99J,2852,1095,3947,0.7225741069166456
1045,2011-05-01,99K,953,508,1461,0.6522929500342232
1046,2011-05-01,99M,992,715,1707,0.5811364967779731
1047,2011-05-01,99N,2577,1984,4561,0.5650076737557553
1048,2011-05-01,99P,5783,1976,7759,0.7453280061863642
1049,2011-05-01,99Q,1774,684,2458,0.7217249796582588
1050,2011-06-01,00C,698,249,947,0.737064413938754
1051,2011-06-01,00D,1902,883,2785,0.6829443447037702
1052,2011-06-01,00F,16,11,27,0.5925925925925926
1053,2011-06-01,00J,1544,651,2195,0.7034168564920273
1054,2011-06-01,00K,2115,1011,3126,0.6765834932821497
1055,2011-06-01,00L,2250,1418,3668,0.6134133042529989
1056,2011-06-01,00M,1941,736,2677,0.7250653716847217
1057,2011-06-01,00N,1039,583,1622,0.6405672009864365
1058,2011-06-01,00P,1883,559,2442,0.7710892710892711
1059,2011-06-01,00Q,978,313,1291,0.7575522850503486
1060,2011-06-01,00R,1055,320,1375,0.7672727272727272
1061,2011-06-01,00T,1803,779,2582,0.698295894655306
1062,2011-06-01,00V,1352,646,1998,0.6766766766766766
1063,2011-06-01,00W,51,28,79,0.6455696202531646
1064,2011-06-01,00X,920,192,1112,0.8273381294964028
1065,2011-06-01,00Y,1638,693,2331,0.7027027027027027
1066,2011-06-01,01A,2384,1035,3419,0.6972799064053817
1067,2011-06-01,01C,1241,647,1888,0.6573093220338984
1068,2011-06-01,01D,1377,649,2026,0.6796643632773939
1069,2011-06-01,01E,1040,154,1194,0.8710217755443886
1070,2011-06-01,01F,836,382,1218,0.6863711001642037
1071,2011-06-01,01G,1103,1027,2130,0.5178403755868545
1072,2011-06-01,01H,2313,589,2902,0.7970365265334253
1073,2011-06-01,01J,977,323,1300,0.7515384615384615
1074,2011-06-01,01K,2103,847,2950,0.7128813559322034
1075,2011-06-01,01N,28,7,35,0.8
1076,2011-06-01,01R,997,506,1503,0.6633399866932801
1077,2011-06-01,01T,765,360,1125,0.68
1078,2011-06-01,01V,774,307,1081,0.7160037002775208
1079,2011-06-01,01W,1687,651,2338,0.7215568862275449
1080,2011-06-01,01X,1396,589,1985,0.7032745591939547
1081,2011-06-01,01Y,1413,502,1915,0.7378590078328982
1082,2011-06-01,02A,1315,616,1931,0.6809943034697048
1083,2011-06-01,02D,560,341,901,0.6215316315205327
1084,2011-06-01,02E,1126,422,1548,0.727390180878553
1085,2011-06-01,02F,1554,510,2064,0.752906976744186
1086,2011-06-01,02G,585,218,803,0.7285180572851806
1087,2011-06-01,02H,1685,1272,2957,0.5698342915116672
1088,2011-06-01,02M,871,265,1136,0.766725352112676
1089,2011-06-01,02N,957,407,1364,0.7016129032258065
1090,2011-06-01,02P,1128,868,1996,0.5651302605210421
1091,2011-06-01,02Q,515,365,880,0.5852272727272727
1092,2011-06-01,02R,1907,650,2557,0.7457958545170121
1093,2011-06-01,02T,865,434,1299,0.665896843725943
1094,2011-06-01,02V,1186,605,1791,0.6621998883305416
1095,2011-06-01,02W,580,143,723,0.8022130013831259
1096,2011-06-01,02X,1742,617,2359,0.738448495125053
1097,2011-06-01,02Y,1753,725,2478,0.7074253430185634
1098,2011-06-01,03A,1101,433,1534,0.7177314211212517
1099,2011-06-01,03C,1742,869,2611,0.6671773266947529
1100,2011-06-01,03D,754,314,1068,0.7059925093632958
1101,2011-06-01,03E,818,388,1206,0.6782752902155887
1102,2011-06-01,03F,1453,492,1945,0.7470437017994859
1103,2011-06-01,03G,1551,583,2134,0.7268041237113402
1104,2011-06-01,03H,1119,402,1521,0.7357001972386588
1105,2011-06-01,03J,995,289,1284,0.7749221183800623
1106,2011-06-01,03K,950,231,1181,0.8044030482641829
1107,2011-06-01,03L,1208,827,2035,0.5936117936117936
1108,2011-06-01,03M,744,344,1088,0.6838235294117647
1109,2011-06-01,03N,3092,782,3874,0.7981414558595766
1110,2011-06-01,03Q,1715,788,2503,0.6851777866560128
1111,2011-06-01,03R,2130,646,2776,0.7672910662824207
1112,2011-06-01,03T,1700,461,2161,0.7866728366496992
1113,2011-06-01,03V,387,240,627,0.6172248803827751
1114,2011-06-01,03W,1882,1014,2896,0.6498618784530387
1115,2011-06-01,03X,468,167,635,0.7370078740157481
1116,2011-06-01,03Y,641,285,926,0.6922246220302376
1117,2011-06-01,04C,1843,907,2750,0.6701818181818182
1118,2011-06-01,04D,1323,578,1901,0.6959495002630195
1119,2011-06-01,04E,973,331,1304,0.7461656441717791
1120,2011-06-01,04F,1364,775,2139,0.6376811594202898
1121,2011-06-01,04G,3834,1852,5686,0.6742877242349631
1122,2011-06-01,04H,668,292,960,0.6958333333333333
1123,2011-06-01,04J,1823,861,2684,0.6792101341281669
1124,2011-06-01,04K,1608,569,2177,0.7386311437758383
1125,2011-06-01,04L,812,278,1090,0.744954128440367
1126,2011-06-01,04M,538,201,739,0.7280108254397835
1127,2011-06-01,04N,696,232,928,0.75
1128,2011-06-01,04Q,773,286,1059,0.7299338999055713
1129,2011-06-01,04R,2419,1031,3450,0.7011594202898551
1130,2011-06-01,04V,2019,1053,3072,0.6572265625
1131,2011-06-01,04X,1326,886,2212,0.5994575045207957
1132,2011-06-01,04Y,822,274,1096,0.75
1133,2011-06-01,05A,2364,1154,3518,0.6719727117680501
1134,2011-06-01,05C,1120,1326,2446,0.4578904333605887
1135,2011-06-01,05D,758,401,1159,0.6540120793787748
1136,2011-06-01,05F,1213,408,1621,0.7483035163479334
1137,2011-06-01,05G,1105,446,1551,0.7124435847840103
1138,2011-06-01,05H,958,426,1384,0.6921965317919075
1139,2011-06-01,05J,1252,409,1661,0.7537627934978929
1140,2011-06-01,05L,2412,961,3373,0.7150904239549363
1141,2011-06-01,05N,2042,575,2617,0.7802827665265571
1142,2011-06-01,05P,1293,352,1645,0.7860182370820669
1143,2011-06-01,05Q,1159,353,1512,0.7665343915343915
1144,2011-06-01,05R,1668,804,2472,0.6747572815533981
1145,2011-06-01,05T,1861,655,2516,0.7396661367249603
1146,2011-06-01,05V,940,350,1290,0.7286821705426356
1147,2011-06-01,05W,1265,559,1824,0.6935307017543859
1148,2011-06-01,05X,1158,315,1473,0.7861507128309573
1149,2011-06-01,05Y,1570,658,2228,0.7046678635547576
1150,2011-06-01,06A,1493,460,1953,0.7644649257552484
1151,2011-06-01,06D,720,279,999,0.7207207207207207
1152,2011-06-01,06F,1629,2002,3631,0.4486367391903057
1153,2011-06-01,06H,4863,2282,7145,0.6806158152554234
1154,2011-06-01,06K,2979,1563,4542,0.6558784676354029
1155,2011-06-01,06L,2315,855,3170,0.7302839116719243
1156,2011-06-01,06M,1789,840,2629,0.6804868771395968
1157,2011-06-01,06N,3062,1599,4661,0.6569405706929844
1158,2011-06-01,06P,868,606,1474,0.5888738127544098
1159,2011-06-01,06Q,2139,1079,3218,0.6646985705407085
1160,2011-06-01,06T,2142,962,3104,0.6900773195876289
1161,2011-06-01,06V,1387,482,1869,0.7421080791867308
1162,2011-06-01,06W,1483,327,1810,0.8193370165745857
1163,2011-06-01,06Y,1240,334,1574,0.7878017789072427
1164,2011-06-01,07G,917,289,1206,0.7603648424543947
1165,2011-06-01,07H,1596,791,2387,0.6686217008797654
1166,2011-06-01,07J,726,326,1052,0.6901140684410646
1167,2011-06-01,07K,1345,603,1948,0.6904517453798767
1168,2011-06-01,07L,772,250,1022,0.7553816046966731
1169,2011-06-01,07M,1179,576,1755,0.6717948717948717
1170,2011-06-01,07N,1234,512,1746,0.7067583046964491
1171,2011-06-01,07P,733,280,1013,0.7235932872655478
1172,2011-06-01,07Q,1677,634,2311,0.7256598874945911
1173,2011-06-01,07R,682,425,1107,0.6160794941282746
1174,2011-06-01,07T,586,299,885,0.6621468926553672
1175,2011-06-01,07V,1712,610,2322,0.7372954349698536
1176,2011-06-01,07W,1024,592,1616,0.6336633663366337
1177,2011-06-01,07X,1242,511,1753,0.708499714774672
1178,2011-06-01,07Y,805,525,1330,0.6052631578947368
1179,2011-06-01,08A,1164,519,1683,0.6916221033868093
1180,2011-06-01,08C,450,241,691,0.6512301013024602
1181,2011-06-01,08D,868,415,1283,0.676539360872954
1182,2011-06-01,08E,686,286,972,0.7057613168724279
1183,2011-06-01,08F,1240,471,1711,0.7247223845704267
1184,2011-06-01,08G,488,1242,1730,0.28208092485549136
1185,2011-06-01,08H,773,467,1240,0.6233870967741936
1186,2011-06-01,08J,677,313,990,0.6838383838383838
1187,2011-06-01,08K,1019,309,1328,0.7673192771084337
1188,2011-06-01,08L,964,645,1609,0.5991298943443132
1189,2011-06-01,08M,1048,321,1369,0.7655222790357925
1190,2011-06-01,08N,1080,344,1424,0.7584269662921348
1191,2011-06-01,08P,741,364,1105,0.6705882352941176
1192,2011-06-01,08Q,999,245,1244,0.8030546623794212
1193,2011-06-01,08R,803,334,1137,0.7062445030782761
1194,2011-06-01,08T,928,415,1343,0.6909903201787044
1195,2011-06-01,08V,1000,310,1310,0.7633587786259542
1196,2011-06-01,08W,1115,302,1417,0.7868736767819337
1197,2011-06-01,08X,1138,451,1589,0.7161736941472624
1198,2011-06-01,08Y,705,310,1015,0.6945812807881774
1199,2011-06-01,09A,527,319,846,0.6229314420803782
1200,2011-06-01,09C,705,311,1016,0.6938976377952756
1201,2011-06-01,09D,1516,687,2203,0.6881525192918747
1202,2011-06-01,09E,1344,359,1703,0.7891955372871403
1203,2011-06-01,09F,1246,548,1794,0.6945373467112598
1204,2011-06-01,09G,3002,1641,4643,0.6465647210855051
1205,2011-06-01,09H,615,272,887,0.6933483652762119
1206,2011-06-01,09J,1505,562,2067,0.7281083696178036
1207,2011-06-01,09L,801,485,1286,0.6228615863141524
1208,2011-06-01,09N,1049,703,1752,0.598744292237443
1209,2011-06-01,09P,1136,647,1783,0.6371284352215367
1210,2011-06-01,09W,1328,482,1810,0.7337016574585635
1211,2011-06-01,09X,1047,621,1668,0.6276978417266187
1212,2011-06-01,09Y,1577,1147,2724,0.578928046989721
1213,2011-06-01,10A,1143,546,1689,0.6767317939609236
1214,2011-06-01,10C,451,285,736,0.6127717391304348
1215,2011-06-01,10D,511,164,675,0.7570370370370371
1216,2011-06-01,10E,752,245,997,0.7542627883650953
1217,2011-06-01,10G,658,255,913,0.7207009857612268
1218,2011-06-01,10H,1686,666,2352,0.7168367346938775
1219,2011-06-01,10J,991,984,1975,0.5017721518987341
1220,2011-06-01,10K,1074,724,1798,0.5973303670745272
1221,2011-06-01,10L,956,296,1252,0.7635782747603834
1222,2011-06-01,10M,504,271,775,0.6503225806451612
1223,2011-06-01,10N,460,312,772,0.5958549222797928
1224,2011-06-01,10Q,2350,2409,4759,0.49380121874343347
1225,2011-06-01,10R,1283,507,1790,0.7167597765363128
1226,2011-06-01,10T,502,187,689,0.7285921625544267
1227,2011-06-01,10V,1182,775,1957,0.6039856923863056
1228,2011-06-01,10W,580,255,835,0.6946107784431138
1229,2011-06-01,10X,1218,541,1759,0.6924388857305287
1230,2011-06-01,10Y,1227,624,1851,0.6628849270664505
1231,2011-06-01,11A,3198,1714,4912,0.6510586319218241
1232,2011-06-01,11C,810,286,1096,0.7390510948905109
1233,2011-06-01,11D,653,463,1116,0.5851254480286738
1234,2011-06-01,11E,1197,540,1737,0.689119170984456
1235,2011-06-01,11H,2503,1317,3820,0.6552356020942408
1236,2011-06-01,11J,4735,2497,7232,0.6547289823008849
1237,2011-06-01,11M,3305,1702,5007,0.6600758937487518
1238,2011-06-01,11N,3908,1268,5176,0.7550231839258115
1239,2011-06-01,11T,1396,738,2134,0.6541705716963448
1240,2011-06-01,11X,3424,1609,5033,0.6803099543016093
1241,2011-06-01,12A,1453,693,2146,0.6770736253494875
1242,2011-06-01,12D,1091,481,1572,0.6940203562340967
1243,2011-06-01,12F,2367,362,2729,0.8673506779039941
1244,2011-06-01,13P,3033,1311,4344,0.6982044198895028
1245,2011-06-01,13T,3090,1172,4262,0.7250117315814172
1246,2011-06-01,14L,2733,1360,4093,0.6677253848033228
1247,2011-06-01,99A,2717,731,3448,0.7879930394431555
1248,2011-06-01,99C,1443,748,2191,0.6586033774532177
1249,2011-06-01,99D,1054,448,1502,0.7017310252996005
1250,2011-06-01,99E,1506,493,1999,0.753376688344172
1251,2011-06-01,99F,1018,304,1322,0.7700453857791225
1252,2011-06-01,99G,956,229,1185,0.8067510548523207
1253,2011-06-01,99H,1443,791,2234,0.6459265890778872
1254,2011-06-01,99J,2910,1166,4076,0.7139352306182531
1255,2011-06-01,99K,1008,528,1536,0.65625
1256,2011-06-01,99M,1054,772,1826,0.5772179627601315
1257,2011-06-01,99N,2645,2106,4751,0.5567249000210482
1258,2011-06-01,99P,6181,2145,8326,0.7423732884938746
1259,2011-06-01,99Q,1843,771,2614,0.7050497322111706
1260,2011-07-01,00C,730,276,1006,0.7256461232604374
1261,2011-07-01,00D,1966,940,2906,0.6765313145216793
1262,2011-07-01,00F,21,12,33,0.6363636363636364
1263,2011-07-01,00J,1475,660,2135,0.6908665105386417
1264,2011-07-01,00K,2070,1052,3122,0.6630365150544523
1265,2011-07-01,00L,2283,1348,3631,0.6287524098044616
1266,2011-07-01,00M,2024,885,2909,0.6957717428669646
1267,2011-07-01,00N,1093,590,1683,0.649435531788473
1268,2011-07-01,00P,1813,640,2453,0.739094985731757
1269,2011-07-01,00Q,881,313,1194,0.7378559463986599
1270,2011-07-01,00R,1015,348,1363,0.7446808510638298
1271,2011-07-01,00T,1742,784,2526,0.6896278701504355
1272,2011-07-01,00V,1185,618,1803,0.6572379367720466
1273,2011-07-01,00W,58,22,80,0.725
1274,2011-07-01,00X,881,201,1082,0.8142329020332717
1275,2011-07-01,00Y,1582,715,2297,0.6887244231606443
1276,2011-07-01,01A,2220,1050,3270,0.6788990825688074
1277,2011-07-01,01C,1185,626,1811,0.6543346217559359
1278,2011-07-01,01D,1401,589,1990,0.7040201005025125
1279,2011-07-01,01E,1011,170,1181,0.8560541913632514
1280,2011-07-01,01F,798,349,1147,0.6957279860505667
1281,2011-07-01,01G,1021,1015,2036,0.5014734774066798
1282,2011-07-01,01H,2228,592,2820,0.7900709219858156
1283,2011-07-01,01J,915,418,1333,0.6864216054013503
1284,2011-07-01,01K,2120,879,2999,0.7069023007669223
1285,2011-07-01,01N,32,15,47,0.6808510638297872
1286,2011-07-01,01R,963,475,1438,0.6696801112656467
1287,2011-07-01,01T,765,348,1113,0.6873315363881402
1288,2011-07-01,01V,769,269,1038,0.7408477842003853
1289,2011-07-01,01W,1690,630,2320,0.728448275862069
1290,2011-07-01,01X,1358,531,1889,0.7188988883006882
1291,2011-07-01,01Y,1352,567,1919,0.7045336112558624
1292,2011-07-01,02A,1336,659,1995,0.6696741854636592
1293,2011-07-01,02D,529,312,841,0.629013079667063
1294,2011-07-01,02E,1063,439,1502,0.7077230359520639
1295,2011-07-01,02F,1522,526,2048,0.7431640625
1296,2011-07-01,02G,574,301,875,0.656
1297,2011-07-01,02H,1600,1288,2888,0.554016620498615
1298,2011-07-01,02M,837,302,1139,0.7348551360842844
1299,2011-07-01,02N,951,396,1347,0.7060133630289532
1300,2011-07-01,02P,1071,826,1897,0.5645756457564576
1301,2011-07-01,02Q,503,405,908,0.5539647577092511
1302,2011-07-01,02R,1885,698,2583,0.72977158343012
1303,2011-07-01,02T,880,403,1283,0.6858924395946999
1304,2011-07-01,02V,1225,546,1771,0.691699604743083
1305,2011-07-01,02W,569,160,729,0.7805212620027435
1306,2011-07-01,02X,1871,698,2569,0.7282989490073959
1307,2011-07-01,02Y,1763,737,2500,0.7052
1308,2011-07-01,03A,1108,403,1511,0.7332892124420913
1309,2011-07-01,03C,1768,851,2619,0.6750668193967163
1310,2011-07-01,03D,854,330,1184,0.7212837837837838
1311,2011-07-01,03E,896,377,1273,0.7038491751767478
1312,2011-07-01,03F,1428,552,1980,0.7212121212121212
1313,2011-07-01,03G,1540,567,2107,0.7308970099667774
1314,2011-07-01,03H,1145,382,1527,0.7498362802881466
1315,2011-07-01,03J,1012,305,1317,0.768413059984814
1316,2011-07-01,03K,990,223,1213,0.8161582852431987
1317,2011-07-01,03L,1245,796,2041,0.6099951004409603
1318,2011-07-01,03M,807,325,1132,0.7128975265017667
1319,2011-07-01,03N,3069,765,3834,0.8004694835680751
1320,2011-07-01,03Q,1692,812,2504,0.6757188498402555
1321,2011-07-01,03R,2130,794,2924,0.728454172366621
1322,2011-07-01,03T,1742,497,2239,0.7780259044216168
1323,2011-07-01,03V,364,223,587,0.6201022146507666
1324,2011-07-01,03W,1845,1019,2864,0.6442039106145251
1325,2011-07-01,03X,467,152,619,0.7544426494345718
1326,2011-07-01,03Y,636,274,910,0.6989010989010989
1327,2011-07-01,04C,1715,838,2553,0.6717587152369761
1328,2011-07-01,04D,1310,522,1832,0.7150655021834061
1329,2011-07-01,04E,1001,350,1351,0.7409326424870466
1330,2011-07-01,04F,1511,798,2309,0.6543958423559982
1331,2011-07-01,04G,3961,1710,5671,0.6984658790336802
1332,2011-07-01,04H,629,302,931,0.6756176154672395
1333,2011-07-01,04J,1865,912,2777,0.6715880446525027
1334,2011-07-01,04K,1552,605,2157,0.7195178488641631
1335,2011-07-01,04L,895,268,1163,0.7695614789337919
1336,2011-07-01,04M,487,204,691,0.7047756874095513
1337,2011-07-01,04N,681,290,971,0.7013388259526262
1338,2011-07-01,04Q,719,240,959,0.7497393117831074
1339,2011-07-01,04R,2375,1046,3421,0.6942414498684595
1340,2011-07-01,04V,1945,1059,3004,0.6474700399467377
1341,2011-07-01,04X,1285,836,2121,0.6058462989156058
1342,2011-07-01,04Y,811,291,1102,0.735934664246824
1343,2011-07-01,05A,2322,1176,3498,0.6638078902229846
1344,2011-07-01,05C,1089,1312,2401,0.453561016243232
1345,2011-07-01,05D,748,330,1078,0.6938775510204082
1346,2011-07-01,05F,1146,405,1551,0.7388781431334622
1347,2011-07-01,05G,1127,449,1576,0.7151015228426396
1348,2011-07-01,05H,1017,370,1387,0.7332372025955299
1349,2011-07-01,05J,1225,403,1628,0.7524570024570024
1350,2011-07-01,05L,2307,989,3296,0.6999393203883495
1351,2011-07-01,05N,2089,576,2665,0.7838649155722326
1352,2011-07-01,05P,1319,471,1790,0.7368715083798882
1353,2011-07-01,05Q,1237,407,1644,0.7524330900243309
1354,2011-07-01,05R,1604,800,2404,0.6672212978369384
1355,2011-07-01,05T,1810,675,2485,0.7283702213279678
1356,2011-07-01,05V,1024,376,1400,0.7314285714285714
1357,2011-07-01,05W,1299,637,1936,0.6709710743801653
1358,2011-07-01,05X,1082,334,1416,0.7641242937853108
1359,2011-07-01,05Y,1455,655,2110,0.6895734597156398
1360,2011-07-01,06A,1521,442,1963,0.7748344370860927
1361,2011-07-01,06D,769,262,1031,0.7458777885548011
1362,2011-07-01,06F,1576,2118,3694,0.42663779101245264
1363,2011-07-01,06H,4854,2203,7057,0.6878276888196118
1364,2011-07-01,06K,2928,1556,4484,0.6529884032114184
1365,2011-07-01,06L,2161,887,3048,0.708989501312336
1366,2011-07-01,06M,1765,803,2568,0.6873052959501558
1367,2011-07-01,06N,3033,1433,4466,0.6791312136139722
1368,2011-07-01,06P,943,670,1613,0.5846249225046497
1369,2011-07-01,06Q,2227,1034,3261,0.682919349892671
1370,2011-07-01,06T,2165,966,3131,0.691472373043756
1371,2011-07-01,06V,1379,509,1888,0.7304025423728814
1372,2011-07-01,06W,1481,372,1853,0.7992444684295736
1373,2011-07-01,06Y,1324,371,1695,0.7811209439528024
1374,2011-07-01,07G,822,353,1175,0.6995744680851064
1375,2011-07-01,07H,1557,838,2395,0.6501043841336117
1376,2011-07-01,07J,734,363,1097,0.6690975387420237
1377,2011-07-01,07K,1451,598,2049,0.7081503172279161
1378,2011-07-01,07L,701,250,951,0.7371188222923238
1379,2011-07-01,07M,1161,638,1799,0.6453585325180656
1380,2011-07-01,07N,1241,476,1717,0.7227722772277227
1381,2011-07-01,07P,772,289,1061,0.7276154571159283
1382,2011-07-01,07Q,1605,687,2292,0.7002617801047121
1383,2011-07-01,07R,664,352,1016,0.6535433070866141
1384,2011-07-01,07T,600,365,965,0.6217616580310881
1385,2011-07-01,07V,1664,633,2297,0.7244231606443187
1386,2011-07-01,07W,918,560,1478,0.6211096075778079
1387,2011-07-01,07X,1207,499,1706,0.7075029308323564
1388,2011-07-01,07Y,765,468,1233,0.6204379562043796
1389,2011-07-01,08A,1052,519,1571,0.6696371737746658
1390,2011-07-01,08C,461,259,720,0.6402777777777777
1391,2011-07-01,08D,858,411,1269,0.6761229314420804
1392,2011-07-01,08E,622,268,890,0.698876404494382
1393,2011-07-01,08F,1155,436,1591,0.725958516656191
1394,2011-07-01,08G,510,1316,1826,0.2792990142387733
1395,2011-07-01,08H,766,450,1216,0.6299342105263158
1396,2011-07-01,08J,717,322,1039,0.6900866217516843
1397,2011-07-01,08K,1033,386,1419,0.7279774489076815
1398,2011-07-01,08L,934,524,1458,0.6406035665294925
1399,2011-07-01,08M,1000,324,1324,0.7552870090634441
1400,2011-07-01,08N,1044,330,1374,0.759825327510917
1401,2011-07-01,08P,777,364,1141,0.6809815950920245
1402,2011-07-01,08Q,904,262,1166,0.7753001715265866
1403,2011-07-01,08R,794,329,1123,0.7070347284060552
1404,2011-07-01,08T,881,414,1295,0.6803088803088803
1405,2011-07-01,08V,930,328,1258,0.739268680445151
1406,2011-07-01,08W,1024,343,1367,0.7490855888807608
1407,2011-07-01,08X,1107,488,1595,0.6940438871473354
1408,2011-07-01,08Y,748,248,996,0.751004016064257
1409,2011-07-01,09A,466,315,781,0.5966709346991037
1410,2011-07-01,09C,724,279,1003,0.7218344965104686
1411,2011-07-01,09D,1466,643,2109,0.6951161688003793
1412,2011-07-01,09E,1251,324,1575,0.7942857142857143
1413,2011-07-01,09F,1222,579,1801,0.6785119378123264
1414,2011-07-01,09G,3055,1693,4748,0.6434288121314238
1415,2011-07-01,09H,685,257,942,0.727176220806794
1416,2011-07-01,09J,1494,575,2069,0.7220879652005799
1417,2011-07-01,09L,866,467,1333,0.6496624156039009
1418,2011-07-01,09N,1062,711,1773,0.5989847715736041
1419,2011-07-01,09P,1203,565,1768,0.6804298642533937
1420,2011-07-01,09W,1337,439,1776,0.7528153153153153
1421,2011-07-01,09X,1028,630,1658,0.6200241254523522
1422,2011-07-01,09Y,1640,1102,2742,0.5981035740335522
1423,2011-07-01,10A,1069,536,1605,0.6660436137071651
1424,2011-07-01,10C,451,289,740,0.6094594594594595
1425,2011-07-01,10D,551,157,708,0.7782485875706214
1426,2011-07-01,10E,641,291,932,0.6877682403433476
1427,2011-07-01,10G,595,258,853,0.6975381008206331
1428,2011-07-01,10H,1719,795,2514,0.6837708830548926
1429,2011-07-01,10J,998,915,1913,0.5216936748562467
1430,2011-07-01,10K,1105,654,1759,0.6281978396816373
1431,2011-07-01,10L,908,302,1210,0.7504132231404959
1432,2011-07-01,10M,552,311,863,0.6396292004634995
1433,2011-07-01,10N,501,282,783,0.6398467432950191
1434,2011-07-01,10Q,2377,2407,4784,0.4968645484949833
1435,2011-07-01,10R,1263,501,1764,0.7159863945578231
1436,2011-07-01,10T,512,199,711,0.720112517580872
1437,2011-07-01,10V,1164,753,1917,0.6071987480438185
1438,2011-07-01,10W,529,218,747,0.7081659973226239
1439,2011-07-01,10X,1180,529,1709,0.6904622586307783
1440,2011-07-01,10Y,1132,626,1758,0.6439135381114903
1441,2011-07-01,11A,3194,1661,4855,0.6578784757981463
1442,2011-07-01,11C,788,259,1047,0.7526265520534862
1443,2011-07-01,11D,692,434,1126,0.6145648312611013
1444,2011-07-01,11E,1209,633,1842,0.6563517915309446
1445,2011-07-01,11H,2350,1284,3634,0.6466703357182169
1446,2011-07-01,11J,4649,2543,7192,0.646412680756396
1447,2011-07-01,11M,3320,1593,4913,0.6757581925503765
1448,2011-07-01,11N,3859,1263,5122,0.753416634127294
1449,2011-07-01,11T,1410,769,2179,0.6470858191831115
1450,2011-07-01,11X,3427,1637,5064,0.67673775671406
1451,2011-07-01,12A,1406,704,2110,0.6663507109004739
1452,2011-07-01,12D,1071,486,1557,0.6878612716763006
1453,2011-07-01,12F,2413,455,2868,0.8413528591352859
1454,2011-07-01,13P,2969,1382,4351,0.6823718685359688
1455,2011-07-01,13T,2939,1178,4117,0.7138693223220792
1456,2011-07-01,14L,2684,1366,4050,0.662716049382716
1457,2011-07-01,99A,2564,708,3272,0.7836185819070904
1458,2011-07-01,99C,1448,701,2149,0.6738017682643089
1459,2011-07-01,99D,1035,447,1482,0.6983805668016194
1460,2011-07-01,99E,1483,509,1992,0.7444779116465864
1461,2011-07-01,99F,1039,256,1295,0.8023166023166023
1462,2011-07-01,99G,892,264,1156,0.7716262975778547
1463,2011-07-01,99H,1537,808,2345,0.6554371002132197
1464,2011-07-01,99J,2856,1179,4035,0.7078066914498141
1465,2011-07-01,99K,1031,515,1546,0.666882276843467
1466,2011-07-01,99M,1051,767,1818,0.5781078107810781
1467,2011-07-01,99N,2691,2176,4867,0.5529073351140333
1468,2011-07-01,99P,6013,2047,8060,0.746029776674938
1469,2011-07-01,99Q,1831,802,2633,0.6954044815799468
1470,2011-08-01,00C,722,279,1001,0.7212787212787213
1471,2011-08-01,00D,1988,988,2976,0.668010752688172
1472,2011-08-01,00F,21,13,34,0.6176470588235294
1473,2011-08-01,00J,1593,741,2334,0.6825192802056556
1474,2011-08-01,00K,2111,957,3068,0.6880704041720991
1475,2011-08-01,00L,2384,1441,3825,0.6232679738562091
1476,2011-08-01,00M,2086,923,3009,0.6932535726154869
1477,2011-08-01,00N,1116,607,1723,0.6477074869413814
1478,2011-08-01,00P,1845,653,2498,0.7385908726981585
1479,2011-08-01,00Q,894,312,1206,0.7412935323383084
1480,2011-08-01,00R,1231,368,1599,0.7698561601000625
1481,2011-08-01,00T,1940,811,2751,0.7051981097782625
1482,2011-08-01,00V,1255,601,1856,0.6761853448275862
1483,2011-08-01,00W,51,34,85,0.6
1484,2011-08-01,00X,915,231,1146,0.7984293193717278
1485,2011-08-01,00Y,1728,763,2491,0.6936973103171417
1486,2011-08-01,01A,2378,1049,3427,0.69390137146192
1487,2011-08-01,01C,1293,683,1976,0.6543522267206477
1488,2011-08-01,01D,1514,604,2118,0.7148253068932956
1489,2011-08-01,01E,1111,251,1362,0.815712187958884
1490,2011-08-01,01F,908,384,1292,0.7027863777089783
1491,2011-08-01,01G,1124,1101,2225,0.5051685393258427
1492,2011-08-01,01H,2481,682,3163,0.7843819159026241
1493,2011-08-01,01J,978,416,1394,0.7015781922525107
1494,2011-08-01,01K,2249,971,3220,0.6984472049689441
1495,2011-08-01,01N,20,13,33,0.6060606060606061
1496,2011-08-01,01R,949,520,1469,0.6460176991150443
1497,2011-08-01,01T,777,402,1179,0.6590330788804071
1498,2011-08-01,01V,802,302,1104,0.7264492753623188
1499,2011-08-01,01W,1772,695,2467,0.7182813133360356
1500,2011-08-01,01X,1476,578,2054,0.7185978578383642
1501,2011-08-01,01Y,1398,581,1979,0.7064173825164224
1502,2011-08-01,02A,1304,698,2002,0.6513486513486514
1503,2011-08-01,02D,549,328,877,0.6259977194982896
1504,2011-08-01,02E,1130,470,1600,0.70625
1505,2011-08-01,02F,1590,541,2131,0.7461285781323322
1506,2011-08-01,02G,658,310,968,0.6797520661157025
1507,2011-08-01,02H,1669,1404,3073,0.5431174747803449
1508,2011-08-01,02M,922,334,1256,0.7340764331210191
1509,2011-08-01,02N,995,456,1451,0.6857339765678843
1510,2011-08-01,02P,1073,958,2031,0.5283111767602167
1511,2011-08-01,02Q,613,353,966,0.634575569358178
1512,2011-08-01,02R,1974,721,2695,0.7324675324675325
1513,2011-08-01,02T,945,482,1427,0.662228451296426
1514,2011-08-01,02V,1296,587,1883,0.6882634094530006
1515,2011-08-01,02W,545,156,701,0.7774607703281027
1516,2011-08-01,02X,1944,828,2772,0.7012987012987013
1517,2011-08-01,02Y,1738,830,2568,0.676791277258567
1518,2011-08-01,03A,1168,452,1620,0.7209876543209877
1519,2011-08-01,03C,1820,907,2727,0.6674000733406674
1520,2011-08-01,03D,807,324,1131,0.713527851458886
1521,2011-08-01,03E,934,391,1325,0.7049056603773585
1522,2011-08-01,03F,1489,524,2013,0.739692001987084
1523,2011-08-01,03G,1626,664,2290,0.7100436681222707
1524,2011-08-01,03H,1088,400,1488,0.7311827956989247
1525,2011-08-01,03J,1071,339,1410,0.7595744680851064
1526,2011-08-01,03K,981,247,1228,0.7988599348534202
1527,2011-08-01,03L,1196,865,2061,0.5803008248423096
1528,2011-08-01,03M,806,335,1141,0.7063978965819456
1529,2011-08-01,03N,3157,851,4008,0.7876746506986028
1530,2011-08-01,03Q,1717,837,2554,0.6722787783868441
1531,2011-08-01,03R,2233,827,3060,0.7297385620915032
1532,2011-08-01,03T,1826,495,2321,0.7867298578199052
1533,2011-08-01,03V,395,275,670,0.5895522388059702
1534,2011-08-01,03W,1964,1056,3020,0.6503311258278146
1535,2011-08-01,03X,445,171,616,0.7224025974025974
1536,2011-08-01,03Y,637,330,967,0.6587383660806618
1537,2011-08-01,04C,1769,845,2614,0.6767406273909717
1538,2011-08-01,04D,1329,583,1912,0.6950836820083682
1539,2011-08-01,04E,1021,377,1398,0.7303290414878397
1540,2011-08-01,04F,1434,815,2249,0.637616718541574
1541,2011-08-01,04G,4065,1885,5950,0.6831932773109244
1542,2011-08-01,04H,718,315,1033,0.6950629235237173
1543,2011-08-01,04J,2020,949,2969,0.6803637588413607
1544,2011-08-01,04K,1607,602,2209,0.7274784970574921
1545,2011-08-01,04L,785,300,1085,0.7235023041474654
1546,2011-08-01,04M,566,224,790,0.7164556962025317
1547,2011-08-01,04N,701,262,963,0.7279335410176532
1548,2011-08-01,04Q,801,277,1078,0.7430426716141002
1549,2011-08-01,04R,2569,1065,3634,0.7069345074298294
1550,2011-08-01,04V,2169,1102,3271,0.6630999694283094
1551,2011-08-01,04X,1382,933,2315,0.5969762419006479
1552,2011-08-01,04Y,927,317,1244,0.7451768488745981
1553,2011-08-01,05A,2471,1238,3709,0.6662173092477757
1554,2011-08-01,05C,1195,1396,2591,0.4612118873021999
1555,2011-08-01,05D,811,375,1186,0.6838111298482293
1556,2011-08-01,05F,1160,416,1576,0.7360406091370558
1557,2011-08-01,05G,1153,502,1655,0.6966767371601208
1558,2011-08-01,05H,1055,415,1470,0.717687074829932
1559,2011-08-01,05J,1315,430,1745,0.7535816618911175
1560,2011-08-01,05L,2331,1033,3364,0.6929250891795482
1561,2011-08-01,05N,2109,599,2708,0.7788035450516987
1562,2011-08-01,05P,1337,452,1789,0.7473448854108441
1563,2011-08-01,05Q,1234,410,1644,0.7506082725060828
1564,2011-08-01,05R,1706,791,2497,0.6832198638366039
1565,2011-08-01,05T,1870,756,2626,0.7121096725057121
1566,2011-08-01,05V,1039,374,1413,0.7353149327671621
1567,2011-08-01,05W,1319,653,1972,0.6688640973630832
1568,2011-08-01,05X,1213,357,1570,0.7726114649681529
1569,2011-08-01,05Y,1604,651,2255,0.7113082039911308
1570,2011-08-01,06A,1545,481,2026,0.7625863770977295
1571,2011-08-01,06D,801,293,1094,0.7321755027422303
1572,2011-08-01,06F,1639,2225,3864,0.4241718426501035
1573,2011-08-01,06H,5079,2423,7502,0.6770194614769395
1574,2011-08-01,06K,3117,1786,4903,0.635733224556394
1575,2011-08-01,06L,2304,888,3192,0.7218045112781954
1576,2011-08-01,06M,1942,859,2801,0.6933238129239557
1577,2011-08-01,06N,3224,1667,4891,0.6591699039051319
1578,2011-08-01,06P,973,651,1624,0.5991379310344828
1579,2011-08-01,06Q,2238,1144,3382,0.6617386162034299
1580,2011-08-01,06T,2209,974,3183,0.6939993716619541
1581,2011-08-01,06V,1366,490,1856,0.7359913793103449
1582,2011-08-01,06W,1671,396,2067,0.8084179970972424
1583,2011-08-01,06Y,1315,352,1667,0.7888422315536893
1584,2011-08-01,07G,901,361,1262,0.713946117274168
1585,2011-08-01,07H,1506,943,2449,0.6149448754593712
1586,2011-08-01,07J,745,384,1129,0.6598759964570416
1587,2011-08-01,07K,1458,603,2061,0.7074235807860262
1588,2011-08-01,07L,743,214,957,0.7763845350052246
1589,2011-08-01,07M,1247,609,1856,0.671875
1590,2011-08-01,07N,1244,529,1773,0.7016356457980824
1591,2011-08-01,07P,698,246,944,0.739406779661017
1592,2011-08-01,07Q,1698,744,2442,0.6953316953316954
1593,2011-08-01,07R,727,372,1099,0.6615104640582348
1594,2011-08-01,07T,565,338,903,0.6256921373200443
1595,2011-08-01,07V,1666,691,2357,0.7068307170131524
1596,2011-08-01,07W,996,558,1554,0.640926640926641
1597,2011-08-01,07X,1216,532,1748,0.6956521739130435
1598,2011-08-01,07Y,832,481,1313,0.6336633663366337
1599,2011-08-01,08A,1187,551,1738,0.6829689298043728
1600,2011-08-01,08C,486,312,798,0.6090225563909775
1601,2011-08-01,08D,855,397,1252,0.6829073482428115
1602,2011-08-01,08E,737,310,1047,0.7039159503342884
1603,2011-08-01,08F,1276,481,1757,0.726237905520774
1604,2011-08-01,08G,506,1284,1790,0.28268156424581004
1605,2011-08-01,08H,809,452,1261,0.6415543219666932
1606,2011-08-01,08J,755,373,1128,0.6693262411347518
1607,2011-08-01,08K,1133,426,1559,0.72674791533034
1608,2011-08-01,08L,919,556,1475,0.6230508474576271
1609,2011-08-01,08M,950,349,1299,0.7313317936874519
1610,2011-08-01,08N,1050,321,1371,0.7658643326039387
1611,2011-08-01,08P,834,331,1165,0.7158798283261802
1612,2011-08-01,08Q,930,301,1231,0.7554833468724614
1613,2011-08-01,08R,815,318,1133,0.7193292144748455
1614,2011-08-01,08T,957,417,1374,0.6965065502183406
1615,2011-08-01,08V,920,311,1231,0.7473598700243704
1616,2011-08-01,08W,1048,304,1352,0.7751479289940828
1617,2011-08-01,08X,1209,507,1716,0.7045454545454546
1618,2011-08-01,08Y,711,286,997,0.7131394182547643
1619,2011-08-01,09A,488,302,790,0.6177215189873417
1620,2011-08-01,09C,686,352,1038,0.6608863198458574
1621,2011-08-01,09D,1493,776,2269,0.6579991185544293
1622,2011-08-01,09E,1443,427,1870,0.7716577540106951
1623,2011-08-01,09F,1343,595,1938,0.6929824561403509
1624,2011-08-01,09G,3241,1788,5029,0.6444621197057069
1625,2011-08-01,09H,698,285,983,0.7100712105798576
1626,2011-08-01,09J,1528,635,2163,0.7064262598243181
1627,2011-08-01,09L,826,436,1262,0.6545166402535658
1628,2011-08-01,09N,1102,727,1829,0.6025150355385457
1629,2011-08-01,09P,1294,663,1957,0.6612161471640265
1630,2011-08-01,09W,1337,455,1792,0.74609375
1631,2011-08-01,09X,1099,651,1750,0.628
1632,2011-08-01,09Y,1723,1190,2913,0.5914864400961208
1633,2011-08-01,10A,1182,568,1750,0.6754285714285714
1634,2011-08-01,10C,545,265,810,0.6728395061728395
1635,2011-08-01,10D,589,216,805,0.7316770186335404
1636,2011-08-01,10E,796,290,1086,0.7329650092081031
1637,2011-08-01,10G,712,288,1000,0.712
1638,2011-08-01,10H,1763,825,2588,0.6812210200927357
1639,2011-08-01,10J,1039,977,2016,0.5153769841269841
1640,2011-08-01,10K,1212,653,1865,0.6498659517426274
1641,2011-08-01,10L,1018,376,1394,0.7302725968436155
1642,2011-08-01,10M,517,326,843,0.6132858837485172
1643,2011-08-01,10N,515,290,805,0.639751552795031
1644,2011-08-01,10Q,2410,2429,4839,0.4980367844595991
1645,2011-08-01,10R,1319,545,1864,0.7076180257510729
1646,2011-08-01,10T,479,228,707,0.6775106082036775
1647,2011-08-01,10V,1216,780,1996,0.6092184368737475
1648,2011-08-01,10W,592,289,881,0.6719636776390465
1649,2011-08-01,10X,1256,577,1833,0.685215493726132
1650,2011-08-01,10Y,1218,662,1880,0.6478723404255319
1651,2011-08-01,11A,3385,1829,5214,0.6492136555427694
1652,2011-08-01,11C,819,272,1091,0.7506874427131073
1653,2011-08-01,11D,667,402,1069,0.6239476145930777
1654,2011-08-01,11E,1266,638,1904,0.6649159663865546
1655,2011-08-01,11H,2483,1310,3793,0.6546269443712102
1656,2011-08-01,11J,5074,2571,7645,0.6637017658600393
1657,2011-08-01,11M,3575,1724,5299,0.6746555953953576
1658,2011-08-01,11N,4270,1296,5566,0.7671577434423285
1659,2011-08-01,11T,1394,834,2228,0.625673249551167
1660,2011-08-01,11X,3669,1866,5535,0.6628726287262873
1661,2011-08-01,12A,1454,723,2177,0.66789159393661
1662,2011-08-01,12D,1134,527,1661,0.6827212522576761
1663,2011-08-01,12F,2512,459,2971,0.845506563446651
1664,2011-08-01,13P,3046,1278,4324,0.7044403330249769
1665,2011-08-01,13T,3125,1248,4373,0.7146123942373657
1666,2011-08-01,14L,2712,1317,4029,0.6731198808637379
1667,2011-08-01,99A,2723,732,3455,0.7881331403762663
1668,2011-08-01,99C,1614,730,2344,0.6885665529010239
1669,2011-08-01,99D,1047,475,1522,0.687910643889619
1670,2011-08-01,99E,1560,538,2098,0.7435653002859867
1671,2011-08-01,99F,1147,344,1491,0.7692823608316566
1672,2011-08-01,99G,932,211,1143,0.8153980752405949
1673,2011-08-01,99H,1490,873,2363,0.6305543800253914
1674,2011-08-01,99J,2933,1160,4093,0.7165892988028341
1675,2011-08-01,99K,1032,603,1635,0.6311926605504588
1676,2011-08-01,99M,1128,859,1987,0.5676899849018621
1677,2011-08-01,99N,2693,2351,5044,0.5339016653449643
1678,2011-08-01,99P,6467,2191,8658,0.746939246939247
1679,2011-08-01,99Q,2015,792,2807,0.7178482365514784
1680,2011-09-01,00C,722,287,1009,0.7155599603567889
1681,2011-09-01,00D,2166,999,3165,0.6843601895734597
1682,2011-09-01,00F,25,12,37,0.6756756756756757
1683,2011-09-01,00J,1645,742,2387,0.6891495601173021
1684,2011-09-01,00K,2184,1044,3228,0.6765799256505576
1685,2011-09-01,00L,2426,1522,3948,0.6144883485309017
1686,2011-09-01,00M,2133,918,3051,0.6991150442477876
1687,2011-09-01,00N,1124,639,1763,0.6375496313102665
1688,2011-09-01,00P,2010,666,2676,0.7511210762331838
1689,2011-09-01,00Q,974,333,1307,0.7452180566182096
1690,2011-09-01,00R,1193,389,1582,0.7541087231352718
1691,2011-09-01,00T,1938,833,2771,0.6993865030674846
1692,2011-09-01,00V,1232,580,1812,0.6799116997792495
1693,2011-09-01,00W,79,25,104,0.7596153846153846
1694,2011-09-01,00X,1001,294,1295,0.772972972972973
1695,2011-09-01,00Y,1856,828,2684,0.6915052160953801
1696,2011-09-01,01A,2432,1180,3612,0.6733111849390919
1697,2011-09-01,01C,1395,665,2060,0.6771844660194175
1698,2011-09-01,01D,1548,690,2238,0.6916890080428955
1699,2011-09-01,01E,1142,237,1379,0.8281363306744017
1700,2011-09-01,01F,922,378,1300,0.7092307692307692
1701,2011-09-01,01G,1171,1135,2306,0.5078057241977451
1702,2011-09-01,01H,2506,712,3218,0.7787445618396519
1703,2011-09-01,01J,982,419,1401,0.7009279086366881
1704,2011-09-01,01K,2307,1107,3414,0.6757469244288224
1705,2011-09-01,01N,29,13,42,0.6904761904761905
1706,2011-09-01,01R,1096,556,1652,0.6634382566585957
1707,2011-09-01,01T,794,397,1191,0.6666666666666666
1708,2011-09-01,01V,842,315,1157,0.7277441659464131
1709,2011-09-01,01W,1795,717,2512,0.7145700636942676
1710,2011-09-01,01X,1512,615,2127,0.7108603667136812
1711,2011-09-01,01Y,1476,608,2084,0.708253358925144
1712,2011-09-01,02A,1454,671,2125,0.684235294117647
1713,2011-09-01,02D,591,351,942,0.6273885350318471
1714,2011-09-01,02E,1288,567,1855,0.6943396226415094
1715,2011-09-01,02F,1632,583,2215,0.7367945823927765
1716,2011-09-01,02G,702,315,1017,0.6902654867256637
1717,2011-09-01,02H,1790,1408,3198,0.5597248280175109
1718,2011-09-01,02M,1001,335,1336,0.749251497005988
1719,2011-09-01,02N,1045,464,1509,0.6925115970841617
1720,2011-09-01,02P,1179,986,2165,0.5445727482678984
1721,2011-09-01,02Q,633,394,1027,0.6163583252190847
1722,2011-09-01,02R,2033,711,2744,0.7408892128279884
1723,2011-09-01,02T,1005,502,1507,0.6668878566688786
1724,2011-09-01,02V,1343,648,1991,0.6745354093420391
1725,2011-09-01,02W,610,144,754,0.8090185676392573
1726,2011-09-01,02X,2019,969,2988,0.6757028112449799
1727,2011-09-01,02Y,1930,772,2702,0.7142857142857143
1728,2011-09-01,03A,1232,482,1714,0.7187864644107351
1729,2011-09-01,03C,1833,957,2790,0.656989247311828
1730,2011-09-01,03D,874,317,1191,0.7338371116708649
1731,2011-09-01,03E,993,469,1462,0.6792065663474692
1732,2011-09-01,03F,1469,556,2025,0.7254320987654321
1733,2011-09-01,03G,1592,692,2284,0.6970227670753065
1734,2011-09-01,03H,1236,446,1682,0.7348394768133175
1735,2011-09-01,03J,1144,374,1518,0.7536231884057971
1736,2011-09-01,03K,1092,230,1322,0.8260211800302572
1737,2011-09-01,03L,1310,891,2201,0.595184007269423
1738,2011-09-01,03M,790,363,1153,0.6851691240242844
1739,2011-09-01,03N,3282,738,4020,0.8164179104477612
1740,2011-09-01,03Q,1807,864,2671,0.6765256458255335
1741,2011-09-01,03R,2349,954,3303,0.7111716621253406
1742,2011-09-01,03T,1820,512,2332,0.7804459691252144
1743,2011-09-01,03V,437,238,675,0.6474074074074074
1744,2011-09-01,03W,2049,1101,3150,0.6504761904761904
1745,2011-09-01,03X,486,188,674,0.7210682492581603
1746,2011-09-01,03Y,629,318,947,0.6642027455121436
1747,2011-09-01,04C,2010,926,2936,0.6846049046321526
1748,2011-09-01,04D,1443,590,2033,0.7097884899163798
1749,2011-09-01,04E,1113,451,1564,0.7116368286445013
1750,2011-09-01,04F,1524,899,2423,0.6289723483285183
1751,2011-09-01,04G,4095,1973,6068,0.674851680949242
1752,2011-09-01,04H,723,365,1088,0.6645220588235294
1753,2011-09-01,04J,1943,945,2888,0.6727839335180056
1754,2011-09-01,04K,1727,620,2347,0.735832978270132
1755,2011-09-01,04L,823,287,1110,0.7414414414414414
1756,2011-09-01,04M,592,218,810,0.7308641975308642
1757,2011-09-01,04N,755,299,1054,0.7163187855787476
1758,2011-09-01,04Q,817,279,1096,0.7454379562043796
1759,2011-09-01,04R,2748,1201,3949,0.6958723727525956
1760,2011-09-01,04V,2328,1133,3461,0.6726379659058076
1761,2011-09-01,04X,1335,966,2301,0.5801825293350718
1762,2011-09-01,04Y,925,312,1237,0.7477768795472919
1763,2011-09-01,05A,2626,1176,3802,0.6906891109942136
1764,2011-09-01,05C,1160,1579,2739,0.4235122307411464
1765,2011-09-01,05D,771,396,1167,0.6606683804627249
1766,2011-09-01,05F,1277,466,1743,0.7326448651749856
1767,2011-09-01,05G,1333,496,1829,0.7288135593220338
1768,2011-09-01,05H,1114,471,1585,0.7028391167192429
1769,2011-09-01,05J,1371,401,1772,0.7737020316027088
1770,2011-09-01,05L,2583,1106,3689,0.7001897533206831
1771,2011-09-01,05N,2245,630,2875,0.7808695652173913
1772,2011-09-01,05P,1330,549,1879,0.707823310271421
1773,2011-09-01,05Q,1311,470,1781,0.7361033127456486
1774,2011-09-01,05R,1729,845,2574,0.6717171717171717
1775,2011-09-01,05T,2040,745,2785,0.7324955116696589
1776,2011-09-01,05V,1071,412,1483,0.7221847606203641
1777,2011-09-01,05W,1392,674,2066,0.6737657308809293
1778,2011-09-01,05X,1259,344,1603,0.785402370555209
1779,2011-09-01,05Y,1675,751,2426,0.690436933223413
1780,2011-09-01,06A,1605,526,2131,0.7531675269826372
1781,2011-09-01,06D,860,323,1183,0.7269653423499577
1782,2011-09-01,06F,1686,2364,4050,0.4162962962962963
1783,2011-09-01,06H,5286,2422,7708,0.6857810067462377
1784,2011-09-01,06K,3294,1791,5085,0.647787610619469
1785,2011-09-01,06L,2453,952,3405,0.7204111600587372
1786,2011-09-01,06M,1922,906,2828,0.6796322489391796
1787,2011-09-01,06N,3278,1731,5009,0.6544220403274107
1788,2011-09-01,06P,1029,700,1729,0.5951417004048583
1789,2011-09-01,06Q,2375,1176,3551,0.6688256829062236
1790,2011-09-01,06T,2304,1033,3337,0.6904405154330236
1791,2011-09-01,06V,1463,469,1932,0.7572463768115942
1792,2011-09-01,06W,1637,416,2053,0.7973697028738431
1793,2011-09-01,06Y,1342,399,1741,0.7708213670304422
1794,2011-09-01,07G,949,341,1290,0.7356589147286822
1795,2011-09-01,07H,1661,922,2583,0.6430507162214479
1796,2011-09-01,07J,817,377,1194,0.6842546063651591
1797,2011-09-01,07K,1542,640,2182,0.7066911090742438
1798,2011-09-01,07L,788,265,1053,0.748338081671415
1799,2011-09-01,07M,1303,649,1952,0.6675204918032787
1800,2011-09-01,07N,1350,551,1901,0.7101525512887954
1801,2011-09-01,07P,841,253,1094,0.7687385740402194
1802,2011-09-01,07Q,1764,751,2515,0.7013916500994036
1803,2011-09-01,07R,735,435,1170,0.6282051282051282
1804,2011-09-01,07T,628,383,1011,0.6211671612265084
1805,2011-09-01,07V,1835,690,2525,0.7267326732673267
1806,2011-09-01,07W,972,657,1629,0.5966850828729282
1807,2011-09-01,07X,1395,585,1980,0.7045454545454546
1808,2011-09-01,07Y,889,515,1404,0.6331908831908832
1809,2011-09-01,08A,1263,543,1806,0.6993355481727574
1810,2011-09-01,08C,619,350,969,0.6388028895768834
1811,2011-09-01,08D,958,437,1395,0.6867383512544802
1812,2011-09-01,08E,726,355,1081,0.6716003700277521
1813,2011-09-01,08F,1390,483,1873,0.7421249332621462
1814,2011-09-01,08G,537,1384,1921,0.2795419052576783
1815,2011-09-01,08H,809,490,1299,0.6227867590454196
1816,2011-09-01,08J,765,348,1113,0.6873315363881402
1817,2011-09-01,08K,1279,449,1728,0.7401620370370371
1818,2011-09-01,08L,1038,611,1649,0.6294724075197089
1819,2011-09-01,08M,1062,363,1425,0.7452631578947368
1820,2011-09-01,08N,1147,359,1506,0.7616201859229748
1821,2011-09-01,08P,948,396,1344,0.7053571428571429
1822,2011-09-01,08Q,1076,317,1393,0.7724335965541995
1823,2011-09-01,08R,898,365,1263,0.7110055423594616
1824,2011-09-01,08T,1013,405,1418,0.7143864598025388
1825,2011-09-01,08V,1053,320,1373,0.7669337217771304
1826,2011-09-01,08W,1085,323,1408,0.7705965909090909
1827,2011-09-01,08X,1337,530,1867,0.7161221210498125
1828,2011-09-01,08Y,735,309,1044,0.7040229885057471
1829,2011-09-01,09A,539,328,867,0.621683967704729
1830,2011-09-01,09C,733,326,1059,0.6921624173748819
1831,2011-09-01,09D,1625,849,2474,0.6568310428455941
1832,2011-09-01,09E,1523,449,1972,0.7723123732251521
1833,2011-09-01,09F,1452,565,2017,0.7198810114030739
1834,2011-09-01,09G,3307,1890,5197,0.6363286511448912
1835,2011-09-01,09H,631,270,901,0.7003329633740288
1836,2011-09-01,09J,1556,685,2241,0.6943328871039715
1837,2011-09-01,09L,837,471,1308,0.6399082568807339
1838,2011-09-01,09N,1219,749,1968,0.619410569105691
1839,2011-09-01,09P,1321,659,1980,0.6671717171717172
1840,2011-09-01,09W,1508,524,2032,0.7421259842519685
1841,2011-09-01,09X,1162,703,1865,0.6230563002680966
1842,2011-09-01,09Y,1757,1119,2876,0.6109179415855355
1843,2011-09-01,10A,1255,597,1852,0.677645788336933
1844,2011-09-01,10C,526,294,820,0.6414634146341464
1845,2011-09-01,10D,571,219,790,0.7227848101265822
1846,2011-09-01,10E,850,330,1180,0.7203389830508474
1847,2011-09-01,10G,671,290,961,0.6982310093652445
1848,2011-09-01,10H,1905,936,2841,0.6705385427666315
1849,2011-09-01,10J,1007,973,1980,0.5085858585858586
1850,2011-09-01,10K,1229,663,1892,0.6495771670190275
1851,2011-09-01,10L,989,356,1345,0.7353159851301115
1852,2011-09-01,10M,560,360,920,0.6086956521739131
1853,2011-09-01,10N,522,325,847,0.6162927981109799
1854,2011-09-01,10Q,2637,2731,5368,0.4912444113263785
1855,2011-09-01,10R,1405,536,1941,0.7238536836682122
1856,2011-09-01,10T,558,231,789,0.7072243346007605
1857,2011-09-01,10V,1245,869,2114,0.5889309366130558
1858,2011-09-01,10W,572,240,812,0.7044334975369458
1859,2011-09-01,10X,1314,597,1911,0.6875981161695447
1860,2011-09-01,10Y,1290,743,2033,0.6345302508607968
1861,2011-09-01,11A,3477,1882,5359,0.6488150774398208
1862,2011-09-01,11C,768,310,1078,0.712430426716141
1863,2011-09-01,11D,683,490,1173,0.5822676896845694
1864,2011-09-01,11E,1241,698,1939,0.6400206291903043
1865,2011-09-01,11H,2658,1336,3994,0.6654982473710566
1866,2011-09-01,11J,4973,2596,7569,0.6570220636808033
1867,2011-09-01,11M,3641,1808,5449,0.6681959992659203
1868,2011-09-01,11N,4232,1384,5616,0.7535612535612536
1869,2011-09-01,11T,1616,846,2462,0.6563769293257514
1870,2011-09-01,11X,3627,1872,5499,0.6595744680851063
1871,2011-09-01,12A,1518,751,2269,0.6690171881886293
1872,2011-09-01,12D,1149,558,1707,0.6731107205623902
1873,2011-09-01,12F,2554,455,3009,0.848786972416085
1874,2011-09-01,13P,3327,1513,4840,0.687396694214876
1875,2011-09-01,13T,3232,1290,4522,0.7147279964617426
1876,2011-09-01,14L,2901,1546,4447,0.6523498988081853
1877,2011-09-01,99A,2854,727,3581,0.7969840826584753
1878,2011-09-01,99C,1663,704,2367,0.7025771018166456
1879,2011-09-01,99D,1189,509,1698,0.7002355712603062
1880,2011-09-01,99E,1576,536,2112,0.7462121212121212
1881,2011-09-01,99F,1206,332,1538,0.7841352405721717
1882,2011-09-01,99G,1000,252,1252,0.7987220447284346
1883,2011-09-01,99H,1616,877,2493,0.6482150020056158
1884,2011-09-01,99J,3210,1291,4501,0.7131748500333259
1885,2011-09-01,99K,1141,592,1733,0.6583958453548759
1886,2011-09-01,99M,1188,856,2044,0.5812133072407045
1887,2011-09-01,99N,2876,2289,5165,0.5568247821878025
1888,2011-09-01,99P,6589,2330,8919,0.7387599506671152
1889,2011-09-01,99Q,2153,824,2977,0.7232112865300638
1890,2011-10-01,00C,760,290,1050,0.7238095238095238
1891,2011-10-01,00D,1951,968,2919,0.6683795820486468
1892,2011-10-01,00F,19,10,29,0.6551724137931034
1893,2011-10-01,00J,1640,711,2351,0.6975754997873246
1894,2011-10-01,00K,1970,1006,2976,0.6619623655913979
1895,2011-10-01,00L,2261,1332,3593,0.6292791539103813
1896,2011-10-01,00M,2095,918,3013,0.6953202787919017
1897,2011-10-01,00N,1093,545,1638,0.6672771672771672
1898,2011-10-01,00P,1858,659,2517,0.7381803734604688
1899,2011-10-01,00Q,967,319,1286,0.7519440124416796
1900,2011-10-01,00R,1175,365,1540,0.762987012987013
1901,2011-10-01,00T,1844,757,2601,0.708958093041138
1902,2011-10-01,00V,1230,599,1829,0.6724986331328595
1903,2011-10-01,00W,56,20,76,0.7368421052631579
1904,2011-10-01,00X,949,218,1167,0.8131962296486718
1905,2011-10-01,00Y,1769,785,2554,0.6926389976507439
1906,2011-10-01,01A,2141,1046,3187,0.6717916535927204
1907,2011-10-01,01C,1306,679,1985,0.6579345088161209
1908,2011-10-01,01D,1425,674,2099,0.6788947117675084
1909,2011-10-01,01E,1142,202,1344,0.8497023809523809
1910,2011-10-01,01F,839,377,1216,0.6899671052631579
1911,2011-10-01,01G,1154,1084,2238,0.515638963360143
1912,2011-10-01,01H,2424,733,3157,0.7678175483053532
1913,2011-10-01,01J,955,451,1406,0.6792318634423897
1914,2011-10-01,01K,2169,1103,3272,0.6628973105134475
1915,2011-10-01,01N,31,13,44,0.7045454545454546
1916,2011-10-01,01R,980,509,1489,0.6581598388179987
1917,2011-10-01,01T,877,370,1247,0.7032878909382518
1918,2011-10-01,01V,754,301,1055,0.7146919431279621
1919,2011-10-01,01W,1705,709,2414,0.7062966031483016
1920,2011-10-01,01X,1328,533,1861,0.7135948414830736
1921,2011-10-01,01Y,1348,607,1955,0.6895140664961636
1922,2011-10-01,02A,1329,729,2058,0.6457725947521866
1923,2011-10-01,02D,563,315,878,0.6412300683371298
1924,2011-10-01,02E,1142,498,1640,0.6963414634146341
1925,2011-10-01,02F,1554,606,2160,0.7194444444444444
1926,2011-10-01,02G,611,339,950,0.6431578947368422
1927,2011-10-01,02H,1687,1397,3084,0.5470168612191959
1928,2011-10-01,02M,955,354,1309,0.7295645530939648
1929,2011-10-01,02N,1019,455,1474,0.6913161465400272
1930,2011-10-01,02P,1148,938,2086,0.5503355704697986
1931,2011-10-01,02Q,539,416,955,0.5643979057591623
1932,2011-10-01,02R,1956,733,2689,0.7274079583488285
1933,2011-10-01,02T,960,529,1489,0.6447280053727333
1934,2011-10-01,02V,1275,673,1948,0.6545174537987679
1935,2011-10-01,02W,568,173,741,0.766531713900135
1936,2011-10-01,02X,1935,995,2930,0.6604095563139932
1937,2011-10-01,02Y,1802,709,2511,0.7176423735563521
1938,2011-10-01,03A,1180,517,1697,0.6953447259870359
1939,2011-10-01,03C,1754,999,2753,0.6371231383944788
1940,2011-10-01,03D,830,306,1136,0.7306338028169014
1941,2011-10-01,03E,921,438,1359,0.6777041942604857
1942,2011-10-01,03F,1454,547,2001,0.7266366816591704
1943,2011-10-01,03G,1604,646,2250,0.7128888888888889
1944,2011-10-01,03H,1118,426,1544,0.7240932642487047
1945,2011-10-01,03J,1036,383,1419,0.7300916138125441
1946,2011-10-01,03K,1026,218,1244,0.8247588424437299
1947,2011-10-01,03L,1156,841,1997,0.5788683024536805
1948,2011-10-01,03M,770,355,1125,0.6844444444444444
1949,2011-10-01,03N,3212,794,4006,0.8017973040439341
1950,2011-10-01,03Q,1826,891,2717,0.6720647773279352
1951,2011-10-01,03R,2200,950,3150,0.6984126984126984
1952,2011-10-01,03T,1646,478,2124,0.7749529190207156
1953,2011-10-01,03V,392,242,634,0.6182965299684543
1954,2011-10-01,03W,2055,1085,3140,0.6544585987261147
1955,2011-10-01,03X,473,162,635,0.7448818897637796
1956,2011-10-01,03Y,616,293,909,0.6776677667766776
1957,2011-10-01,04C,1965,887,2852,0.6889901823281908
1958,2011-10-01,04D,1297,555,1852,0.7003239740820735
1959,2011-10-01,04E,1077,478,1555,0.692604501607717
1960,2011-10-01,04F,1485,850,2335,0.6359743040685225
1961,2011-10-01,04G,4028,1852,5880,0.6850340136054421
1962,2011-10-01,04H,637,304,941,0.6769394261424017
1963,2011-10-01,04J,1867,928,2795,0.6679785330948121
1964,2011-10-01,04K,1668,686,2354,0.7085811384876806
1965,2011-10-01,04L,807,268,1075,0.7506976744186047
1966,2011-10-01,04M,551,191,742,0.7425876010781671
1967,2011-10-01,04N,725,279,1004,0.7221115537848606
1968,2011-10-01,04Q,835,279,1114,0.7495511669658886
1969,2011-10-01,04R,2623,1213,3836,0.6837851929092805
1970,2011-10-01,04V,2211,1097,3308,0.6683796856106409
1971,2011-10-01,04X,1367,978,2345,0.5829424307036247
1972,2011-10-01,04Y,876,346,1222,0.7168576104746317
1973,2011-10-01,05A,2518,1235,3753,0.6709299227284838
1974,2011-10-01,05C,1140,1467,2607,0.4372842347525892
1975,2011-10-01,05D,740,389,1129,0.6554472984942427
1976,2011-10-01,05F,1255,388,1643,0.7638466220328667
1977,2011-10-01,05G,1219,478,1697,0.718326458456099
1978,2011-10-01,05H,1025,396,1421,0.7213230119634061
1979,2011-10-01,05J,1294,397,1691,0.7652276759314015
1980,2011-10-01,05L,2497,1060,3557,0.7019960640989598
1981,2011-10-01,05N,2108,595,2703,0.779874213836478
1982,2011-10-01,05P,1424,496,1920,0.7416666666666667
1983,2011-10-01,05Q,1314,449,1763,0.7453204764605785
1984,2011-10-01,05R,1639,839,2478,0.6614205004035513
1985,2011-10-01,05T,2041,715,2756,0.7405660377358491
1986,2011-10-01,05V,1001,425,1426,0.7019635343618513
1987,2011-10-01,05W,1444,697,2141,0.674451191032228
1988,2011-10-01,05X,1224,321,1545,0.7922330097087379
1989,2011-10-01,05Y,1521,733,2254,0.6748003549245786
1990,2011-10-01,06A,1511,532,2043,0.7395986294664709
1991,2011-10-01,06D,860,317,1177,0.7306711979609176
1992,2011-10-01,06F,1546,2208,3754,0.4118273841236015
1993,2011-10-01,06H,4979,2417,7396,0.6732017306652245
1994,2011-10-01,06K,3013,1702,4715,0.6390243902439025
1995,2011-10-01,06L,2359,974,3333,0.7077707770777077
1996,2011-10-01,06M,1904,896,2800,0.68
1997,2011-10-01,06N,3226,1776,5002,0.6449420231907237
1998,2011-10-01,06P,949,671,1620,0.5858024691358025
1999,2011-10-01,06Q,2297,1195,3492,0.6577892325315006
2000,2011-10-01,06T,2179,1007,3186,0.6839296924042687
2001,2011-10-01,06V,1338,482,1820,0.7351648351648352
2002,2011-10-01,06W,1519,382,1901,0.7990531299316149
2003,2011-10-01,06Y,1286,418,1704,0.7546948356807511
2004,2011-10-01,07G,981,308,1289,0.761055081458495
2005,2011-10-01,07H,1605,916,2521,0.6366521221737406
2006,2011-10-01,07J,733,344,1077,0.680594243268338
2007,2011-10-01,07K,1469,687,2156,0.6813543599257885
2008,2011-10-01,07L,786,251,1037,0.7579556412729026
2009,2011-10-01,07M,1284,645,1929,0.6656298600311042
2010,2011-10-01,07N,1207,512,1719,0.702152414194299
2011,2011-10-01,07P,715,271,986,0.7251521298174443
2012,2011-10-01,07Q,1611,724,2335,0.6899357601713062
2013,2011-10-01,07R,800,453,1253,0.6384676775738228
2014,2011-10-01,07T,650,355,1005,0.6467661691542289
2015,2011-10-01,07V,1765,697,2462,0.7168968318440292
2016,2011-10-01,07W,951,557,1508,0.6306366047745358
2017,2011-10-01,07X,1336,600,1936,0.6900826446280992
2018,2011-10-01,07Y,809,523,1332,0.6073573573573574
2019,2011-10-01,08A,1262,525,1787,0.7062115277000559
2020,2011-10-01,08C,641,370,1011,0.6340257171117705
2021,2011-10-01,08D,922,443,1365,0.6754578754578755
2022,2011-10-01,08E,754,348,1102,0.6842105263157895
2023,2011-10-01,08F,1288,435,1723,0.7475333720255368
2024,2011-10-01,08G,504,1315,1819,0.2770753161077515
2025,2011-10-01,08H,828,476,1304,0.6349693251533742
2026,2011-10-01,08J,779,395,1174,0.6635434412265758
2027,2011-10-01,08K,1219,452,1671,0.7295032914422501
2028,2011-10-01,08L,950,604,1554,0.6113256113256114
2029,2011-10-01,08M,978,364,1342,0.7287630402384501
2030,2011-10-01,08N,1061,364,1425,0.744561403508772
2031,2011-10-01,08P,854,359,1213,0.7040395713107996
2032,2011-10-01,08Q,1036,318,1354,0.7651403249630724
2033,2011-10-01,08R,881,369,1250,0.7048
2034,2011-10-01,08T,967,438,1405,0.6882562277580071
2035,2011-10-01,08V,941,351,1292,0.728328173374613
2036,2011-10-01,08W,1025,311,1336,0.7672155688622755
2037,2011-10-01,08X,1290,517,1807,0.7138904261206419
2038,2011-10-01,08Y,719,331,1050,0.6847619047619048
2039,2011-10-01,09A,514,323,837,0.6140979689366786
2040,2011-10-01,09C,687,315,1002,0.6856287425149701
2041,2011-10-01,09D,1584,795,2379,0.6658259773013872
2042,2011-10-01,09E,1451,425,1876,0.773454157782516
2043,2011-10-01,09F,1326,561,1887,0.7027027027027027
2044,2011-10-01,09G,3206,1859,5065,0.6329713721618954
2045,2011-10-01,09H,648,274,922,0.702819956616052
2046,2011-10-01,09J,1478,651,2129,0.6942226397369657
2047,2011-10-01,09L,761,466,1227,0.6202118989405053
2048,2011-10-01,09N,1152,656,1808,0.6371681415929203
2049,2011-10-01,09P,1179,665,1844,0.6393709327548807
2050,2011-10-01,09W,1422,480,1902,0.7476340694006309
2051,2011-10-01,09X,1078,667,1745,0.6177650429799427
2052,2011-10-01,09Y,1725,1121,2846,0.6061138439915671
2053,2011-10-01,10A,1092,606,1698,0.6431095406360424
2054,2011-10-01,10C,456,291,747,0.6104417670682731
2055,2011-10-01,10D,569,165,734,0.7752043596730245
2056,2011-10-01,10E,826,297,1123,0.7355298308103295
2057,2011-10-01,10G,709,282,991,0.715438950554995
2058,2011-10-01,10H,1745,922,2667,0.6542932133483315
2059,2011-10-01,10J,990,1010,2000,0.495
2060,2011-10-01,10K,1132,652,1784,0.6345291479820628
2061,2011-10-01,10L,978,355,1333,0.7336834208552138
2062,2011-10-01,10M,519,360,879,0.590443686006826
2063,2011-10-01,10N,501,318,819,0.6117216117216118
2064,2011-10-01,10Q,2342,2465,4807,0.4872061576867069
2065,2011-10-01,10R,1329,558,1887,0.7042925278219396
2066,2011-10-01,10T,528,241,769,0.6866059817945384
2067,2011-10-01,10V,1272,798,2070,0.6144927536231884
2068,2011-10-01,10W,600,255,855,0.7017543859649122
2069,2011-10-01,10X,1297,622,1919,0.675872850442939
2070,2011-10-01,10Y,1257,692,1949,0.6449461262185736
2071,2011-10-01,11A,3242,1769,5011,0.6469766513669926
2072,2011-10-01,11C,779,299,1078,0.7226345083487941
2073,2011-10-01,11D,684,446,1130,0.6053097345132743
2074,2011-10-01,11E,1174,806,1980,0.592929292929293
2075,2011-10-01,11H,2476,1357,3833,0.645969214714323
2076,2011-10-01,11J,4880,2719,7599,0.6421897618107646
2077,2011-10-01,11M,3518,1787,5305,0.663147973609802
2078,2011-10-01,11N,4043,1321,5364,0.7537285607755406
2079,2011-10-01,11T,1417,819,2236,0.6337209302325582
2080,2011-10-01,11X,3481,1807,5288,0.6582829046898638
2081,2011-10-01,12A,1445,729,2174,0.6646734130634775
2082,2011-10-01,12D,1112,563,1675,0.6638805970149254
2083,2011-10-01,12F,2416,458,2874,0.8406402226861517
2084,2011-10-01,13P,3219,1466,4685,0.6870864461045891
2085,2011-10-01,13T,3174,1287,4461,0.7114996637525218
2086,2011-10-01,14L,2962,1521,4483,0.6607182690162837
2087,2011-10-01,99A,2711,767,3478,0.7794709603220241
2088,2011-10-01,99C,1550,730,2280,0.6798245614035088
2089,2011-10-01,99D,1049,497,1546,0.6785252263906857
2090,2011-10-01,99E,1531,491,2022,0.7571711177052424
2091,2011-10-01,99F,1030,311,1341,0.7680835197613721
2092,2011-10-01,99G,1004,234,1238,0.8109854604200323
2093,2011-10-01,99H,1509,836,2345,0.643496801705757
2094,2011-10-01,99J,2968,1265,4233,0.7011575714623198
2095,2011-10-01,99K,971,611,1582,0.6137800252844501
2096,2011-10-01,99M,1094,740,1834,0.5965103598691385
2097,2011-10-01,99N,2656,2292,4948,0.5367825383993533
2098,2011-10-01,99P,6418,2213,8631,0.7435986560074151
2099,2011-10-01,99Q,1945,775,2720,0.7150735294117647
2100,2011-11-01,00C,782,285,1067,0.7328959700093721
2101,2011-11-01,00D,2085,992,3077,0.677608059798505
2102,2011-11-01,00F,31,13,44,0.7045454545454546
2103,2011-11-01,00J,1659,765,2424,0.6844059405940595
2104,2011-11-01,00K,2123,1037,3160,0.6718354430379747
2105,2011-11-01,00L,2345,1467,3812,0.6151626442812173
2106,2011-11-01,00M,2122,1005,3127,0.6786056923568916
2107,2011-11-01,00N,1136,606,1742,0.6521239954075775
2108,2011-11-01,00P,1926,656,2582,0.7459333849728892
2109,2011-11-01,00Q,960,326,1286,0.7465007776049767
2110,2011-11-01,00R,1219,438,1657,0.7356668678334339
2111,2011-11-01,00T,1822,837,2659,0.6852200075216247
2112,2011-11-01,00V,1357,621,1978,0.686046511627907
2113,2011-11-01,00W,65,24,89,0.7303370786516854
2114,2011-11-01,00X,1000,282,1282,0.7800312012480499
2115,2011-11-01,00Y,1777,774,2551,0.6965895727165817
2116,2011-11-01,01A,2386,1106,3492,0.6832760595647194
2117,2011-11-01,01C,1259,680,1939,0.6493037648272305
2118,2011-11-01,01D,1512,632,2144,0.7052238805970149
2119,2011-11-01,01E,1165,208,1373,0.8485069191551348
2120,2011-11-01,01F,908,395,1303,0.6968534151957022
2121,2011-11-01,01G,1208,1055,2263,0.5338046840477243
2122,2011-11-01,01H,2497,730,3227,0.7737837000309885
2123,2011-11-01,01J,1024,435,1459,0.7018505825908157
2124,2011-11-01,01K,2288,1150,3438,0.6655031995346131
2125,2011-11-01,01N,26,14,40,0.65
2126,2011-11-01,01R,1081,542,1623,0.6660505237215034
2127,2011-11-01,01T,782,409,1191,0.6565910999160369
2128,2011-11-01,01V,785,287,1072,0.7322761194029851
2129,2011-11-01,01W,1808,776,2584,0.6996904024767802
2130,2011-11-01,01X,1478,614,2092,0.7065009560229446
2131,2011-11-01,01Y,1356,613,1969,0.6886744540375825
2132,2011-11-01,02A,1399,708,2107,0.6639772187944946
2133,2011-11-01,02D,554,336,890,0.6224719101123596
2134,2011-11-01,02E,1186,544,1730,0.6855491329479769
2135,2011-11-01,02F,1699,622,2321,0.7320120637656182
2136,2011-11-01,02G,635,323,958,0.662839248434238
2137,2011-11-01,02H,1860,1362,3222,0.5772811918063314
2138,2011-11-01,02M,981,399,1380,0.7108695652173913
2139,2011-11-01,02N,1013,549,1562,0.6485275288092189
2140,2011-11-01,02P,1200,943,2143,0.5599626691553896
2141,2011-11-01,02Q,597,412,1009,0.5916749256689792
2142,2011-11-01,02R,1937,785,2722,0.7116091109478325
2143,2011-11-01,02T,1003,529,1532,0.6546997389033943
2144,2011-11-01,02V,1349,681,2030,0.6645320197044335
2145,2011-11-01,02W,534,179,713,0.7489481065918654
2146,2011-11-01,02X,1940,1054,2994,0.6479625918503674
2147,2011-11-01,02Y,1826,831,2657,0.6872412495295446
2148,2011-11-01,03A,1204,505,1709,0.7045055588063195
2149,2011-11-01,03C,2016,1042,3058,0.6592544146500982
2150,2011-11-01,03D,823,313,1136,0.7244718309859155
2151,2011-11-01,03E,918,462,1380,0.6652173913043479
2152,2011-11-01,03F,1579,570,2149,0.7347603536528617
2153,2011-11-01,03G,1660,686,2346,0.7075873827791986
2154,2011-11-01,03H,1176,460,1636,0.7188264058679706
2155,2011-11-01,03J,1096,395,1491,0.7350771294433266
2156,2011-11-01,03K,1008,217,1225,0.8228571428571428
2157,2011-11-01,03L,1309,911,2220,0.5896396396396396
2158,2011-11-01,03M,815,377,1192,0.6837248322147651
2159,2011-11-01,03N,3360,862,4222,0.7958313595452392
2160,2011-11-01,03Q,1841,870,2711,0.6790852084101807
2161,2011-11-01,03R,2359,972,3331,0.7081957370159111
2162,2011-11-01,03T,1825,502,2327,0.7842715943274603
2163,2011-11-01,03V,355,243,598,0.5936454849498328
2164,2011-11-01,03W,2061,1105,3166,0.6509791535060012
2165,2011-11-01,03X,530,169,699,0.7582260371959942
2166,2011-11-01,03Y,657,290,947,0.6937697993664202
2167,2011-11-01,04C,1954,956,2910,0.6714776632302405
2168,2011-11-01,04D,1402,579,1981,0.7077233720343261
2169,2011-11-01,04E,1121,498,1619,0.692402717726992
2170,2011-11-01,04F,1436,920,2356,0.6095076400679117
2171,2011-11-01,04G,4081,1969,6050,0.6745454545454546
2172,2011-11-01,04H,681,350,1031,0.6605237633365665
2173,2011-11-01,04J,1895,902,2797,0.6775116195924205
2174,2011-11-01,04K,1700,812,2512,0.6767515923566879
2175,2011-11-01,04L,873,328,1201,0.7268942547876769
2176,2011-11-01,04M,610,202,812,0.7512315270935961
2177,2011-11-01,04N,781,290,1071,0.7292250233426704
2178,2011-11-01,04Q,828,307,1135,0.7295154185022027
2179,2011-11-01,04R,2863,1200,4063,0.7046517351710558
2180,2011-11-01,04V,2261,1141,3402,0.6646090534979424
2181,2011-11-01,04X,1394,1054,2448,0.5694444444444444
2182,2011-11-01,04Y,888,348,1236,0.7184466019417476
2183,2011-11-01,05A,2734,1259,3993,0.6846982218883045
2184,2011-11-01,05C,1223,1552,2775,0.4407207207207207
2185,2011-11-01,05D,837,427,1264,0.6621835443037974
2186,2011-11-01,05F,1218,410,1628,0.7481572481572482
2187,2011-11-01,05G,1278,554,1832,0.6975982532751092
2188,2011-11-01,05H,1108,436,1544,0.7176165803108808
2189,2011-11-01,05J,1319,438,1757,0.7507114399544679
2190,2011-11-01,05L,2599,1116,3715,0.6995962314939435
2191,2011-11-01,05N,2292,638,2930,0.7822525597269625
2192,2011-11-01,05P,1431,575,2006,0.7133599202392822
2193,2011-11-01,05Q,1354,480,1834,0.7382769901853872
2194,2011-11-01,05R,1714,892,2606,0.6577129700690714
2195,2011-11-01,05T,1991,719,2710,0.7346863468634687
2196,2011-11-01,05V,1006,415,1421,0.7079521463757917
2197,2011-11-01,05W,1458,709,2167,0.6728195662205815
2198,2011-11-01,05X,1169,365,1534,0.7620599739243807
2199,2011-11-01,05Y,1668,747,2415,0.6906832298136646
2200,2011-11-01,06A,1627,567,2194,0.7415679124886053
2201,2011-11-01,06D,842,334,1176,0.7159863945578231
2202,2011-11-01,06F,1519,2279,3798,0.39994734070563454
2203,2011-11-01,06H,5330,2549,7879,0.6764817870288108
2204,2011-11-01,06K,3139,1884,5023,0.6249253434202667
2205,2011-11-01,06L,2531,1010,3541,0.714769839028523
2206,2011-11-01,06M,1941,831,2772,0.7002164502164502
2207,2011-11-01,06N,3220,1796,5016,0.6419457735247209
2208,2011-11-01,06P,952,718,1670,0.5700598802395209
2209,2011-11-01,06Q,2267,1149,3416,0.6636416861826698
2210,2011-11-01,06T,2362,1045,3407,0.6932785441737599
2211,2011-11-01,06V,1382,492,1874,0.7374599786552828
2212,2011-11-01,06W,1598,401,1999,0.799399699849925
2213,2011-11-01,06Y,1312,381,1693,0.7749556999409333
2214,2011-11-01,07G,904,348,1252,0.7220447284345048
2215,2011-11-01,07H,1601,887,2488,0.6434887459807074
2216,2011-11-01,07J,753,385,1138,0.6616871704745168
2217,2011-11-01,07K,1526,655,2181,0.6996790463090325
2218,2011-11-01,07L,851,261,1112,0.7652877697841727
2219,2011-11-01,07M,1278,707,1985,0.6438287153652393
2220,2011-11-01,07N,1324,583,1907,0.6942842160461458
2221,2011-11-01,07P,730,268,998,0.7314629258517034
2222,2011-11-01,07Q,1798,760,2558,0.7028928850664582
2223,2011-11-01,07R,799,458,1257,0.6356404136833731
2224,2011-11-01,07T,687,386,1073,0.6402609506057781
2225,2011-11-01,07V,1768,722,2490,0.7100401606425703
2226,2011-11-01,07W,1028,596,1624,0.6330049261083743
2227,2011-11-01,07X,1291,515,1806,0.7148394241417497
2228,2011-11-01,07Y,827,489,1316,0.628419452887538
2229,2011-11-01,08A,1156,512,1668,0.6930455635491607
2230,2011-11-01,08C,624,392,1016,0.6141732283464567
2231,2011-11-01,08D,880,468,1348,0.6528189910979229
2232,2011-11-01,08E,793,366,1159,0.6842105263157895
2233,2011-11-01,08F,1289,458,1747,0.7378362907842015
2234,2011-11-01,08G,500,1368,1868,0.2676659528907923
2235,2011-11-01,08H,807,476,1283,0.6289945440374123
2236,2011-11-01,08J,747,367,1114,0.670556552962298
2237,2011-11-01,08K,1231,459,1690,0.7284023668639054
2238,2011-11-01,08L,1018,689,1707,0.5963678968951377
2239,2011-11-01,08M,1004,349,1353,0.7420546932742055
2240,2011-11-01,08N,1133,351,1484,0.7634770889487871
2241,2011-11-01,08P,868,411,1279,0.6786551993745114
2242,2011-11-01,08Q,1093,358,1451,0.7532736044107512
2243,2011-11-01,08R,929,397,1326,0.700603318250377
2244,2011-11-01,08T,1016,400,1416,0.7175141242937854
2245,2011-11-01,08V,1023,321,1344,0.7611607142857143
2246,2011-11-01,08W,1084,336,1420,0.7633802816901408
2247,2011-11-01,08X,1297,569,1866,0.695069667738478
2248,2011-11-01,08Y,689,336,1025,0.6721951219512196
2249,2011-11-01,09A,555,346,901,0.6159822419533851
2250,2011-11-01,09C,735,349,1084,0.6780442804428044
2251,2011-11-01,09D,1574,868,2442,0.6445536445536445
2252,2011-11-01,09E,1477,456,1933,0.7640972581479566
2253,2011-11-01,09F,1330,589,1919,0.693069306930693
2254,2011-11-01,09G,3319,1864,5183,0.6403627242909512
2255,2011-11-01,09H,691,334,1025,0.6741463414634147
2256,2011-11-01,09J,1575,745,2320,0.6788793103448276
2257,2011-11-01,09L,858,478,1336,0.6422155688622755
2258,2011-11-01,09N,1128,673,1801,0.6263187118267629
2259,2011-11-01,09P,1244,707,1951,0.6376217324449001
2260,2011-11-01,09W,1455,550,2005,0.7256857855361596
2261,2011-11-01,09X,1153,724,1877,0.6142781033564199
2262,2011-11-01,09Y,1779,1162,2941,0.6048962937776267
2263,2011-11-01,10A,1170,648,1818,0.6435643564356436
2264,2011-11-01,10C,494,259,753,0.6560424966799469
2265,2011-11-01,10D,589,171,760,0.775
2266,2011-11-01,10E,808,277,1085,0.744700460829493
2267,2011-11-01,10G,708,292,1000,0.708
2268,2011-11-01,10H,1852,929,2781,0.6659475008989572
2269,2011-11-01,10J,1123,987,2110,0.5322274881516588
2270,2011-11-01,10K,1218,691,1909,0.6380303823991619
2271,2011-11-01,10L,938,324,1262,0.7432646592709984
2272,2011-11-01,10M,537,330,867,0.6193771626297578
2273,2011-11-01,10N,546,352,898,0.6080178173719376
2274,2011-11-01,10Q,2534,2609,5143,0.4927085358740035
2275,2011-11-01,10R,1399,581,1980,0.7065656565656566
2276,2011-11-01,10T,505,241,746,0.6769436997319035
2277,2011-11-01,10V,1284,810,2094,0.6131805157593123
2278,2011-11-01,10W,649,297,946,0.686046511627907
2279,2011-11-01,10X,1313,633,1946,0.6747173689619733
2280,2011-11-01,10Y,1202,774,1976,0.6082995951417004
2281,2011-11-01,11A,3390,1859,5249,0.6458373023433035
2282,2011-11-01,11C,818,326,1144,0.715034965034965
2283,2011-11-01,11D,621,498,1119,0.5549597855227882
2284,2011-11-01,11E,1267,843,2110,0.6004739336492891
2285,2011-11-01,11H,2575,1470,4045,0.6365883807169345
2286,2011-11-01,11J,5126,2837,7963,0.6437272384779605
2287,2011-11-01,11M,3759,1842,5601,0.6711301553294055
2288,2011-11-01,11N,4184,1395,5579,0.7499551891019895
2289,2011-11-01,11T,1417,830,2247,0.6306186025812194
2290,2011-11-01,11X,3585,1850,5435,0.6596136154553818
2291,2011-11-01,12A,1549,771,2320,0.6676724137931035
2292,2011-11-01,12D,1147,578,1725,0.664927536231884
2293,2011-11-01,12F,2461,453,2914,0.8445435827041867
2294,2011-11-01,13P,3257,1542,4799,0.6786830589706189
2295,2011-11-01,13T,3166,1297,4463,0.7093883038315034
2296,2011-11-01,14L,2903,1615,4518,0.6425409473218238
2297,2011-11-01,99A,2845,819,3664,0.7764737991266376
2298,2011-11-01,99C,1601,793,2394,0.6687552213868003
2299,2011-11-01,99D,1090,494,1584,0.6881313131313131
2300,2011-11-01,99E,1612,558,2170,0.7428571428571429
2301,2011-11-01,99F,1130,336,1466,0.7708049113233287
2302,2011-11-01,99G,1030,276,1306,0.7886676875957122
2303,2011-11-01,99H,1685,938,2623,0.6423942051086542
2304,2011-11-01,99J,3099,1314,4413,0.7022433718558804
2305,2011-11-01,99K,1083,599,1682,0.6438763376932224
2306,2011-11-01,99M,1083,812,1895,0.5715039577836412
2307,2011-11-01,99N,2798,2468,5266,0.5313330801367262
2308,2011-11-01,99P,6589,2281,8870,0.7428410372040586
2309,2011-11-01,99Q,1998,759,2757,0.7247007616974973
2310,2011-12-01,00C,764,291,1055,0.7241706161137441
2311,2011-12-01,00D,1949,964,2913,0.6690696876072777
2312,2011-12-01,00F,16,7,23,0.6956521739130435
2313,2011-12-01,00J,1596,748,2344,0.6808873720136519
2314,2011-12-01,00K,1967,1008,2975,0.6611764705882353
2315,2011-12-01,00L,2317,1436,3753,0.6173727684519051
2316,2011-12-01,00M,2092,989,3081,0.6790003245699449
2317,2011-12-01,00N,1053,558,1611,0.6536312849162011
2318,2011-12-01,00P,1827,659,2486,0.7349155269509252
2319,2011-12-01,00Q,923,313,1236,0.7467637540453075
2320,2011-12-01,00R,1109,395,1504,0.7373670212765957
2321,2011-12-01,00T,1820,863,2683,0.6783451360417443
2322,2011-12-01,00V,1245,667,1912,0.6511506276150628
2323,2011-12-01,00W,44,32,76,0.5789473684210527
2324,2011-12-01,00X,978,284,1262,0.7749603803486529
2325,2011-12-01,00Y,1680,803,2483,0.6766008860249698
2326,2011-12-01,01A,2236,1110,3346,0.6682606096832038
2327,2011-12-01,01C,1360,722,2082,0.6532180595581172
2328,2011-12-01,01D,1364,598,1962,0.6952089704383282
2329,2011-12-01,01E,1090,197,1287,0.846930846930847
2330,2011-12-01,01F,871,381,1252,0.6956869009584664
2331,2011-12-01,01G,1151,1118,2269,0.5072719259585721
2332,2011-12-01,01H,2408,789,3197,0.7532061307475758
2333,2011-12-01,01J,897,396,1293,0.6937354988399071
2334,2011-12-01,01K,2159,1025,3184,0.6780778894472361
2335,2011-12-01,01N,18,10,28,0.6428571428571429
2336,2011-12-01,01R,977,547,1524,0.6410761154855643
2337,2011-12-01,01T,750,343,1093,0.6861848124428179
2338,2011-12-01,01V,763,348,1111,0.6867686768676867
2339,2011-12-01,01W,1766,750,2516,0.7019077901430842
2340,2011-12-01,01X,1346,578,1924,0.6995841995841996
2341,2011-12-01,01Y,1313,645,1958,0.6705822267620021
2342,2011-12-01,02A,1328,736,2064,0.6434108527131783
2343,2011-12-01,02D,571,350,921,0.6199782844733985
2344,2011-12-01,02E,1144,526,1670,0.6850299401197605
2345,2011-12-01,02F,1579,598,2177,0.7253100597152045
2346,2011-12-01,02G,616,325,941,0.6546227417640808
2347,2011-12-01,02H,1717,1386,3103,0.5533354817918144
2348,2011-12-01,02M,968,372,1340,0.7223880597014926
2349,2011-12-01,02N,1028,553,1581,0.6502213788741303
2350,2011-12-01,02P,1155,1032,2187,0.5281207133058985
2351,2011-12-01,02Q,636,418,1054,0.603415559772296
2352,2011-12-01,02R,1956,789,2745,0.7125683060109289
2353,2011-12-01,02T,962,565,1527,0.6299934512115258
2354,2011-12-01,02V,1244,599,1843,0.6749864351600651
2355,2011-12-01,02W,506,145,651,0.7772657450076805
2356,2011-12-01,02X,1890,999,2889,0.6542056074766355
2357,2011-12-01,02Y,1776,813,2589,0.6859791425260718
2358,2011-12-01,03A,1231,469,1700,0.7241176470588235
2359,2011-12-01,03C,1926,927,2853,0.6750788643533123
2360,2011-12-01,03D,783,321,1104,0.7092391304347826
2361,2011-12-01,03E,902,468,1370,0.6583941605839416
2362,2011-12-01,03F,1496,620,2116,0.7069943289224953
2363,2011-12-01,03G,1508,669,2177,0.6926963711529628
2364,2011-12-01,03H,1114,427,1541,0.7229072031148605
2365,2011-12-01,03J,1028,356,1384,0.7427745664739884
2366,2011-12-01,03K,942,236,1178,0.799660441426146
2367,2011-12-01,03L,1248,895,2143,0.5823611759216052
2368,2011-12-01,03M,825,345,1170,0.7051282051282052
2369,2011-12-01,03N,3109,745,3854,0.8066943435391801
2370,2011-12-01,03Q,1776,875,2651,0.6699358732553753
2371,2011-12-01,03R,2195,903,3098,0.7085216268560361
2372,2011-12-01,03T,1699,513,2212,0.7680831826401446
2373,2011-12-01,03V,354,229,583,0.6072041166380789
2374,2011-12-01,03W,1991,1095,3086,0.6451717433570966
2375,2011-12-01,03X,440,177,617,0.713128038897893
2376,2011-12-01,03Y,622,315,937,0.663820704375667
2377,2011-12-01,04C,1733,862,2595,0.6678227360308285
2378,2011-12-01,04D,1316,551,1867,0.7048741296197107
2379,2011-12-01,04E,1046,458,1504,0.6954787234042553
2380,2011-12-01,04F,1414,844,2258,0.6262178919397697
2381,2011-12-01,04G,3951,1934,5885,0.6713678844519966
2382,2011-12-01,04H,697,331,1028,0.6780155642023347
2383,2011-12-01,04J,1937,992,2929,0.6613178559235234
2384,2011-12-01,04K,1571,697,2268,0.6926807760141094
2385,2011-12-01,04L,810,308,1118,0.7245080500894454
2386,2011-12-01,04M,565,204,769,0.7347204161248374
2387,2011-12-01,04N,736,316,1052,0.6996197718631179
2388,2011-12-01,04Q,775,253,1028,0.7538910505836576
2389,2011-12-01,04R,2521,1178,3699,0.6815355501486888
2390,2011-12-01,04V,2108,1104,3212,0.6562889165628891
2391,2011-12-01,04X,1269,1094,2363,0.5370292001692764
2392,2011-12-01,04Y,910,363,1273,0.7148468185388845
2393,2011-12-01,05A,2500,1178,3678,0.6797172376291463
2394,2011-12-01,05C,1175,1439,2614,0.4495026778882938
2395,2011-12-01,05D,768,448,1216,0.631578947368421
2396,2011-12-01,05F,1304,410,1714,0.7607934655775963
2397,2011-12-01,05G,1132,511,1643,0.6889835666463786
2398,2011-12-01,05H,983,412,1395,0.7046594982078853
2399,2011-12-01,05J,1302,422,1724,0.7552204176334106
2400,2011-12-01,05L,2308,1078,3386,0.6816302421736562
2401,2011-12-01,05N,2101,606,2707,0.7761359438492796
2402,2011-12-01,05P,1323,580,1903,0.6952180767209669
2403,2011-12-01,05Q,1256,478,1734,0.7243367935409458
2404,2011-12-01,05R,1681,903,2584,0.6505417956656346
2405,2011-12-01,05T,1956,744,2700,0.7244444444444444
2406,2011-12-01,05V,944,415,1359,0.6946284032376747
2407,2011-12-01,05W,1278,691,1969,0.649060436769934
2408,2011-12-01,05X,1129,315,1444,0.7818559556786704
2409,2011-12-01,05Y,1500,672,2172,0.6906077348066298
2410,2011-12-01,06A,1479,550,2029,0.7289305076392312
2411,2011-12-01,06D,861,340,1201,0.7169025811823481
2412,2011-12-01,06F,1573,2314,3887,0.40468227424749165
2413,2011-12-01,06H,4882,2446,7328,0.6662117903930131
2414,2011-12-01,06K,3097,1832,4929,0.6283221748833435
2415,2011-12-01,06L,2301,909,3210,0.7168224299065421
2416,2011-12-01,06M,1847,891,2738,0.6745799853907962
2417,2011-12-01,06N,3141,1843,4984,0.6302166934189406
2418,2011-12-01,06P,881,666,1547,0.5694893341952165
2419,2011-12-01,06Q,2362,1207,3569,0.6618100308209582
2420,2011-12-01,06T,2191,1034,3225,0.6793798449612403
2421,2011-12-01,06V,1408,469,1877,0.7501331912626532
2422,2011-12-01,06W,1564,399,1963,0.7967396841569027
2423,2011-12-01,06Y,1319,389,1708,0.772248243559719
2424,2011-12-01,07G,890,292,1182,0.7529610829103215
2425,2011-12-01,07H,1504,908,2412,0.6235489220563848
2426,2011-12-01,07J,703,386,1089,0.6455463728191001
2427,2011-12-01,07K,1428,658,2086,0.6845637583892618
2428,2011-12-01,07L,753,234,987,0.7629179331306991
2429,2011-12-01,07M,1250,674,1924,0.6496881496881497
2430,2011-12-01,07N,1151,546,1697,0.6782557454331173
2431,2011-12-01,07P,772,242,1014,0.7613412228796844
2432,2011-12-01,07Q,1585,699,2284,0.6939579684763573
2433,2011-12-01,07R,720,418,1138,0.632688927943761
2434,2011-12-01,07T,545,359,904,0.6028761061946902
2435,2011-12-01,07V,1759,710,2469,0.7124341838801134
2436,2011-12-01,07W,934,538,1472,0.6345108695652174
2437,2011-12-01,07X,1219,478,1697,0.718326458456099
2438,2011-12-01,07Y,859,512,1371,0.6265499635302699
2439,2011-12-01,08A,1233,558,1791,0.6884422110552764
2440,2011-12-01,08C,574,305,879,0.6530147895335608
2441,2011-12-01,08D,880,425,1305,0.6743295019157088
2442,2011-12-01,08E,719,404,1123,0.6402493321460374
2443,2011-12-01,08F,1310,499,1809,0.7241569928137093
2444,2011-12-01,08G,511,1317,1828,0.27954048140043763
2445,2011-12-01,08H,779,424,1203,0.6475477971737323
2446,2011-12-01,08J,771,408,1179,0.6539440203562341
2447,2011-12-01,08K,1042,490,1532,0.6801566579634465
2448,2011-12-01,08L,942,633,1575,0.5980952380952381
2449,2011-12-01,08M,962,340,1302,0.738863287250384
2450,2011-12-01,08N,1057,315,1372,0.7704081632653061
2451,2011-12-01,08P,804,446,1250,0.6432
2452,2011-12-01,08Q,966,326,1292,0.7476780185758514
2453,2011-12-01,08R,900,403,1303,0.6907137375287797
2454,2011-12-01,08T,996,436,1432,0.6955307262569832
2455,2011-12-01,08V,983,349,1332,0.737987987987988
2456,2011-12-01,08W,1039,329,1368,0.7595029239766082
2457,2011-12-01,08X,1118,496,1614,0.6926889714993805
2458,2011-12-01,08Y,635,314,949,0.6691253951527925
2459,2011-12-01,09A,474,342,816,0.5808823529411765
2460,2011-12-01,09C,738,318,1056,0.6988636363636364
2461,2011-12-01,09D,1462,857,2319,0.6304441569642087
2462,2011-12-01,09E,1586,539,2125,0.7463529411764706
2463,2011-12-01,09F,1380,546,1926,0.7165109034267912
2464,2011-12-01,09G,3173,1886,5059,0.6271990511958885
2465,2011-12-01,09H,616,311,927,0.6645091693635383
2466,2011-12-01,09J,1507,711,2218,0.6794409377817854
2467,2011-12-01,09L,810,436,1246,0.6500802568218299
2468,2011-12-01,09N,1115,634,1749,0.6375071469411092
2469,2011-12-01,09P,1196,710,1906,0.6274921301154249
2470,2011-12-01,09W,1331,498,1829,0.7277200656096228
2471,2011-12-01,09X,1132,707,1839,0.6155519303969549
2472,2011-12-01,09Y,1720,1146,2866,0.6001395673412422
2473,2011-12-01,10A,1145,608,1753,0.6531660011409013
2474,2011-12-01,10C,416,266,682,0.6099706744868035
2475,2011-12-01,10D,618,186,804,0.7686567164179104
2476,2011-12-01,10E,749,301,1050,0.7133333333333334
2477,2011-12-01,10G,648,310,958,0.6764091858037579
2478,2011-12-01,10H,1824,916,2740,0.6656934306569343
2479,2011-12-01,10J,1015,956,1971,0.5149670218163369
2480,2011-12-01,10K,1149,708,1857,0.6187399030694669
2481,2011-12-01,10L,1029,360,1389,0.7408207343412527
2482,2011-12-01,10M,529,441,970,0.545360824742268
2483,2011-12-01,10N,468,316,784,0.5969387755102041
2484,2011-12-01,10Q,2359,2428,4787,0.49279298099018176
2485,2011-12-01,10R,1272,557,1829,0.6954620010934938
2486,2011-12-01,10T,530,227,757,0.7001321003963011
2487,2011-12-01,10V,1321,847,2168,0.6093173431734318
2488,2011-12-01,10W,554,239,793,0.6986128625472888
2489,2011-12-01,10X,1193,614,1807,0.6602102933038185
2490,2011-12-01,10Y,1285,774,2059,0.6240893637688198
2491,2011-12-01,11A,3248,1840,5088,0.6383647798742138
2492,2011-12-01,11C,825,298,1123,0.7346393588601959
2493,2011-12-01,11D,632,445,1077,0.5868152274837511
2494,2011-12-01,11E,1191,803,1994,0.5972918756268807
2495,2011-12-01,11H,2317,1427,3744,0.6188568376068376
2496,2011-12-01,11J,4951,2779,7730,0.6404915912031048
2497,2011-12-01,11M,3475,1814,5289,0.6570240121005861
2498,2011-12-01,11N,4019,1450,5469,0.7348692631194003
2499,2011-12-01,11T,1447,820,2267,0.6382884869872077
2500,2011-12-01,11X,3385,1843,5228,0.6474751338944147
2501,2011-12-01,12A,1526,728,2254,0.6770186335403726
2502,2011-12-01,12D,1081,580,1661,0.6508127633955448
2503,2011-12-01,12F,2501,515,3016,0.8292440318302388
2504,2011-12-01,13P,3037,1504,4541,0.6687954195111209
2505,2011-12-01,13T,3148,1194,4342,0.7250115154306771
2506,2011-12-01,14L,2740,1423,4163,0.6581791976939707
2507,2011-12-01,99A,2638,798,3436,0.7677532013969732
2508,2011-12-01,99C,1540,714,2254,0.6832298136645962
2509,2011-12-01,99D,1060,546,1606,0.660024906600249
2510,2011-12-01,99E,1571,580,2151,0.7303579730357973
2511,2011-12-01,99F,1064,339,1403,0.7583749109052031
2512,2011-12-01,99G,994,263,1257,0.7907716785998409
2513,2011-12-01,99H,1580,946,2526,0.6254948535233571
2514,2011-12-01,99J,2944,1280,4224,0.696969696969697
2515,2011-12-01,99K,1004,630,1634,0.6144430844553244
2516,2011-12-01,99M,1055,778,1833,0.5755591925804692
2517,2011-12-01,99N,2718,2391,5109,0.532002348796242
2518,2011-12-01,99P,6232,2330,8562,0.727867320719458
2519,2011-12-01,99Q,1993,848,2841,0.7015135515663499
2520,2012-01-01,00C,766,279,1045,0.7330143540669857
2521,2012-01-01,00D,1974,993,2967,0.6653185035389282
2522,2012-01-01,00F,17,5,22,0.7727272727272727
2523,2012-01-01,00J,1569,746,2315,0.6777537796976242
2524,2012-01-01,00K,2134,1028,3162,0.6748893105629349
2525,2012-01-01,00L,2288,1382,3670,0.623433242506812
2526,2012-01-01,00M,2088,954,3042,0.6863905325443787
2527,2012-01-01,00N,1152,596,1748,0.6590389016018307
2528,2012-01-01,00P,1953,635,2588,0.7546367851622875
2529,2012-01-01,00Q,1018,325,1343,0.7580044676098288
2530,2012-01-01,00R,1176,457,1633,0.7201469687691365
2531,2012-01-01,00T,1796,863,2659,0.6754418954494171
2532,2012-01-01,00V,1266,679,1945,0.6508997429305913
2533,2012-01-01,00W,83,29,112,0.7410714285714286
2534,2012-01-01,00X,960,271,1231,0.7798537774167343
2535,2012-01-01,00Y,1789,824,2613,0.6846536548029085
2536,2012-01-01,01A,2410,1093,3503,0.6879817299457608
2537,2012-01-01,01C,1381,677,2058,0.6710398445092323
2538,2012-01-01,01D,1555,634,2189,0.7103700319780721
2539,2012-01-01,01E,1163,215,1378,0.8439767779390421
2540,2012-01-01,01F,894,381,1275,0.7011764705882353
2541,2012-01-01,01G,1205,1079,2284,0.5275831873905429
2542,2012-01-01,01H,2395,739,3134,0.7641991065730696
2543,2012-01-01,01J,954,435,1389,0.6868250539956804
2544,2012-01-01,01K,2170,1045,3215,0.6749611197511665
2545,2012-01-01,01N,28,10,38,0.7368421052631579
2546,2012-01-01,01R,1011,540,1551,0.6518375241779497
2547,2012-01-01,01T,803,377,1180,0.6805084745762712
2548,2012-01-01,01V,847,305,1152,0.7352430555555556
2549,2012-01-01,01W,1761,774,2535,0.6946745562130178
2550,2012-01-01,01X,1423,608,2031,0.7006400787789266
2551,2012-01-01,01Y,1321,634,1955,0.6757033248081842
2552,2012-01-01,02A,1341,729,2070,0.6478260869565218
2553,2012-01-01,02D,604,342,946,0.638477801268499
2554,2012-01-01,02E,1222,487,1709,0.7150380339379754
2555,2012-01-01,02F,1596,607,2203,0.7244666364049024
2556,2012-01-01,02G,663,364,1027,0.6455696202531646
2557,2012-01-01,02H,1753,1414,3167,0.5535206820334702
2558,2012-01-01,02M,978,354,1332,0.7342342342342343
2559,2012-01-01,02N,1004,496,1500,0.6693333333333333
2560,2012-01-01,02P,1148,975,2123,0.5407442298634009
2561,2012-01-01,02Q,595,439,1034,0.5754352030947776
2562,2012-01-01,02R,2042,788,2830,0.7215547703180212
2563,2012-01-01,02T,1089,577,1666,0.6536614645858343
2564,2012-01-01,02V,1351,619,1970,0.6857868020304568
2565,2012-01-01,02W,554,165,719,0.7705146036161336
2566,2012-01-01,02X,1993,998,2991,0.6663323303243063
2567,2012-01-01,02Y,1772,717,2489,0.7119325030132584
2568,2012-01-01,03A,1154,556,1710,0.6748538011695906
2569,2012-01-01,03C,1890,996,2886,0.6548856548856549
2570,2012-01-01,03D,811,338,1149,0.7058311575282855
2571,2012-01-01,03E,893,475,1368,0.6527777777777778
2572,2012-01-01,03F,1429,583,2012,0.7102385685884692
2573,2012-01-01,03G,1497,662,2159,0.6933765632237147
2574,2012-01-01,03H,1161,436,1597,0.7269881026925485
2575,2012-01-01,03J,1029,383,1412,0.7287535410764873
2576,2012-01-01,03K,1041,196,1237,0.841552142279709
2577,2012-01-01,03L,1244,961,2205,0.5641723356009071
2578,2012-01-01,03M,753,328,1081,0.696577243293247
2579,2012-01-01,03N,3249,761,4010,0.8102244389027431
2580,2012-01-01,03Q,1767,831,2598,0.6801385681293303
2581,2012-01-01,03R,2274,958,3232,0.7035891089108911
2582,2012-01-01,03T,1784,549,2333,0.7646806686669524
2583,2012-01-01,03V,393,236,629,0.6248012718600954
2584,2012-01-01,03W,2010,1090,3100,0.6483870967741936
2585,2012-01-01,03X,489,186,675,0.7244444444444444
2586,2012-01-01,03Y,674,312,986,0.6835699797160243
2587,2012-01-01,04C,1962,925,2887,0.6795981988223069
2588,2012-01-01,04D,1284,571,1855,0.6921832884097036
2589,2012-01-01,04E,1123,454,1577,0.7121116043119848
2590,2012-01-01,04F,1436,900,2336,0.6147260273972602
2591,2012-01-01,04G,4154,1994,6148,0.6756668835393624
2592,2012-01-01,04H,717,281,998,0.718436873747495
2593,2012-01-01,04J,1922,899,2821,0.6813186813186813
2594,2012-01-01,04K,1649,730,2379,0.6931483816729719
2595,2012-01-01,04L,880,305,1185,0.7426160337552743
2596,2012-01-01,04M,552,227,779,0.7086007702182285
2597,2012-01-01,04N,692,295,987,0.7011144883485309
2598,2012-01-01,04Q,887,279,1166,0.7607204116638079
2599,2012-01-01,04R,2603,1124,3727,0.6984169573383419
2600,2012-01-01,04V,2235,1031,3266,0.6843233312921004
2601,2012-01-01,04X,1367,1001,2368,0.5772804054054054
2602,2012-01-01,04Y,887,295,1182,0.7504230118443317
2603,2012-01-01,05A,2585,1257,3842,0.6728266527850079
2604,2012-01-01,05C,1164,1563,2727,0.42684268426842686
2605,2012-01-01,05D,755,373,1128,0.6693262411347518
2606,2012-01-01,05F,1183,388,1571,0.7530235518777848
2607,2012-01-01,05G,1147,511,1658,0.6917973462002412
2608,2012-01-01,05H,1063,424,1487,0.714862138533961
2609,2012-01-01,05J,1347,412,1759,0.7657760090960773
2610,2012-01-01,05L,2630,1078,3708,0.709277238403452
2611,2012-01-01,05N,2119,572,2691,0.7874396135265701
2612,2012-01-01,05P,1388,552,1940,0.7154639175257732
2613,2012-01-01,05Q,1199,489,1688,0.7103080568720379
2614,2012-01-01,05R,1685,836,2521,0.6683855612852043
2615,2012-01-01,05T,1958,742,2700,0.7251851851851852
2616,2012-01-01,05V,996,391,1387,0.7180966113914924
2617,2012-01-01,05W,1380,635,2015,0.684863523573201
2618,2012-01-01,05X,1162,303,1465,0.7931740614334472
2619,2012-01-01,05Y,1565,754,2319,0.6748598533850798
2620,2012-01-01,06A,1522,551,2073,0.7342016401350699
2621,2012-01-01,06D,775,327,1102,0.7032667876588021
2622,2012-01-01,06F,1572,2244,3816,0.4119496855345912
2623,2012-01-01,06H,5116,2535,7651,0.6686707619918965
2624,2012-01-01,06K,3142,1894,5036,0.6239078633836378
2625,2012-01-01,06L,2392,939,3331,0.7181026718703092
2626,2012-01-01,06M,1918,854,2772,0.6919191919191919
2627,2012-01-01,06N,3345,1786,5131,0.65191970376145
2628,2012-01-01,06P,934,720,1654,0.5646916565900847
2629,2012-01-01,06Q,2331,1237,3568,0.6533071748878924
2630,2012-01-01,06T,2287,1040,3327,0.6874060715359183
2631,2012-01-01,06V,1405,518,1923,0.7306292251690067
2632,2012-01-01,06W,1593,459,2052,0.7763157894736842
2633,2012-01-01,06Y,1381,404,1785,0.7736694677871149
2634,2012-01-01,07G,935,352,1287,0.7264957264957265
2635,2012-01-01,07H,1640,880,2520,0.6507936507936508
2636,2012-01-01,07J,677,386,1063,0.6368767638758231
2637,2012-01-01,07K,1502,668,2170,0.6921658986175115
2638,2012-01-01,07L,773,246,1019,0.7585868498527969
2639,2012-01-01,07M,1255,679,1934,0.6489141675284384
2640,2012-01-01,07N,1342,572,1914,0.7011494252873564
2641,2012-01-01,07P,827,226,1053,0.785375118708452
2642,2012-01-01,07Q,1716,730,2446,0.7015535568274734
2643,2012-01-01,07R,764,452,1216,0.6282894736842105
2644,2012-01-01,07T,564,335,899,0.6273637374860956
2645,2012-01-01,07V,1679,646,2325,0.7221505376344086
2646,2012-01-01,07W,1025,637,1662,0.6167268351383874
2647,2012-01-01,07X,1293,529,1822,0.7096597145993414
2648,2012-01-01,07Y,820,531,1351,0.6069578090303479
2649,2012-01-01,08A,1304,576,1880,0.6936170212765957
2650,2012-01-01,08C,641,349,990,0.6474747474747474
2651,2012-01-01,08D,888,439,1327,0.6691785983421251
2652,2012-01-01,08E,797,373,1170,0.6811965811965812
2653,2012-01-01,08F,1253,485,1738,0.7209436133486766
2654,2012-01-01,08G,536,1285,1821,0.2943437671609006
2655,2012-01-01,08H,833,501,1334,0.6244377811094453
2656,2012-01-01,08J,775,357,1132,0.6846289752650176
2657,2012-01-01,08K,1260,542,1802,0.6992230854605993
2658,2012-01-01,08L,982,651,1633,0.6013472137170851
2659,2012-01-01,08M,1041,385,1426,0.7300140252454418
2660,2012-01-01,08N,1161,330,1491,0.778672032193159
2661,2012-01-01,08P,856,425,1281,0.6682279469164715
2662,2012-01-01,08Q,995,327,1322,0.7526475037821483
2663,2012-01-01,08R,895,345,1240,0.7217741935483871
2664,2012-01-01,08T,1024,443,1467,0.6980231765507839
2665,2012-01-01,08V,1137,359,1496,0.7600267379679144
2666,2012-01-01,08W,1099,358,1457,0.7542896362388469
2667,2012-01-01,08X,1215,551,1766,0.687995469988675
2668,2012-01-01,08Y,692,375,1067,0.6485473289597001
2669,2012-01-01,09A,529,353,882,0.5997732426303855
2670,2012-01-01,09C,707,328,1035,0.6830917874396135
2671,2012-01-01,09D,1495,893,2388,0.6260469011725294
2672,2012-01-01,09E,1809,624,2433,0.7435265104808878
2673,2012-01-01,09F,1263,563,1826,0.6916757940854327
2674,2012-01-01,09G,3163,1900,5063,0.6247284218842584
2675,2012-01-01,09H,638,337,975,0.6543589743589744
2676,2012-01-01,09J,1586,725,2311,0.6862829943747295
2677,2012-01-01,09L,835,487,1322,0.6316187594553706
2678,2012-01-01,09N,1080,611,1691,0.638675340035482
2679,2012-01-01,09P,1145,713,1858,0.616254036598493
2680,2012-01-01,09W,1409,499,1908,0.7384696016771488
2681,2012-01-01,09X,1102,698,1800,0.6122222222222222
2682,2012-01-01,09Y,1748,1143,2891,0.6046350743687305
2683,2012-01-01,10A,1099,606,1705,0.644574780058651
2684,2012-01-01,10C,487,271,758,0.6424802110817942
2685,2012-01-01,10D,654,213,867,0.754325259515571
2686,2012-01-01,10E,768,289,1057,0.7265846736045412
2687,2012-01-01,10G,649,236,885,0.7333333333333333
2688,2012-01-01,10H,1865,1007,2872,0.6493732590529248
2689,2012-01-01,10J,938,959,1897,0.4944649446494465
2690,2012-01-01,10K,1171,692,1863,0.6285560923242083
2691,2012-01-01,10L,985,346,1331,0.740045078888054
2692,2012-01-01,10M,540,341,881,0.6129398410896708
2693,2012-01-01,10N,475,309,784,0.6058673469387755
2694,2012-01-01,10Q,2425,2487,4912,0.49368892508143325
2695,2012-01-01,10R,1318,541,1859,0.7089833243679398
2696,2012-01-01,10T,519,249,768,0.67578125
2697,2012-01-01,10V,1173,787,1960,0.5984693877551021
2698,2012-01-01,10W,554,289,843,0.6571767497034401
2699,2012-01-01,10X,1251,590,1841,0.6795219989136339
2700,2012-01-01,10Y,1268,725,1993,0.6362267937782238
2701,2012-01-01,11A,3260,1789,5049,0.6456724103782927
2702,2012-01-01,11C,813,292,1105,0.7357466063348417
2703,2012-01-01,11D,649,491,1140,0.5692982456140351
2704,2012-01-01,11E,1238,776,2014,0.6146971201588878
2705,2012-01-01,11H,2507,1410,3917,0.6400306356905795
2706,2012-01-01,11J,4743,2694,7437,0.6377571601452199
2707,2012-01-01,11M,3647,1856,5503,0.6627294203161912
2708,2012-01-01,11N,4161,1348,5509,0.7553094935559993
2709,2012-01-01,11T,1425,823,2248,0.6338967971530249
2710,2012-01-01,11X,3530,1857,5387,0.6552812325969928
2711,2012-01-01,12A,1513,714,2227,0.6793893129770993
2712,2012-01-01,12D,1161,647,1808,0.6421460176991151
2713,2012-01-01,12F,2551,487,3038,0.8396971691902567
2714,2012-01-01,13P,3241,1615,4856,0.6674217462932455
2715,2012-01-01,13T,3122,1224,4346,0.718361711919006
2716,2012-01-01,14L,2905,1500,4405,0.659477866061294
2717,2012-01-01,99A,2832,850,3682,0.7691472026072786
2718,2012-01-01,99C,1489,692,2181,0.682714351215039
2719,2012-01-01,99D,1083,609,1692,0.6400709219858156
2720,2012-01-01,99E,1606,543,2149,0.7473243369008842
2721,2012-01-01,99F,1162,320,1482,0.7840755735492577
2722,2012-01-01,99G,946,277,1223,0.7735077677841373
2723,2012-01-01,99H,1556,844,2400,0.6483333333333333
2724,2012-01-01,99J,3010,1225,4235,0.7107438016528925
2725,2012-01-01,99K,992,567,1559,0.6363053239255934
2726,2012-01-01,99M,1040,818,1858,0.5597416576964478
2727,2012-01-01,99N,2699,2414,5113,0.5278701349501271
2728,2012-01-01,99P,6395,2317,8712,0.7340449954086318
2729,2012-01-01,99Q,1973,774,2747,0.7182380779031671
2730,2012-02-01,00C,701,287,988,0.7095141700404858
2731,2012-02-01,00D,2073,1017,3090,0.670873786407767
2732,2012-02-01,00F,21,7,28,0.75
2733,2012-02-01,00J,1540,727,2267,0.6793118659020733
2734,2012-02-01,00K,2014,1052,3066,0.6568819308545336
2735,2012-02-01,00L,2213,1419,3632,0.6093061674008811
2736,2012-02-01,00M,1957,979,2936,0.6665531335149864
2737,2012-02-01,00N,1045,611,1656,0.6310386473429952
2738,2012-02-01,00P,1911,710,2621,0.7291110263258298
2739,2012-02-01,00Q,945,328,1273,0.7423409269442263
2740,2012-02-01,00R,1129,430,1559,0.7241821680564464
2741,2012-02-01,00T,1765,764,2529,0.6979043100039541
2742,2012-02-01,00V,1207,641,1848,0.6531385281385281
2743,2012-02-01,00W,62,20,82,0.7560975609756098
2744,2012-02-01,00X,952,284,1236,0.7702265372168284
2745,2012-02-01,00Y,1708,787,2495,0.6845691382765531
2746,2012-02-01,01A,2136,1098,3234,0.660482374768089
2747,2012-02-01,01C,1241,617,1858,0.6679224973089344
2748,2012-02-01,01D,1410,576,1986,0.7099697885196374
2749,2012-02-01,01E,1137,204,1341,0.8478747203579419
2750,2012-02-01,01F,836,394,1230,0.6796747967479675
2751,2012-02-01,01G,1166,1068,2234,0.5219337511190689
2752,2012-02-01,01H,2233,692,2925,0.7634188034188034
2753,2012-02-01,01J,925,429,1354,0.6831610044313147
2754,2012-02-01,01K,2132,1008,3140,0.6789808917197452
2755,2012-02-01,01N,30,14,44,0.6818181818181818
2756,2012-02-01,01R,926,498,1424,0.6502808988764045
2757,2012-02-01,01T,770,379,1149,0.6701479547432551
2758,2012-02-01,01V,753,299,1052,0.7157794676806084
2759,2012-02-01,01W,1737,764,2501,0.6945221911235506
2760,2012-02-01,01X,1340,609,1949,0.6875320677270395
2761,2012-02-01,01Y,1270,568,1838,0.690968443960827
2762,2012-02-01,02A,1195,784,1979,0.6038403233956544
2763,2012-02-01,02D,539,362,901,0.5982241953385128
2764,2012-02-01,02E,1178,539,1717,0.6860803727431567
2765,2012-02-01,02F,1513,566,2079,0.7277537277537277
2766,2012-02-01,02G,641,359,1000,0.641
2767,2012-02-01,02H,1624,1326,2950,0.5505084745762712
2768,2012-02-01,02M,893,363,1256,0.7109872611464968
2769,2012-02-01,02N,949,533,1482,0.6403508771929824
2770,2012-02-01,02P,1180,935,2115,0.557919621749409
2771,2012-02-01,02Q,586,403,989,0.5925176946410515
2772,2012-02-01,02R,1886,772,2658,0.709556057185854
2773,2012-02-01,02T,1008,558,1566,0.6436781609195402
2774,2012-02-01,02V,1236,561,1797,0.6878130217028381
2775,2012-02-01,02W,575,183,758,0.758575197889182
2776,2012-02-01,02X,1777,939,2716,0.6542709867452136
2777,2012-02-01,02Y,1697,758,2455,0.6912423625254582
2778,2012-02-01,03A,1142,555,1697,0.6729522687094873
2779,2012-02-01,03C,1822,989,2811,0.648167911775169
2780,2012-02-01,03D,794,325,1119,0.709562109025916
2781,2012-02-01,03E,806,419,1225,0.6579591836734694
2782,2012-02-01,03F,1341,598,1939,0.6915936049510056
2783,2012-02-01,03G,1533,675,2208,0.6942934782608695
2784,2012-02-01,03H,1084,413,1497,0.7241148964595858
2785,2012-02-01,03J,1038,351,1389,0.7473002159827213
2786,2012-02-01,03K,975,202,1177,0.8283772302463891
2787,2012-02-01,03L,1257,866,2123,0.5920866698068771
2788,2012-02-01,03M,739,343,1082,0.6829944547134935
2789,2012-02-01,03N,3045,764,3809,0.7994224205828301
2790,2012-02-01,03Q,1638,812,2450,0.6685714285714286
2791,2012-02-01,03R,2077,854,2931,0.70863186625725
2792,2012-02-01,03T,1654,538,2192,0.7545620437956204
2793,2012-02-01,03V,343,218,561,0.6114081996434938
2794,2012-02-01,03W,1993,981,2974,0.6701412239408204
2795,2012-02-01,03X,444,200,644,0.6894409937888198
2796,2012-02-01,03Y,601,309,910,0.6604395604395604
2797,2012-02-01,04C,1852,882,2734,0.6773957571324067
2798,2012-02-01,04D,1289,522,1811,0.7117614577581447
2799,2012-02-01,04E,1053,471,1524,0.6909448818897638
2800,2012-02-01,04F,1384,873,2257,0.613203367301728
2801,2012-02-01,04G,3904,1833,5737,0.6804950322468188
2802,2012-02-01,04H,630,282,912,0.6907894736842105
2803,2012-02-01,04J,1884,894,2778,0.6781857451403888
2804,2012-02-01,04K,1556,731,2287,0.6803672933974639
2805,2012-02-01,04L,810,327,1137,0.712401055408971
2806,2012-02-01,04M,484,192,676,0.7159763313609467
2807,2012-02-01,04N,705,280,985,0.7157360406091371
2808,2012-02-01,04Q,768,296,1064,0.7218045112781954
2809,2012-02-01,04R,2455,1076,3531,0.6952704616256018
2810,2012-02-01,04V,1988,1034,3022,0.6578424884182661
2811,2012-02-01,04X,1286,936,2222,0.5787578757875788
2812,2012-02-01,04Y,849,272,1121,0.7573595004460303
2813,2012-02-01,05A,2470,1142,3612,0.6838316722037652
2814,2012-02-01,05C,1051,1453,2504,0.41972843450479236
2815,2012-02-01,05D,770,405,1175,0.6553191489361702
2816,2012-02-01,05F,1218,374,1592,0.7650753768844221
2817,2012-02-01,05G,1169,465,1634,0.715422276621787
2818,2012-02-01,05H,1061,421,1482,0.7159244264507423
2819,2012-02-01,05J,1203,445,1648,0.7299757281553398
2820,2012-02-01,05L,2323,1001,3324,0.6988567990373045
2821,2012-02-01,05N,2044,587,2631,0.7768909160015204
2822,2012-02-01,05P,1243,543,1786,0.6959686450167973
2823,2012-02-01,05Q,1227,437,1664,0.7373798076923077
2824,2012-02-01,05R,1592,893,2485,0.6406438631790744
2825,2012-02-01,05T,1734,778,2512,0.6902866242038217
2826,2012-02-01,05V,886,353,1239,0.7150928167877321
2827,2012-02-01,05W,1262,625,1887,0.6687864334923158
2828,2012-02-01,05X,1111,302,1413,0.7862703467799009
2829,2012-02-01,05Y,1501,766,2267,0.6621085134539039
2830,2012-02-01,06A,1443,564,2007,0.71898355754858
2831,2012-02-01,06D,783,310,1093,0.716376944190302
2832,2012-02-01,06F,1447,2134,3581,0.4040770734431723
2833,2012-02-01,06H,4812,2442,7254,0.663358147229115
2834,2012-02-01,06K,2875,1781,4656,0.6174828178694158
2835,2012-02-01,06L,2171,915,3086,0.70349967595593
2836,2012-02-01,06M,1785,768,2553,0.699177438307873
2837,2012-02-01,06N,2995,1743,4738,0.63212325875897
2838,2012-02-01,06P,883,670,1553,0.5685769478428847
2839,2012-02-01,06Q,2113,1064,3177,0.6650928548945546
2840,2012-02-01,06T,2117,914,3031,0.6984493566479709
2841,2012-02-01,06V,1225,487,1712,0.7155373831775701
2842,2012-02-01,06W,1405,423,1828,0.7685995623632386
2843,2012-02-01,06Y,1222,423,1645,0.7428571428571429
2844,2012-02-01,07G,824,323,1147,0.7183958151700087
2845,2012-02-01,07H,1510,909,2419,0.6242248863166597
2846,2012-02-01,07J,664,365,1029,0.6452866861030127
2847,2012-02-01,07K,1382,593,1975,0.699746835443038
2848,2012-02-01,07L,691,241,932,0.7414163090128756
2849,2012-02-01,07M,1125,671,1796,0.626391982182628
2850,2012-02-01,07N,1214,560,1774,0.6843291995490417
2851,2012-02-01,07P,702,246,948,0.740506329113924
2852,2012-02-01,07Q,1625,690,2315,0.7019438444924406
2853,2012-02-01,07R,695,445,1140,0.6096491228070176
2854,2012-02-01,07T,588,349,937,0.6275346851654215
2855,2012-02-01,07V,1670,636,2306,0.7241977450130095
2856,2012-02-01,07W,968,585,1553,0.6233097231165486
2857,2012-02-01,07X,1188,516,1704,0.6971830985915493
2858,2012-02-01,07Y,752,505,1257,0.5982498011137629
2859,2012-02-01,08A,1192,522,1714,0.6954492415402567
2860,2012-02-01,08C,566,333,899,0.6295884315906563
2861,2012-02-01,08D,873,391,1264,0.6906645569620253
2862,2012-02-01,08E,725,360,1085,0.6682027649769585
2863,2012-02-01,08F,1261,459,1720,0.733139534883721
2864,2012-02-01,08G,493,1277,1770,0.27853107344632766
2865,2012-02-01,08H,697,500,1197,0.5822890559732665
2866,2012-02-01,08J,751,350,1101,0.6821071752951862
2867,2012-02-01,08K,1137,455,1592,0.7141959798994975
2868,2012-02-01,08L,921,680,1601,0.5752654590880699
2869,2012-02-01,08M,987,329,1316,0.75
2870,2012-02-01,08N,997,317,1314,0.758751902587519
2871,2012-02-01,08P,829,387,1216,0.6817434210526315
2872,2012-02-01,08Q,902,350,1252,0.7204472843450479
2873,2012-02-01,08R,820,374,1194,0.6867671691792295
2874,2012-02-01,08T,962,396,1358,0.7083946980854198
2875,2012-02-01,08V,972,342,1314,0.7397260273972602
2876,2012-02-01,08W,1056,325,1381,0.7646632874728457
2877,2012-02-01,08X,1146,566,1712,0.669392523364486
2878,2012-02-01,08Y,658,339,997,0.6599799398194583
2879,2012-02-01,09A,478,357,835,0.5724550898203593
2880,2012-02-01,09C,658,334,992,0.6633064516129032
2881,2012-02-01,09D,1347,850,2197,0.6131087847064178
2882,2012-02-01,09E,1517,517,2034,0.7458210422812193
2883,2012-02-01,09F,1257,525,1782,0.7053872053872053
2884,2012-02-01,09G,3092,1759,4851,0.637394351680066
2885,2012-02-01,09H,615,275,890,0.6910112359550562
2886,2012-02-01,09J,1414,639,2053,0.6887481734047735
2887,2012-02-01,09L,765,465,1230,0.6219512195121951
2888,2012-02-01,09N,1027,625,1652,0.6216707021791767
2889,2012-02-01,09P,1074,746,1820,0.5901098901098901
2890,2012-02-01,09W,1355,441,1796,0.7544543429844098
2891,2012-02-01,09X,1051,698,1749,0.6009148084619783
2892,2012-02-01,09Y,1666,1014,2680,0.6216417910447761
2893,2012-02-01,10A,1075,597,1672,0.6429425837320574
2894,2012-02-01,10C,445,280,725,0.6137931034482759
2895,2012-02-01,10D,547,180,727,0.7524071526822559
2896,2012-02-01,10E,797,272,1069,0.7455565949485501
2897,2012-02-01,10G,622,296,918,0.6775599128540305
2898,2012-02-01,10H,1600,855,2455,0.6517311608961304
2899,2012-02-01,10J,922,861,1783,0.517106001121705
2900,2012-02-01,10K,1130,621,1751,0.6453455168475157
2901,2012-02-01,10L,908,352,1260,0.7206349206349206
2902,2012-02-01,10M,528,363,891,0.5925925925925926
2903,2012-02-01,10N,414,355,769,0.5383615084525357
2904,2012-02-01,10Q,2393,2380,4773,0.5013618269432223
2905,2012-02-01,10R,1265,549,1814,0.697353914002205
2906,2012-02-01,10T,490,195,685,0.7153284671532847
2907,2012-02-01,10V,1109,731,1840,0.6027173913043479
2908,2012-02-01,10W,537,310,847,0.6340023612750886
2909,2012-02-01,10X,1210,579,1789,0.6763555058692007
2910,2012-02-01,10Y,1221,693,1914,0.6379310344827587
2911,2012-02-01,11A,3109,1759,4868,0.6386606409202958
2912,2012-02-01,11C,781,248,1029,0.7589893100097181
2913,2012-02-01,11D,584,480,1064,0.5488721804511278
2914,2012-02-01,11E,1143,719,1862,0.6138560687432868
2915,2012-02-01,11H,2374,1355,3729,0.6366318047733976
2916,2012-02-01,11J,4571,2584,7155,0.6388539482879105
2917,2012-02-01,11M,3377,1658,5035,0.6707050645481628
2918,2012-02-01,11N,3759,1311,5070,0.7414201183431952
2919,2012-02-01,11T,1385,771,2156,0.6423933209647495
2920,2012-02-01,11X,3275,1779,5054,0.64800158290463
2921,2012-02-01,12A,1418,757,2175,0.6519540229885058
2922,2012-02-01,12D,1050,616,1666,0.6302521008403361
2923,2012-02-01,12F,2397,455,2852,0.8404628330995793
2924,2012-02-01,13P,2933,1462,4395,0.667349260523322
2925,2012-02-01,13T,3084,1182,4266,0.7229254571026723
2926,2012-02-01,14L,2907,1476,4383,0.6632443531827515
2927,2012-02-01,99A,2666,786,3452,0.772305909617613
2928,2012-02-01,99C,1506,700,2206,0.6826835902085222
2929,2012-02-01,99D,1009,532,1541,0.654769630110318
2930,2012-02-01,99E,1431,536,1967,0.7275038129130655
2931,2012-02-01,99F,1044,249,1293,0.8074245939675174
2932,2012-02-01,99G,970,226,1196,0.8110367892976589
2933,2012-02-01,99H,1471,770,2241,0.6564033913431504
2934,2012-02-01,99J,2791,1208,3999,0.69792448112028
2935,2012-02-01,99K,1024,585,1609,0.6364201367308887
2936,2012-02-01,99M,1030,700,1730,0.5953757225433526
2937,2012-02-01,99N,2654,2253,4907,0.54085999592419
2938,2012-02-01,99P,6059,2220,8279,0.731851672907356
2939,2012-02-01,99Q,1847,708,2555,0.7228962818003913
2940,2012-03-01,00C,743,278,1021,0.7277179236043095
2941,2012-03-01,00D,2150,1087,3237,0.6641952425084955
2942,2012-03-01,00F,17,6,23,0.7391304347826086
2943,2012-03-01,00J,1609,869,2478,0.6493139628732849
2944,2012-03-01,00K,2201,1065,3266,0.6739130434782609
2945,2012-03-01,00L,2372,1437,3809,0.6227356261485955
2946,2012-03-01,00M,2225,1055,3280,0.6783536585365854
2947,2012-03-01,00N,1243,594,1837,0.6766467065868264
2948,2012-03-01,00P,1990,714,2704,0.7359467455621301
2949,2012-03-01,00Q,924,350,1274,0.7252747252747253
2950,2012-03-01,00R,1219,409,1628,0.7487714987714987
2951,2012-03-01,00T,1844,898,2742,0.6725018234865062
2952,2012-03-01,00V,1272,655,1927,0.6600934094447327
2953,2012-03-01,00W,67,28,95,0.7052631578947368
2954,2012-03-01,00X,1020,306,1326,0.7692307692307693
2955,2012-03-01,00Y,1840,866,2706,0.679970436067997
2956,2012-03-01,01A,2199,1146,3345,0.6573991031390135
2957,2012-03-01,01C,1345,678,2023,0.6648541769649036
2958,2012-03-01,01D,1439,633,2072,0.6944980694980695
2959,2012-03-01,01E,1159,195,1354,0.8559822747415067
2960,2012-03-01,01F,871,410,1281,0.6799375487900078
2961,2012-03-01,01G,1321,1105,2426,0.544517724649629
2962,2012-03-01,01H,2409,719,3128,0.7701406649616368
2963,2012-03-01,01J,962,536,1498,0.6421895861148198
2964,2012-03-01,01K,2189,1012,3201,0.6838487972508591
2965,2012-03-01,01N,14,13,27,0.5185185185185185
2966,2012-03-01,01R,944,541,1485,0.6356902356902356
2967,2012-03-01,01T,799,394,1193,0.6697401508801342
2968,2012-03-01,01V,831,333,1164,0.7139175257731959
2969,2012-03-01,01W,1878,814,2692,0.6976225854383358
2970,2012-03-01,01X,1404,658,2062,0.6808923375363725
2971,2012-03-01,01Y,1399,621,2020,0.6925742574257425
2972,2012-03-01,02A,1361,775,2136,0.6371722846441947
2973,2012-03-01,02D,520,395,915,0.5683060109289617
2974,2012-03-01,02E,1196,500,1696,0.7051886792452831
2975,2012-03-01,02F,1585,585,2170,0.7304147465437788
2976,2012-03-01,02G,656,349,1005,0.6527363184079602
2977,2012-03-01,02H,1756,1349,3105,0.5655394524959743
2978,2012-03-01,02M,988,397,1385,0.7133574007220217
2979,2012-03-01,02N,1023,529,1552,0.6591494845360825
2980,2012-03-01,02P,1231,1001,2232,0.5515232974910395
2981,2012-03-01,02Q,581,427,1008,0.5763888888888888
2982,2012-03-01,02R,1950,799,2749,0.7093488541287741
2983,2012-03-01,02T,1102,569,1671,0.6594853381208857
2984,2012-03-01,02V,1332,599,1931,0.6897980321077162
2985,2012-03-01,02W,550,225,775,0.7096774193548387
2986,2012-03-01,02X,2056,1097,3153,0.6520773866159213
2987,2012-03-01,02Y,1794,834,2628,0.682648401826484
2988,2012-03-01,03A,1194,600,1794,0.6655518394648829
2989,2012-03-01,03C,1868,982,2850,0.655438596491228
2990,2012-03-01,03D,868,361,1229,0.7062652563059398
2991,2012-03-01,03E,896,472,1368,0.6549707602339181
2992,2012-03-01,03F,1625,661,2286,0.7108486439195101
2993,2012-03-01,03G,1644,656,2300,0.7147826086956521
2994,2012-03-01,03H,1163,458,1621,0.7174583590376311
2995,2012-03-01,03J,1107,418,1525,0.7259016393442623
2996,2012-03-01,03K,1018,231,1249,0.8150520416333067
2997,2012-03-01,03L,1342,884,2226,0.6028751123090745
2998,2012-03-01,03M,774,407,1181,0.655376799322608
2999,2012-03-01,03N,3336,813,4149,0.8040491684743312
3000,2012-03-01,03Q,1841,871,2712,0.678834808259587
3001,2012-03-01,03R,2386,981,3367,0.7086427086427086
3002,2012-03-01,03T,1801,562,2363,0.7621667371984765
3003,2012-03-01,03V,341,237,578,0.5899653979238755
3004,2012-03-01,03W,2080,1118,3198,0.6504065040650406
3005,2012-03-01,03X,513,170,683,0.7510980966325037
3006,2012-03-01,03Y,686,310,996,0.6887550200803213
3007,2012-03-01,04C,1839,956,2795,0.6579606440071556
3008,2012-03-01,04D,1380,596,1976,0.6983805668016194
3009,2012-03-01,04E,1117,474,1591,0.7020741671904462
3010,2012-03-01,04F,1436,864,2300,0.6243478260869565
3011,2012-03-01,04G,4168,2039,6207,0.671499919445787
3012,2012-03-01,04H,744,308,1052,0.7072243346007605
3013,2012-03-01,04J,1961,922,2883,0.6801942421089143
3014,2012-03-01,04K,1707,681,2388,0.714824120603015
3015,2012-03-01,04L,843,343,1186,0.7107925801011804
3016,2012-03-01,04M,567,221,788,0.7195431472081218
3017,2012-03-01,04N,754,268,1022,0.7377690802348337
3018,2012-03-01,04Q,862,296,1158,0.7443868739205527
3019,2012-03-01,04R,2747,1131,3878,0.7083548220732336
3020,2012-03-01,04V,2152,1186,3338,0.6446974236069503
3021,2012-03-01,04X,1229,1079,2308,0.5324956672443674
3022,2012-03-01,04Y,893,319,1212,0.7367986798679867
3023,2012-03-01,05A,2641,1302,3943,0.6697945726604109
3024,2012-03-01,05C,1129,1618,2747,0.4109938114306516
3025,2012-03-01,05D,818,426,1244,0.657556270096463
3026,2012-03-01,05F,1197,427,1624,0.7370689655172413
3027,2012-03-01,05G,1153,510,1663,0.6933253156945279
3028,2012-03-01,05H,1133,453,1586,0.71437578814628
3029,2012-03-01,05J,1282,456,1738,0.7376294591484465
3030,2012-03-01,05L,2453,1091,3544,0.6921557562076749
3031,2012-03-01,05N,2163,563,2726,0.793470286133529
3032,2012-03-01,05P,1281,643,1924,0.6658004158004158
3033,2012-03-01,05Q,1279,466,1745,0.7329512893982808
3034,2012-03-01,05R,1658,934,2592,0.6396604938271605
3035,2012-03-01,05T,1995,778,2773,0.7194374323837
3036,2012-03-01,05V,908,390,1298,0.699537750385208
3037,2012-03-01,05W,1419,653,2072,0.6848455598455598
3038,2012-03-01,05X,1285,349,1634,0.7864137086903304
3039,2012-03-01,05Y,1679,786,2465,0.6811359026369168
3040,2012-03-01,06A,1549,507,2056,0.7534046692607004
3041,2012-03-01,06D,762,350,1112,0.685251798561151
3042,2012-03-01,06F,1804,2136,3940,0.4578680203045685
3043,2012-03-01,06H,5188,2545,7733,0.6708909866804603
3044,2012-03-01,06K,3123,2003,5126,0.6092469761997659
3045,2012-03-01,06L,2324,1019,3343,0.6951839664971582
3046,2012-03-01,06M,1924,885,2809,0.684941260234959
3047,2012-03-01,06N,3301,1918,5219,0.632496646867216
3048,2012-03-01,06P,1007,661,1668,0.6037170263788969
3049,2012-03-01,06Q,2247,1124,3371,0.6665677840403441
3050,2012-03-01,06T,2311,1063,3374,0.6849436870183758
3051,2012-03-01,06V,1418,503,1921,0.7381572097865695
3052,2012-03-01,06W,1537,433,1970,0.7802030456852792
3053,2012-03-01,06Y,1311,390,1701,0.7707231040564374
3054,2012-03-01,07G,865,336,1201,0.720233139050791
3055,2012-03-01,07H,1607,851,2458,0.6537835638730676
3056,2012-03-01,07J,717,396,1113,0.6442048517520216
3057,2012-03-01,07K,1459,736,2195,0.6646924829157176
3058,2012-03-01,07L,727,246,973,0.7471736896197327
3059,2012-03-01,07M,1402,743,2145,0.6536130536130537
3060,2012-03-01,07N,1296,585,1881,0.6889952153110048
3061,2012-03-01,07P,780,284,1064,0.7330827067669173
3062,2012-03-01,07Q,1663,820,2483,0.6697543294401933
3063,2012-03-01,07R,758,482,1240,0.6112903225806452
3064,2012-03-01,07T,585,355,940,0.6223404255319149
3065,2012-03-01,07V,1785,705,2490,0.7168674698795181
3066,2012-03-01,07W,1017,745,1762,0.5771850170261067
3067,2012-03-01,07X,1293,575,1868,0.6921841541755889
3068,2012-03-01,07Y,768,578,1346,0.5705794947994056
3069,2012-03-01,08A,1226,558,1784,0.6872197309417041
3070,2012-03-01,08C,563,332,895,0.6290502793296089
3071,2012-03-01,08D,967,455,1422,0.680028129395218
3072,2012-03-01,08E,812,389,1201,0.6761032472939217
3073,2012-03-01,08F,1321,503,1824,0.7242324561403509
3074,2012-03-01,08G,510,1294,1804,0.2827050997782705
3075,2012-03-01,08H,847,488,1335,0.6344569288389513
3076,2012-03-01,08J,763,387,1150,0.6634782608695652
3077,2012-03-01,08K,1160,522,1682,0.6896551724137931
3078,2012-03-01,08L,961,886,1847,0.5203031943692474
3079,2012-03-01,08M,1123,346,1469,0.7644656228727025
3080,2012-03-01,08N,1089,326,1415,0.7696113074204947
3081,2012-03-01,08P,910,427,1337,0.680628272251309
3082,2012-03-01,08Q,1068,379,1447,0.7380787836903939
3083,2012-03-01,08R,893,409,1302,0.6858678955453149
3084,2012-03-01,08T,1057,447,1504,0.7027925531914894
3085,2012-03-01,08V,1071,406,1477,0.7251184834123223
3086,2012-03-01,08W,1053,379,1432,0.7353351955307262
3087,2012-03-01,08X,1228,496,1724,0.7122969837587007
3088,2012-03-01,08Y,787,334,1121,0.7020517395182873
3089,2012-03-01,09A,523,378,901,0.5804661487236404
3090,2012-03-01,09C,753,342,1095,0.6876712328767123
3091,2012-03-01,09D,1447,885,2332,0.6204974271012007
3092,2012-03-01,09E,1685,570,2255,0.7472283813747228
3093,2012-03-01,09F,1377,614,1991,0.6916122551481667
3094,2012-03-01,09G,3270,1967,5237,0.6244032843230858
3095,2012-03-01,09H,639,279,918,0.696078431372549
3096,2012-03-01,09J,1601,758,2359,0.678677405680373
3097,2012-03-01,09L,873,501,1374,0.6353711790393013
3098,2012-03-01,09N,1162,680,1842,0.6308360477741585
3099,2012-03-01,09P,1178,774,1952,0.6034836065573771
3100,2012-03-01,09W,1556,541,2097,0.7420123986647592
3101,2012-03-01,09X,1112,742,1854,0.5997842502696872
3102,2012-03-01,09Y,1705,1085,2790,0.6111111111111112
3103,2012-03-01,10A,1148,636,1784,0.6434977578475336
3104,2012-03-01,10C,469,283,752,0.6236702127659575
3105,2012-03-01,10D,601,194,795,0.7559748427672957
3106,2012-03-01,10E,806,318,1124,0.7170818505338078
3107,2012-03-01,10G,648,307,955,0.6785340314136126
3108,2012-03-01,10H,1942,1010,2952,0.657859078590786
3109,2012-03-01,10J,1074,943,2017,0.5324739712444224
3110,2012-03-01,10K,1189,677,1866,0.6371918542336549
3111,2012-03-01,10L,1005,387,1392,0.7219827586206896
3112,2012-03-01,10M,568,385,953,0.5960125918153201
3113,2012-03-01,10N,451,350,801,0.5630461922596754
3114,2012-03-01,10Q,2494,2568,5062,0.4926906361122086
3115,2012-03-01,10R,1333,522,1855,0.7185983827493262
3116,2012-03-01,10T,608,244,852,0.7136150234741784
3117,2012-03-01,10V,1155,798,1953,0.5913978494623656
3118,2012-03-01,10W,654,332,986,0.6632860040567952
3119,2012-03-01,10X,1204,619,1823,0.6604498080087767
3120,2012-03-01,10Y,1284,755,2039,0.6297204512015694
3121,2012-03-01,11A,3283,1772,5055,0.649455984174085
3122,2012-03-01,11C,854,340,1194,0.7152428810720268
3123,2012-03-01,11D,700,495,1195,0.5857740585774058
3124,2012-03-01,11E,1246,864,2110,0.590521327014218
3125,2012-03-01,11H,2430,1466,3896,0.6237166324435318
3126,2012-03-01,11J,4791,2613,7404,0.6470826580226904
3127,2012-03-01,11M,3637,1760,5397,0.673892903464888
3128,2012-03-01,11N,4122,1393,5515,0.7474161378059837
3129,2012-03-01,11T,1471,806,2277,0.6460254721124287
3130,2012-03-01,11X,3454,1852,5306,0.6509611760271391
3131,2012-03-01,12A,1477,759,2236,0.6605545617173524
3132,2012-03-01,12D,1145,614,1759,0.6509380329732802
3133,2012-03-01,12F,2610,501,3111,0.8389585342333655
3134,2012-03-01,13P,3251,1493,4744,0.6852866779089376
3135,2012-03-01,13T,3285,1287,4572,0.718503937007874
3136,2012-03-01,14L,2846,1678,4524,0.6290893015030946
3137,2012-03-01,99A,2843,815,3658,0.7772006560962275
3138,2012-03-01,99C,1604,747,2351,0.6822628668651638
3139,2012-03-01,99D,1136,589,1725,0.6585507246376812
3140,2012-03-01,99E,1572,552,2124,0.7401129943502824
3141,2012-03-01,99F,1087,296,1383,0.7859725234996384
3142,2012-03-01,99G,981,269,1250,0.7848
3143,2012-03-01,99H,1512,868,2380,0.6352941176470588
3144,2012-03-01,99J,3024,1282,4306,0.702275894101254
3145,2012-03-01,99K,974,622,1596,0.6102756892230576
3146,2012-03-01,99M,1023,800,1823,0.5611629182665935
3147,2012-03-01,99N,2743,2381,5124,0.5353239656518345
3148,2012-03-01,99P,6454,2295,8749,0.7376843067779175
3149,2012-03-01,99Q,1896,872,2768,0.684971098265896
3150,2012-04-01,00C,668,276,944,0.7076271186440678
3151,2012-04-01,00D,1889,973,2862,0.6600279524807827
3152,2012-04-01,00F,22,8,30,0.7333333333333333
3153,2012-04-01,00J,1469,785,2254,0.6517302573203194
3154,2012-04-01,00K,1896,1047,2943,0.6442405708460754
3155,2012-04-01,00L,2130,1262,3392,0.6279481132075472
3156,2012-04-01,00M,1897,973,2870,0.6609756097560976
3157,2012-04-01,00N,1033,551,1584,0.6521464646464646
3158,2012-04-01,00P,1766,586,2352,0.7508503401360545
3159,2012-04-01,00Q,841,330,1171,0.7181895815542272
3160,2012-04-01,00R,1132,407,1539,0.7355425601039636
3161,2012-04-01,00T,1664,819,2483,0.6701570680628273
3162,2012-04-01,00V,1153,594,1747,0.659988551803091
3163,2012-04-01,00W,67,26,93,0.7204301075268817
3164,2012-04-01,00X,910,245,1155,0.7878787878787878
3165,2012-04-01,00Y,1620,740,2360,0.6864406779661016
3166,2012-04-01,01A,2216,1081,3297,0.6721261753108887
3167,2012-04-01,01C,1145,596,1741,0.6576680068925904
3168,2012-04-01,01D,1335,612,1947,0.6856702619414484
3169,2012-04-01,01E,1001,171,1172,0.8540955631399317
3170,2012-04-01,01F,825,411,1236,0.6674757281553398
3171,2012-04-01,01G,1181,911,2092,0.5645315487571702
3172,2012-04-01,01H,2207,702,2909,0.7586799587487109
3173,2012-04-01,01J,874,404,1278,0.6838810641627543
3174,2012-04-01,01K,1989,1002,2991,0.6649949849548646
3175,2012-04-01,01N,13,21,34,0.38235294117647056
3176,2012-04-01,01R,914,508,1422,0.6427566807313643
3177,2012-04-01,01T,701,328,1029,0.6812439261418853
3178,2012-04-01,01V,715,299,1014,0.7051282051282052
3179,2012-04-01,01W,1720,765,2485,0.6921529175050302
3180,2012-04-01,01X,1256,589,1845,0.6807588075880758
3181,2012-04-01,01Y,1288,627,1915,0.6725848563968668
3182,2012-04-01,02A,1189,654,1843,0.6451437873033098
3183,2012-04-01,02D,503,310,813,0.6186961869618696
3184,2012-04-01,02E,1015,459,1474,0.6886024423337856
3185,2012-04-01,02F,1496,510,2006,0.7457627118644068
3186,2012-04-01,02G,540,273,813,0.6642066420664207
3187,2012-04-01,02H,1513,1232,2745,0.551183970856102
3188,2012-04-01,02M,877,338,1215,0.7218106995884773
3189,2012-04-01,02N,923,471,1394,0.6621233859397417
3190,2012-04-01,02P,1159,944,2103,0.5511174512601046
3191,2012-04-01,02Q,551,446,997,0.5526579739217653
3192,2012-04-01,02R,1800,751,2551,0.7056056448451588
3193,2012-04-01,02T,937,517,1454,0.6444291609353507
3194,2012-04-01,02V,1257,584,1841,0.6827810972297664
3195,2012-04-01,02W,548,181,729,0.7517146776406035
3196,2012-04-01,02X,1645,976,2621,0.6276230446394506
3197,2012-04-01,02Y,1705,761,2466,0.6914030819140308
3198,2012-04-01,03A,1122,489,1611,0.6964618249534451
3199,2012-04-01,03C,1703,840,2543,0.6696814785686197
3200,2012-04-01,03D,788,281,1069,0.7371375116931712
3201,2012-04-01,03E,763,437,1200,0.6358333333333334
3202,2012-04-01,03F,1363,555,1918,0.7106360792492179
3203,2012-04-01,03G,1493,640,2133,0.6999531176746366
3204,2012-04-01,03H,1096,397,1493,0.7340924313462827
3205,2012-04-01,03J,1006,380,1386,0.7258297258297258
3206,2012-04-01,03K,946,188,1134,0.8342151675485009
3207,2012-04-01,03L,1164,818,1982,0.5872855701311807
3208,2012-04-01,03M,754,356,1110,0.6792792792792792
3209,2012-04-01,03N,2898,791,3689,0.7855787476280834
3210,2012-04-01,03Q,1674,871,2545,0.6577603143418468
3211,2012-04-01,03R,2058,874,2932,0.7019099590723056
3212,2012-04-01,03T,1720,557,2277,0.7553798858146684
3213,2012-04-01,03V,306,215,521,0.5873320537428023
3214,2012-04-01,03W,1870,1078,2948,0.6343283582089553
3215,2012-04-01,03X,432,149,581,0.7435456110154905
3216,2012-04-01,03Y,633,288,921,0.6872964169381107
3217,2012-04-01,04C,1693,798,2491,0.6796467282215978
3218,2012-04-01,04D,1128,579,1707,0.6608084358523726
3219,2012-04-01,04E,1034,448,1482,0.6977058029689609
3220,2012-04-01,04F,1241,795,2036,0.6095284872298625
3221,2012-04-01,04G,3957,1882,5839,0.6776845350231204
3222,2012-04-01,04H,602,290,892,0.6748878923766816
3223,2012-04-01,04J,1762,836,2598,0.6782140107775212
3224,2012-04-01,04K,1412,622,2034,0.6941986234021632
3225,2012-04-01,04L,753,302,1055,0.7137440758293839
3226,2012-04-01,04M,508,203,711,0.7144866385372715
3227,2012-04-01,04N,680,259,939,0.724174653887114
3228,2012-04-01,04Q,724,299,1023,0.70772238514174
3229,2012-04-01,04R,2355,1039,3394,0.6938715380082499
3230,2012-04-01,04V,1911,1007,2918,0.6549006168608636
3231,2012-04-01,04X,1145,917,2062,0.555286129970902
3232,2012-04-01,04Y,798,299,1097,0.7274384685505926
3233,2012-04-01,05A,2318,1177,3495,0.6632331902718169
3234,2012-04-01,05C,1030,1403,2433,0.42334566378956023
3235,2012-04-01,05D,701,352,1053,0.6657169990503324
3236,2012-04-01,05F,1125,405,1530,0.7352941176470589
3237,2012-04-01,05G,1116,480,1596,0.6992481203007519
3238,2012-04-01,05H,1000,426,1426,0.7012622720897616
3239,2012-04-01,05J,1179,422,1601,0.7364147407870081
3240,2012-04-01,05L,2328,974,3302,0.7050272562083586
3241,2012-04-01,05N,1948,571,2519,0.7733227471218738
3242,2012-04-01,05P,1197,587,1784,0.6709641255605381
3243,2012-04-01,05Q,1156,431,1587,0.7284183994959043
3244,2012-04-01,05R,1528,860,2388,0.6398659966499163
3245,2012-04-01,05T,1771,785,2556,0.6928794992175273
3246,2012-04-01,05V,873,344,1217,0.7173377156943304
3247,2012-04-01,05W,1311,619,1930,0.6792746113989637
3248,2012-04-01,05X,1098,310,1408,0.7798295454545454
3249,2012-04-01,05Y,1486,734,2220,0.6693693693693694
3250,2012-04-01,06A,1286,530,1816,0.7081497797356828
3251,2012-04-01,06D,743,324,1067,0.6963448922211809
3252,2012-04-01,06F,1540,2080,3620,0.425414364640884
3253,2012-04-01,06H,4716,2383,7099,0.664318918157487
3254,2012-04-01,06K,2790,1820,4610,0.6052060737527115
3255,2012-04-01,06L,2174,869,3043,0.7144265527440026
3256,2012-04-01,06M,1700,751,2451,0.69359445124439
3257,2012-04-01,06N,3015,1762,4777,0.6311492568557672
3258,2012-04-01,06P,955,611,1566,0.6098339719029374
3259,2012-04-01,06Q,2070,1107,3177,0.6515580736543909
3260,2012-04-01,06T,2106,994,3100,0.6793548387096774
3261,2012-04-01,06V,1369,507,1876,0.7297441364605544
3262,2012-04-01,06W,1344,434,1778,0.7559055118110236
3263,2012-04-01,06Y,1242,407,1649,0.7531837477258945
3264,2012-04-01,07G,851,324,1175,0.7242553191489361
3265,2012-04-01,07H,1508,813,2321,0.6497199482981474
3266,2012-04-01,07J,673,363,1036,0.6496138996138996
3267,2012-04-01,07K,1284,621,1905,0.6740157480314961
3268,2012-04-01,07L,668,232,900,0.7422222222222222
3269,2012-04-01,07M,1121,641,1762,0.6362088535754824
3270,2012-04-01,07N,1145,507,1652,0.6930992736077481
3271,2012-04-01,07P,665,274,939,0.7082002129925452
3272,2012-04-01,07Q,1529,705,2234,0.6844225604297225
3273,2012-04-01,07R,667,423,1090,0.6119266055045871
3274,2012-04-01,07T,586,287,873,0.6712485681557846
3275,2012-04-01,07V,1599,667,2266,0.705648720211827
3276,2012-04-01,07W,913,652,1565,0.5833865814696486
3277,2012-04-01,07X,1087,527,1614,0.6734820322180917
3278,2012-04-01,07Y,709,482,1191,0.5952980688497062
3279,2012-04-01,08A,1094,539,1633,0.6699326393141457
3280,2012-04-01,08C,571,322,893,0.6394176931690929
3281,2012-04-01,08D,794,414,1208,0.6572847682119205
3282,2012-04-01,08E,775,378,1153,0.6721595836947094
3283,2012-04-01,08F,1264,501,1765,0.7161473087818697
3284,2012-04-01,08G,515,1166,1681,0.30636525877453896
3285,2012-04-01,08H,699,423,1122,0.6229946524064172
3286,2012-04-01,08J,728,324,1052,0.6920152091254753
3287,2012-04-01,08K,1008,430,1438,0.7009735744089013
3288,2012-04-01,08L,812,747,1559,0.5208466966003849
3289,2012-04-01,08M,1012,339,1351,0.7490747594374537
3290,2012-04-01,08N,999,351,1350,0.74
3291,2012-04-01,08P,781,373,1154,0.6767764298093587
3292,2012-04-01,08Q,854,306,1160,0.7362068965517241
3293,2012-04-01,08R,752,356,1108,0.6787003610108303
3294,2012-04-01,08T,874,443,1317,0.6636294608959757
3295,2012-04-01,08V,1001,332,1333,0.7509377344336085
3296,2012-04-01,08W,920,364,1284,0.7165109034267912
3297,2012-04-01,08X,1068,471,1539,0.6939571150097466
3298,2012-04-01,08Y,645,302,947,0.6810982048574445
3299,2012-04-01,09A,451,324,775,0.5819354838709677
3300,2012-04-01,09C,605,302,907,0.6670341786108048
3301,2012-04-01,09D,1259,803,2062,0.6105722599418041
3302,2012-04-01,09E,1635,612,2247,0.7276368491321762
3303,2012-04-01,09F,1170,550,1720,0.6802325581395349
3304,2012-04-01,09G,2868,1696,4564,0.628396143733567
3305,2012-04-01,09H,558,253,811,0.688039457459926
3306,2012-04-01,09J,1341,650,1991,0.6735308890005023
3307,2012-04-01,09L,758,422,1180,0.6423728813559322
3308,2012-04-01,09N,969,608,1577,0.6144578313253012
3309,2012-04-01,09P,1026,678,1704,0.602112676056338
3310,2012-04-01,09W,1254,487,1741,0.72027570361861
3311,2012-04-01,09X,961,709,1670,0.5754491017964072
3312,2012-04-01,09Y,1539,986,2525,0.6095049504950495
3313,2012-04-01,10A,1085,526,1611,0.6734947237740534
3314,2012-04-01,10C,409,237,646,0.6331269349845201
3315,2012-04-01,10D,524,180,704,0.7443181818181818
3316,2012-04-01,10E,711,267,978,0.7269938650306749
3317,2012-04-01,10G,586,279,865,0.6774566473988439
3318,2012-04-01,10H,1649,983,2632,0.6265197568389058
3319,2012-04-01,10J,866,881,1747,0.4957069261591299
3320,2012-04-01,10K,1085,600,1685,0.6439169139465876
3321,2012-04-01,10L,781,328,1109,0.7042380522993688
3322,2012-04-01,10M,465,338,803,0.5790784557907845
3323,2012-04-01,10N,431,337,768,0.5611979166666666
3324,2012-04-01,10Q,2216,2227,4443,0.49876209768174656
3325,2012-04-01,10R,1176,495,1671,0.703770197486535
3326,2012-04-01,10T,516,249,765,0.6745098039215687
3327,2012-04-01,10V,1009,687,1696,0.5949292452830188
3328,2012-04-01,10W,502,281,783,0.6411238825031929
3329,2012-04-01,10X,1069,553,1622,0.659062885326757
3330,2012-04-01,10Y,1136,708,1844,0.6160520607375272
3331,2012-04-01,11A,2862,1655,4517,0.6336063759132168
3332,2012-04-01,11C,838,316,1154,0.7261698440207972
3333,2012-04-01,11D,598,448,1046,0.5717017208413002
3334,2012-04-01,11E,1082,788,1870,0.5786096256684492
3335,2012-04-01,11H,2335,1294,3629,0.6434279415817029
3336,2012-04-01,11J,4311,2323,6634,0.6498341875188424
3337,2012-04-01,11M,3218,1699,4917,0.6544641041285336
3338,2012-04-01,11N,3584,1223,4807,0.7455793634283336
3339,2012-04-01,11T,1386,756,2142,0.6470588235294118
3340,2012-04-01,11X,3004,1656,4660,0.6446351931330472
3341,2012-04-01,12A,1321,699,2020,0.653960396039604
3342,2012-04-01,12D,1021,569,1590,0.6421383647798742
3343,2012-04-01,12F,2244,461,2705,0.8295748613678373
3344,2012-04-01,13P,2858,1364,4222,0.6769303647560397
3345,2012-04-01,13T,2856,1180,4036,0.707631318136769
3346,2012-04-01,14L,2517,1415,3932,0.6401322482197355
3347,2012-04-01,99A,2525,703,3228,0.7822180916976456
3348,2012-04-01,99C,1346,636,1982,0.6791120080726539
3349,2012-04-01,99D,1021,585,1606,0.6357409713574097
3350,2012-04-01,99E,1375,526,1901,0.7233035244608101
3351,2012-04-01,99F,1004,262,1266,0.7930489731437599
3352,2012-04-01,99G,923,261,1184,0.7795608108108109
3353,2012-04-01,99H,1392,748,2140,0.6504672897196262
3354,2012-04-01,99J,2726,1237,3963,0.6878627302548574
3355,2012-04-01,99K,908,556,1464,0.6202185792349727
3356,2012-04-01,99M,906,720,1626,0.5571955719557196
3357,2012-04-01,99N,2515,2244,4759,0.5284723681445682
3358,2012-04-01,99P,5610,2118,7728,0.7259316770186336
3359,2012-04-01,99Q,1696,694,2390,0.7096234309623431
3360,2012-05-01,00C,718,272,990,0.7252525252525253
3361,2012-05-01,00D,2240,1039,3279,0.6831351021652943
3362,2012-05-01,00F,19,7,26,0.7307692307692307
3363,2012-05-01,00J,1645,846,2491,0.660377358490566
3364,2012-05-01,00K,2159,1131,3290,0.6562310030395136
3365,2012-05-01,00L,2236,1407,3643,0.6137798517705189
3366,2012-05-01,00M,2136,1062,3198,0.6679174484052532
3367,2012-05-01,00N,1240,630,1870,0.6631016042780749
3368,2012-05-01,00P,1970,720,2690,0.7323420074349443
3369,2012-05-01,00Q,979,338,1317,0.7433561123766135
3370,2012-05-01,00R,1196,432,1628,0.7346437346437347
3371,2012-05-01,00T,1849,974,2823,0.6549769748494509
3372,2012-05-01,00V,1268,600,1868,0.6788008565310493
3373,2012-05-01,00W,73,16,89,0.8202247191011236
3374,2012-05-01,00X,950,260,1210,0.7851239669421488
3375,2012-05-01,00Y,1796,875,2671,0.6724073380756271
3376,2012-05-01,01A,2370,1223,3593,0.6596159198441414
3377,2012-05-01,01C,1261,709,1970,0.6401015228426395
3378,2012-05-01,01D,1477,648,2125,0.6950588235294117
3379,2012-05-01,01E,1065,179,1244,0.8561093247588425
3380,2012-05-01,01F,849,385,1234,0.6880064829821718
3381,2012-05-01,01G,1393,1015,2408,0.5784883720930233
3382,2012-05-01,01H,2384,765,3149,0.7570657351540171
3383,2012-05-01,01J,955,450,1405,0.6797153024911032
3384,2012-05-01,01K,2158,1062,3220,0.6701863354037267
3385,2012-05-01,01N,25,10,35,0.7142857142857143
3386,2012-05-01,01R,986,554,1540,0.6402597402597403
3387,2012-05-01,01T,784,386,1170,0.67008547008547
3388,2012-05-01,01V,824,317,1141,0.7221735319894829
3389,2012-05-01,01W,1906,791,2697,0.7067111605487579
3390,2012-05-01,01X,1452,640,2092,0.6940726577437859
3391,2012-05-01,01Y,1337,672,2009,0.6655052264808362
3392,2012-05-01,02A,1250,770,2020,0.6188118811881188
3393,2012-05-01,02D,526,405,931,0.564983888292159
3394,2012-05-01,02E,1234,500,1734,0.7116493656286044
3395,2012-05-01,02F,1633,576,2209,0.739248528746039
3396,2012-05-01,02G,645,349,994,0.6488933601609658
3397,2012-05-01,02H,1620,1396,3016,0.5371352785145889
3398,2012-05-01,02M,981,386,1367,0.717629846378932
3399,2012-05-01,02N,992,508,1500,0.6613333333333333
3400,2012-05-01,02P,1340,1067,2407,0.5567095970087246
3401,2012-05-01,02Q,627,434,1061,0.590951932139491
3402,2012-05-01,02R,2076,897,2973,0.698284561049445
3403,2012-05-01,02T,1126,575,1701,0.6619635508524397
3404,2012-05-01,02V,1412,632,2044,0.6908023483365949
3405,2012-05-01,02W,581,233,814,0.7137592137592138
3406,2012-05-01,02X,1932,1072,3004,0.6431424766977364
3407,2012-05-01,02Y,1814,826,2640,0.6871212121212121
3408,2012-05-01,03A,1137,568,1705,0.6668621700879765
3409,2012-05-01,03C,2000,926,2926,0.683526999316473
3410,2012-05-01,03D,768,337,1105,0.6950226244343891
3411,2012-05-01,03E,864,476,1340,0.6447761194029851
3412,2012-05-01,03F,1509,674,2183,0.6912505726065048
3413,2012-05-01,03G,1601,729,2330,0.6871244635193133
3414,2012-05-01,03H,1213,439,1652,0.7342615012106537
3415,2012-05-01,03J,1118,407,1525,0.7331147540983607
3416,2012-05-01,03K,1042,233,1275,0.8172549019607843
3417,2012-05-01,03L,1280,927,2207,0.5799728137743543
3418,2012-05-01,03M,816,420,1236,0.6601941747572816
3419,2012-05-01,03N,3344,853,4197,0.7967595901834644
3420,2012-05-01,03Q,1857,876,2733,0.6794731064763996
3421,2012-05-01,03R,2324,946,3270,0.710703363914373
3422,2012-05-01,03T,1697,570,2267,0.7485663872959859
3423,2012-05-01,03V,388,285,673,0.5765230312035661
3424,2012-05-01,03W,2027,1132,3159,0.6416587527698638
3425,2012-05-01,03X,477,199,676,0.7056213017751479
3426,2012-05-01,03Y,675,331,1006,0.6709741550695825
3427,2012-05-01,04C,1749,909,2658,0.6580135440180587
3428,2012-05-01,04D,1289,564,1853,0.6956287101996762
3429,2012-05-01,04E,1181,522,1703,0.6934820904286553
3430,2012-05-01,04F,1417,884,2301,0.615819209039548
3431,2012-05-01,04G,4265,2171,6436,0.6626786824114357
3432,2012-05-01,04H,676,294,970,0.6969072164948453
3433,2012-05-01,04J,1967,1033,3000,0.6556666666666666
3434,2012-05-01,04K,1653,690,2343,0.70550576184379
3435,2012-05-01,04L,827,356,1183,0.6990701606086221
3436,2012-05-01,04M,495,239,734,0.6743869209809265
3437,2012-05-01,04N,683,301,984,0.6941056910569106
3438,2012-05-01,04Q,881,326,1207,0.7299088649544325
3439,2012-05-01,04R,2512,1152,3664,0.6855895196506551
3440,2012-05-01,04V,2131,1119,3250,0.6556923076923077
3441,2012-05-01,04X,1285,997,2282,0.563102541630149
3442,2012-05-01,04Y,1045,364,1409,0.7416607523066004
3443,2012-05-01,05A,2646,1319,3965,0.6673392181588903
3444,2012-05-01,05C,1179,1553,2732,0.4315519765739385
3445,2012-05-01,05D,850,415,1265,0.6719367588932806
3446,2012-05-01,05F,1186,400,1586,0.7477931904161412
3447,2012-05-01,05G,1177,545,1722,0.6835075493612079
3448,2012-05-01,05H,1206,514,1720,0.7011627906976744
3449,2012-05-01,05J,1364,496,1860,0.7333333333333333
3450,2012-05-01,05L,2458,1096,3554,0.6916150815981992
3451,2012-05-01,05N,2150,594,2744,0.7835276967930029
3452,2012-05-01,05P,1370,567,1937,0.7072792978833248
3453,2012-05-01,05Q,1249,509,1758,0.7104664391353811
3454,2012-05-01,05R,1747,1003,2750,0.6352727272727273
3455,2012-05-01,05T,1962,806,2768,0.7088150289017341
3456,2012-05-01,05V,978,390,1368,0.7149122807017544
3457,2012-05-01,05W,1340,655,1995,0.6716791979949874
3458,2012-05-01,05X,1176,363,1539,0.7641325536062378
3459,2012-05-01,05Y,1635,822,2457,0.6654456654456654
3460,2012-05-01,06A,1483,523,2006,0.7392821535393819
3461,2012-05-01,06D,819,355,1174,0.6976149914821125
3462,2012-05-01,06F,1750,2186,3936,0.4446138211382114
3463,2012-05-01,06H,5231,2646,7877,0.6640853116668782
3464,2012-05-01,06K,3113,1919,5032,0.6186406995230525
3465,2012-05-01,06L,2341,997,3338,0.7013181545835829
3466,2012-05-01,06M,1879,842,2721,0.6905549430356487
3467,2012-05-01,06N,3315,1991,5306,0.6247644176404071
3468,2012-05-01,06P,978,674,1652,0.5920096852300242
3469,2012-05-01,06Q,2273,1193,3466,0.655799192152337
3470,2012-05-01,06T,2290,1098,3388,0.6759149940968123
3471,2012-05-01,06V,1370,488,1858,0.7373519913885899
3472,2012-05-01,06W,1501,459,1960,0.7658163265306123
3473,2012-05-01,06Y,1314,447,1761,0.7461669505962522
3474,2012-05-01,07G,926,324,1250,0.7408
3475,2012-05-01,07H,1608,900,2508,0.6411483253588517
3476,2012-05-01,07J,746,414,1160,0.6431034482758621
3477,2012-05-01,07K,1470,672,2142,0.6862745098039216
3478,2012-05-01,07L,809,243,1052,0.7690114068441065
3479,2012-05-01,07M,1320,745,2065,0.639225181598063
3480,2012-05-01,07N,1358,610,1968,0.6900406504065041
3481,2012-05-01,07P,774,312,1086,0.712707182320442
3482,2012-05-01,07Q,1701,810,2511,0.6774193548387096
3483,2012-05-01,07R,779,487,1266,0.6153238546603476
3484,2012-05-01,07T,575,361,936,0.6143162393162394
3485,2012-05-01,07V,1798,841,2639,0.6813186813186813
3486,2012-05-01,07W,1090,736,1826,0.5969331872946331
3487,2012-05-01,07X,1298,575,1873,0.6930058729311266
3488,2012-05-01,07Y,796,505,1301,0.611837048424289
3489,2012-05-01,08A,1286,612,1898,0.6775553213909379
3490,2012-05-01,08C,651,363,1014,0.6420118343195266
3491,2012-05-01,08D,873,446,1319,0.6618650492797574
3492,2012-05-01,08E,900,424,1324,0.6797583081570997
3493,2012-05-01,08F,1341,532,1873,0.7159636946075815
3494,2012-05-01,08G,526,1317,1843,0.2854042322300597
3495,2012-05-01,08H,857,481,1338,0.64050822122571
3496,2012-05-01,08J,850,358,1208,0.7036423841059603
3497,2012-05-01,08K,1227,513,1740,0.7051724137931035
3498,2012-05-01,08L,789,816,1605,0.491588785046729
3499,2012-05-01,08M,1027,317,1344,0.7641369047619048
3500,2012-05-01,08N,1132,408,1540,0.7350649350649351
3501,2012-05-01,08P,920,437,1357,0.6779661016949152
3502,2012-05-01,08Q,1011,400,1411,0.7165131112686038
3503,2012-05-01,08R,850,396,1246,0.6821829855537721
3504,2012-05-01,08T,951,446,1397,0.6807444523979957
3505,2012-05-01,08V,1033,366,1399,0.7383845604002859
3506,2012-05-01,08W,1087,384,1471,0.7389530931339225
3507,2012-05-01,08X,1169,543,1712,0.6828271028037384
3508,2012-05-01,08Y,667,369,1036,0.6438223938223938
3509,2012-05-01,09A,557,345,902,0.6175166297117517
3510,2012-05-01,09C,704,347,1051,0.6698382492863939
3511,2012-05-01,09D,1470,902,2372,0.6197301854974705
3512,2012-05-01,09E,1470,528,1998,0.7357357357357357
3513,2012-05-01,09F,1388,610,1998,0.6946946946946947
3514,2012-05-01,09G,3205,1956,5161,0.621003681457082
3515,2012-05-01,09H,634,304,938,0.67590618336887
3516,2012-05-01,09J,1550,695,2245,0.6904231625835189
3517,2012-05-01,09L,847,468,1315,0.644106463878327
3518,2012-05-01,09N,1095,662,1757,0.6232214001138304
3519,2012-05-01,09P,1173,820,1993,0.5885599598595083
3520,2012-05-01,09W,1390,566,1956,0.7106339468302658
3521,2012-05-01,09X,1169,750,1919,0.6091714434601355
3522,2012-05-01,09Y,1732,1142,2874,0.6026443980514962
3523,2012-05-01,10A,1149,578,1727,0.6653155761436016
3524,2012-05-01,10C,500,305,805,0.6211180124223602
3525,2012-05-01,10D,606,163,769,0.788036410923277
3526,2012-05-01,10E,820,321,1141,0.7186678352322524
3527,2012-05-01,10G,679,325,1004,0.6762948207171314
3528,2012-05-01,10H,1740,968,2708,0.6425406203840472
3529,2012-05-01,10J,1039,928,1967,0.5282155566853076
3530,2012-05-01,10K,1206,746,1952,0.617827868852459
3531,2012-05-01,10L,1076,372,1448,0.7430939226519337
3532,2012-05-01,10M,555,453,1008,0.5505952380952381
3533,2012-05-01,10N,440,364,804,0.5472636815920398
3534,2012-05-01,10Q,2610,2583,5193,0.5025996533795494
3535,2012-05-01,10R,1372,571,1943,0.7061245496654658
3536,2012-05-01,10T,584,283,867,0.6735870818915801
3537,2012-05-01,10V,1189,750,1939,0.6132026817947396
3538,2012-05-01,10W,655,341,996,0.6576305220883534
3539,2012-05-01,10X,1320,610,1930,0.6839378238341969
3540,2012-05-01,10Y,1243,737,1980,0.6277777777777778
3541,2012-05-01,11A,3217,1855,5072,0.6342665615141956
3542,2012-05-01,11C,811,375,1186,0.6838111298482293
3543,2012-05-01,11D,687,524,1211,0.5672997522708505
3544,2012-05-01,11E,1180,811,1991,0.5926670015067805
3545,2012-05-01,11H,2625,1461,4086,0.6424375917767988
3546,2012-05-01,11J,4786,2652,7438,0.6434525410056466
3547,2012-05-01,11M,3616,1843,5459,0.6623923795566954
3548,2012-05-01,11N,4115,1465,5580,0.7374551971326165
3549,2012-05-01,11T,1428,839,2267,0.6299073665637406
3550,2012-05-01,11X,3414,1924,5338,0.6395653802922443
3551,2012-05-01,12A,1443,772,2215,0.6514672686230248
3552,2012-05-01,12D,1055,629,1684,0.6264845605700713
3553,2012-05-01,12F,2436,531,2967,0.8210313447927199
3554,2012-05-01,13P,3183,1479,4662,0.6827541827541828
3555,2012-05-01,13T,3202,1329,4531,0.7066872655043037
3556,2012-05-01,14L,2914,1622,4536,0.642416225749559
3557,2012-05-01,99A,2709,841,3550,0.7630985915492958
3558,2012-05-01,99C,1521,730,2251,0.6756996890270991
3559,2012-05-01,99D,1070,567,1637,0.6536346976175932
3560,2012-05-01,99E,1585,530,2115,0.7494089834515366
3561,2012-05-01,99F,1045,293,1338,0.78101644245142
3562,2012-05-01,99G,1031,305,1336,0.7717065868263473
3563,2012-05-01,99H,1668,862,2530,0.6592885375494071
3564,2012-05-01,99J,3110,1315,4425,0.7028248587570621
3565,2012-05-01,99K,1062,605,1667,0.6370725854829035
3566,2012-05-01,99M,1032,844,1876,0.5501066098081023
3567,2012-05-01,99N,2820,2365,5185,0.5438765670202508
3568,2012-05-01,99P,6476,2298,8774,0.7380898108046501
3569,2012-05-01,99Q,1952,776,2728,0.7155425219941349
3570,2012-06-01,00C,667,275,942,0.7080679405520169
3571,2012-06-01,00D,2107,982,3089,0.6820977662674005
3572,2012-06-01,00F,14,4,18,0.7777777777777778
3573,2012-06-01,00J,1615,836,2451,0.6589147286821705
3574,2012-06-01,00K,2171,1140,3311,0.655693144065237
3575,2012-06-01,00L,2193,1403,3596,0.6098442714126807
3576,2012-06-01,00M,2125,1056,3181,0.6680289217227287
3577,2012-06-01,00N,1145,602,1747,0.6554092730394963
3578,2012-06-01,00P,1698,696,2394,0.7092731829573935
3579,2012-06-01,00Q,871,319,1190,0.7319327731092437
3580,2012-06-01,00R,1164,400,1564,0.7442455242966752
3581,2012-06-01,00T,1920,1005,2925,0.6564102564102564
3582,2012-06-01,00V,1287,615,1902,0.6766561514195584
3583,2012-06-01,00W,67,26,93,0.7204301075268817
3584,2012-06-01,00X,996,270,1266,0.7867298578199052
3585,2012-06-01,00Y,1703,814,2517,0.6765991259435836
3586,2012-06-01,01A,2359,1126,3485,0.6769010043041607
3587,2012-06-01,01C,1219,705,1924,0.6335758835758836
3588,2012-06-01,01D,1510,649,2159,0.6993978693839741
3589,2012-06-01,01E,1069,178,1247,0.8572574178027266
3590,2012-06-01,01F,875,424,1299,0.6735950731331793
3591,2012-06-01,01G,1209,1080,2289,0.528178243774574
3592,2012-06-01,01H,2444,726,3170,0.7709779179810725
3593,2012-06-01,01J,941,451,1392,0.6760057471264368
3594,2012-06-01,01K,2066,1044,3110,0.6643086816720257
3595,2012-06-01,01N,19,17,36,0.5277777777777778
3596,2012-06-01,01R,978,531,1509,0.6481113320079522
3597,2012-06-01,01T,793,396,1189,0.6669470142977292
3598,2012-06-01,01V,788,322,1110,0.7099099099099099
3599,2012-06-01,01W,1907,797,2704,0.7052514792899408
3600,2012-06-01,01X,1358,545,1903,0.7136100893326327
3601,2012-06-01,01Y,1339,641,1980,0.6762626262626262
3602,2012-06-01,02A,1216,761,1977,0.6150733434496712
3603,2012-06-01,02D,532,366,898,0.5924276169265034
3604,2012-06-01,02E,1130,495,1625,0.6953846153846154
3605,2012-06-01,02F,1551,576,2127,0.7291960507757405
3606,2012-06-01,02G,572,343,915,0.6251366120218579
3607,2012-06-01,02H,1713,1317,3030,0.5653465346534653
3608,2012-06-01,02M,959,339,1298,0.7388289676425269
3609,2012-06-01,02N,940,532,1472,0.6385869565217391
3610,2012-06-01,02P,1325,1046,2371,0.5588359342049768
3611,2012-06-01,02Q,595,434,1029,0.5782312925170068
3612,2012-06-01,02R,2008,852,2860,0.7020979020979021
3613,2012-06-01,02T,1044,557,1601,0.6520924422236103
3614,2012-06-01,02V,1312,586,1898,0.6912539515279241
3615,2012-06-01,02W,565,204,769,0.7347204161248374
3616,2012-06-01,02X,1844,902,2746,0.6715222141296431
3617,2012-06-01,02Y,1943,754,2697,0.7204301075268817
3618,2012-06-01,03A,1177,593,1770,0.6649717514124294
3619,2012-06-01,03C,1898,872,2770,0.6851985559566787
3620,2012-06-01,03D,834,333,1167,0.7146529562982005
3621,2012-06-01,03E,949,528,1477,0.6425186188219364
3622,2012-06-01,03F,1383,561,1944,0.7114197530864198
3623,2012-06-01,03G,1613,683,2296,0.7025261324041812
3624,2012-06-01,03H,1175,436,1611,0.7293606455617628
3625,2012-06-01,03J,1066,410,1476,0.7222222222222222
3626,2012-06-01,03K,989,243,1232,0.8027597402597403
3627,2012-06-01,03L,1294,872,2166,0.5974145891043398
3628,2012-06-01,03M,726,374,1100,0.66
3629,2012-06-01,03N,3033,831,3864,0.7849378881987578
3630,2012-06-01,03Q,1736,882,2618,0.6631016042780749
3631,2012-06-01,03R,2316,973,3289,0.7041653998175738
3632,2012-06-01,03T,1807,610,2417,0.7476210177906496
3633,2012-06-01,03V,371,250,621,0.5974235104669887
3634,2012-06-01,03W,1971,1126,3097,0.6364223442040684
3635,2012-06-01,03X,492,180,672,0.7321428571428571
3636,2012-06-01,03Y,673,321,994,0.6770623742454729
3637,2012-06-01,04C,1765,878,2643,0.6678017404464623
3638,2012-06-01,04D,1210,544,1754,0.6898517673888256
3639,2012-06-01,04E,1047,439,1486,0.7045760430686406
3640,2012-06-01,04F,1331,842,2173,0.6125172572480442
3641,2012-06-01,04G,4118,2039,6157,0.6688322234854637
3642,2012-06-01,04H,672,302,974,0.6899383983572895
3643,2012-06-01,04J,1920,880,2800,0.6857142857142857
3644,2012-06-01,04K,1645,669,2314,0.7108902333621435
3645,2012-06-01,04L,799,290,1089,0.7337006427915519
3646,2012-06-01,04M,513,217,730,0.7027397260273973
3647,2012-06-01,04N,698,278,976,0.7151639344262295
3648,2012-06-01,04Q,827,310,1137,0.7273526824978013
3649,2012-06-01,04R,2620,1157,3777,0.6936722266348955
3650,2012-06-01,04V,2159,1044,3203,0.6740555729004059
3651,2012-06-01,04X,1313,1006,2319,0.5661923242777059
3652,2012-06-01,04Y,985,386,1371,0.7184536834427425
3653,2012-06-01,05A,2433,1321,3754,0.648108684070325
3654,2012-06-01,05C,1203,1551,2754,0.43681917211328974
3655,2012-06-01,05D,760,387,1147,0.6625980819529207
3656,2012-06-01,05F,1250,415,1665,0.7507507507507507
3657,2012-06-01,05G,1171,497,1668,0.7020383693045563
3658,2012-06-01,05H,1044,483,1527,0.6836935166994106
3659,2012-06-01,05J,1357,441,1798,0.7547274749721913
3660,2012-06-01,05L,2471,1008,3479,0.710261569416499
3661,2012-06-01,05N,2140,627,2767,0.7734007950849295
3662,2012-06-01,05P,1408,676,2084,0.6756238003838771
3663,2012-06-01,05Q,1283,477,1760,0.7289772727272728
3664,2012-06-01,05R,1735,956,2691,0.6447417316982534
3665,2012-06-01,05T,1927,787,2714,0.7100221075902726
3666,2012-06-01,05V,860,383,1243,0.6918744971842317
3667,2012-06-01,05W,1364,633,1997,0.6830245368052078
3668,2012-06-01,05X,1121,345,1466,0.7646657571623465
3669,2012-06-01,05Y,1626,808,2434,0.6680361544782252
3670,2012-06-01,06A,1522,547,2069,0.735621072982117
3671,2012-06-01,06D,770,336,1106,0.6962025316455697
3672,2012-06-01,06F,1683,2161,3844,0.43782518210197713
3673,2012-06-01,06H,5107,2651,7758,0.6582882186130447
3674,2012-06-01,06K,3003,1964,4967,0.6045902959532917
3675,2012-06-01,06L,2285,978,3263,0.7002758197977321
3676,2012-06-01,06M,1907,834,2741,0.6957314848595403
3677,2012-06-01,06N,3290,1854,5144,0.6395800933125972
3678,2012-06-01,06P,936,737,1673,0.5594739988045427
3679,2012-06-01,06Q,2253,1097,3350,0.6725373134328358
3680,2012-06-01,06T,2270,1099,3369,0.6737904422677352
3681,2012-06-01,06V,1368,502,1870,0.7315508021390374
3682,2012-06-01,06W,1544,477,2021,0.7639782285997031
3683,2012-06-01,06Y,1335,397,1732,0.7707852193995381
3684,2012-06-01,07G,917,284,1201,0.7635303913405496
3685,2012-06-01,07H,1616,844,2460,0.656910569105691
3686,2012-06-01,07J,765,403,1168,0.6549657534246576
3687,2012-06-01,07K,1481,653,2134,0.6940018744142455
3688,2012-06-01,07L,758,206,964,0.7863070539419087
3689,2012-06-01,07M,1242,665,1907,0.6512847404299947
3690,2012-06-01,07N,1235,619,1854,0.6661272923408845
3691,2012-06-01,07P,830,321,1151,0.7211120764552563
3692,2012-06-01,07Q,1610,824,2434,0.6614626129827444
3693,2012-06-01,07R,744,431,1175,0.6331914893617021
3694,2012-06-01,07T,622,317,939,0.6624068157614483
3695,2012-06-01,07V,1772,736,2508,0.7065390749601276
3696,2012-06-01,07W,1050,614,1664,0.6310096153846154
3697,2012-06-01,07X,1274,559,1833,0.6950354609929078
3698,2012-06-01,07Y,789,526,1315,0.6
3699,2012-06-01,08A,1174,582,1756,0.6685649202733486
3700,2012-06-01,08C,626,328,954,0.6561844863731656
3701,2012-06-01,08D,856,388,1244,0.6881028938906752
3702,2012-06-01,08E,862,413,1275,0.676078431372549
3703,2012-06-01,08F,1286,541,1827,0.7038861521620142
3704,2012-06-01,08G,512,1283,1795,0.2852367688022284
3705,2012-06-01,08H,777,439,1216,0.6389802631578947
3706,2012-06-01,08J,804,353,1157,0.6949006050129646
3707,2012-06-01,08K,1132,494,1626,0.6961869618696187
3708,2012-06-01,08L,823,724,1547,0.5319974143503555
3709,2012-06-01,08M,979,299,1278,0.7660406885758998
3710,2012-06-01,08N,1043,414,1457,0.7158544955387783
3711,2012-06-01,08P,908,398,1306,0.6952526799387443
3712,2012-06-01,08Q,976,328,1304,0.7484662576687117
3713,2012-06-01,08R,928,391,1319,0.7035633055344959
3714,2012-06-01,08T,964,472,1436,0.6713091922005571
3715,2012-06-01,08V,1071,350,1421,0.7536945812807881
3716,2012-06-01,08W,1056,376,1432,0.7374301675977654
3717,2012-06-01,08X,1153,505,1658,0.695416164053076
3718,2012-06-01,08Y,689,344,1033,0.6669893514036787
3719,2012-06-01,09A,504,336,840,0.6
3720,2012-06-01,09C,680,333,1013,0.6712734452122409
3721,2012-06-01,09D,1376,834,2210,0.6226244343891403
3722,2012-06-01,09E,1464,463,1927,0.7597301504929943
3723,2012-06-01,09F,1268,581,1849,0.6857760951865873
3724,2012-06-01,09G,3117,1819,4936,0.631482982171799
3725,2012-06-01,09H,665,295,960,0.6927083333333334
3726,2012-06-01,09J,1502,712,2214,0.6784101174345076
3727,2012-06-01,09L,871,477,1348,0.6461424332344213
3728,2012-06-01,09N,1065,659,1724,0.6177494199535963
3729,2012-06-01,09P,1144,767,1911,0.5986394557823129
3730,2012-06-01,09W,1483,572,2055,0.7216545012165451
3731,2012-06-01,09X,1076,722,1798,0.5984427141268076
3732,2012-06-01,09Y,1702,1089,2791,0.6098172697957721
3733,2012-06-01,10A,1109,580,1689,0.6566015393724097
3734,2012-06-01,10C,438,260,698,0.6275071633237822
3735,2012-06-01,10D,582,177,759,0.766798418972332
3736,2012-06-01,10E,759,313,1072,0.7080223880597015
3737,2012-06-01,10G,636,354,990,0.6424242424242425
3738,2012-06-01,10H,1735,1030,2765,0.6274864376130199
3739,2012-06-01,10J,999,984,1983,0.5037821482602118
3740,2012-06-01,10K,1089,648,1737,0.6269430051813472
3741,2012-06-01,10L,922,331,1253,0.7358339984038308
3742,2012-06-01,10M,536,383,919,0.5832426550598476
3743,2012-06-01,10N,473,355,828,0.571256038647343
3744,2012-06-01,10Q,2596,2498,5094,0.5096191597958383
3745,2012-06-01,10R,1267,512,1779,0.7121978639685217
3746,2012-06-01,10T,508,274,782,0.649616368286445
3747,2012-06-01,10V,1156,756,1912,0.604602510460251
3748,2012-06-01,10W,581,299,880,0.6602272727272728
3749,2012-06-01,10X,1208,644,1852,0.652267818574514
3750,2012-06-01,10Y,1233,734,1967,0.6268429079816981
3751,2012-06-01,11A,3129,1766,4895,0.6392236976506639
3752,2012-06-01,11C,834,365,1199,0.69557964970809
3753,2012-06-01,11D,680,514,1194,0.5695142378559463
3754,2012-06-01,11E,1072,777,1849,0.5797728501892915
3755,2012-06-01,11H,2341,1368,3709,0.6311674305742788
3756,2012-06-01,11J,4686,2526,7212,0.6497504159733777
3757,2012-06-01,11M,3616,1766,5382,0.6718691936083241
3758,2012-06-01,11N,4194,1337,5531,0.7582715602965105
3759,2012-06-01,11T,1446,819,2265,0.6384105960264901
3760,2012-06-01,11X,3280,1829,5109,0.6420043061264435
3761,2012-06-01,12A,1419,745,2164,0.6557301293900185
3762,2012-06-01,12D,1037,600,1637,0.6334758704948076
3763,2012-06-01,12F,2402,566,2968,0.8092991913746631
3764,2012-06-01,13P,3072,1439,4511,0.6810019951230326
3765,2012-06-01,13T,2975,1167,4142,0.7182520521487205
3766,2012-06-01,14L,2831,1602,4433,0.638619445071058
3767,2012-06-01,99A,2664,787,3451,0.7719501593740945
3768,2012-06-01,99C,1438,648,2086,0.6893576222435283
3769,2012-06-01,99D,1024,594,1618,0.6328800988875154
3770,2012-06-01,99E,1475,533,2008,0.7345617529880478
3771,2012-06-01,99F,1138,344,1482,0.7678812415654521
3772,2012-06-01,99G,988,256,1244,0.7942122186495176
3773,2012-06-01,99H,1518,884,2402,0.6319733555370525
3774,2012-06-01,99J,3078,1226,4304,0.7151486988847584
3775,2012-06-01,99K,1026,623,1649,0.6221952698605215
3776,2012-06-01,99M,1039,836,1875,0.5541333333333334
3777,2012-06-01,99N,2628,2133,4761,0.5519848771266541
3778,2012-06-01,99P,6225,2187,8412,0.7400142653352354
3779,2012-06-01,99Q,1988,821,2809,0.7077251690993236
3780,2012-07-01,00C,755,330,1085,0.695852534562212
3781,2012-07-01,00D,2251,1151,3402,0.6616696061140506
3782,2012-07-01,00F,20,2,22,0.9090909090909091
3783,2012-07-01,00J,1702,828,2530,0.6727272727272727
3784,2012-07-01,00K,2271,1122,3393,0.6693191865605659
3785,2012-07-01,00L,2353,1521,3874,0.6073825503355704
3786,2012-07-01,00M,2171,1071,3242,0.6696483652066626
3787,2012-07-01,00N,1270,633,1903,0.6673673147661587
3788,2012-07-01,00P,1985,697,2682,0.7401193139448173
3789,2012-07-01,00Q,986,369,1355,0.7276752767527676
3790,2012-07-01,00R,1234,485,1719,0.7178592204770216
3791,2012-07-01,00T,2051,1037,3088,0.6641839378238342
3792,2012-07-01,00V,1391,708,2099,0.6626965221534064
3793,2012-07-01,00W,71,30,101,0.7029702970297029
3794,2012-07-01,00X,1026,284,1310,0.783206106870229
3795,2012-07-01,00Y,1876,874,2750,0.6821818181818182
3796,2012-07-01,01A,2493,1150,3643,0.684326104858633
3797,2012-07-01,01C,1290,707,1997,0.6459689534301453
3798,2012-07-01,01D,1539,683,2222,0.6926192619261926
3799,2012-07-01,01E,1167,215,1382,0.8444283646888567
3800,2012-07-01,01F,929,454,1383,0.6717281272595806
3801,2012-07-01,01G,1357,1115,2472,0.5489482200647249
3802,2012-07-01,01H,2596,788,3384,0.7671394799054374
3803,2012-07-01,01J,1001,431,1432,0.6990223463687151
3804,2012-07-01,01K,2293,1086,3379,0.6786031370227879
3805,2012-07-01,01N,26,6,32,0.8125
3806,2012-07-01,01R,1086,569,1655,0.6561933534743203
3807,2012-07-01,01T,850,430,1280,0.6640625
3808,2012-07-01,01V,848,347,1195,0.7096234309623431
3809,2012-07-01,01W,2055,840,2895,0.7098445595854922
3810,2012-07-01,01X,1477,667,2144,0.6888992537313433
3811,2012-07-01,01Y,1370,743,2113,0.6483672503549456
3812,2012-07-01,02A,1351,839,2190,0.6168949771689498
3813,2012-07-01,02D,557,416,973,0.5724563206577595
3814,2012-07-01,02E,1299,558,1857,0.6995153473344103
3815,2012-07-01,02F,1675,555,2230,0.7511210762331838
3816,2012-07-01,02G,614,394,1008,0.6091269841269841
3817,2012-07-01,02H,1807,1351,3158,0.5721975934135529
3818,2012-07-01,02M,1054,396,1450,0.7268965517241379
3819,2012-07-01,02N,1030,594,1624,0.6342364532019704
3820,2012-07-01,02P,1402,1159,2561,0.5474424053104257
3821,2012-07-01,02Q,659,448,1107,0.5953026196928636
3822,2012-07-01,02R,2160,983,3143,0.6872414890232262
3823,2012-07-01,02T,1138,653,1791,0.6353992183137912
3824,2012-07-01,02V,1515,666,2181,0.6946354883081155
3825,2012-07-01,02W,620,244,864,0.7175925925925926
3826,2012-07-01,02X,1972,1000,2972,0.6635262449528937
3827,2012-07-01,02Y,2054,823,2877,0.7139381299965242
3828,2012-07-01,03A,1113,606,1719,0.6474694589877836
3829,2012-07-01,03C,1988,840,2828,0.7029702970297029
3830,2012-07-01,03D,918,342,1260,0.7285714285714285
3831,2012-07-01,03E,934,564,1498,0.6234979973297731
3832,2012-07-01,03F,1580,603,2183,0.7237746220797068
3833,2012-07-01,03G,1698,715,2413,0.7036883547451306
3834,2012-07-01,03H,1245,420,1665,0.7477477477477478
3835,2012-07-01,03J,1172,463,1635,0.7168195718654434
3836,2012-07-01,03K,1019,241,1260,0.8087301587301587
3837,2012-07-01,03L,1417,881,2298,0.6166231505657093
3838,2012-07-01,03M,820,400,1220,0.6721311475409836
3839,2012-07-01,03N,3230,834,4064,0.7947834645669292
3840,2012-07-01,03Q,1960,949,2909,0.6737710553454795
3841,2012-07-01,03R,2372,1029,3401,0.6974419288444575
3842,2012-07-01,03T,1868,565,2433,0.7677764077270859
3843,2012-07-01,03V,405,283,688,0.5886627906976745
3844,2012-07-01,03W,2213,1134,3347,0.6611891245891843
3845,2012-07-01,03X,523,174,697,0.7503586800573888
3846,2012-07-01,03Y,737,328,1065,0.692018779342723
3847,2012-07-01,04C,1808,938,2746,0.6584122359796067
3848,2012-07-01,04D,1400,554,1954,0.7164790174002047
3849,2012-07-01,04E,1193,498,1691,0.7054997043169722
3850,2012-07-01,04F,1470,866,2336,0.6292808219178082
3851,2012-07-01,04G,4357,2266,6623,0.6578589762947304
3852,2012-07-01,04H,711,342,1053,0.6752136752136753
3853,2012-07-01,04J,2009,990,2999,0.6698899633211071
3854,2012-07-01,04K,1646,672,2318,0.7100949094046591
3855,2012-07-01,04L,921,324,1245,0.7397590361445783
3856,2012-07-01,04M,556,194,750,0.7413333333333333
3857,2012-07-01,04N,734,299,1033,0.7105517909002904
3858,2012-07-01,04Q,854,331,1185,0.7206751054852321
3859,2012-07-01,04R,2788,1349,4137,0.6739182982837805
3860,2012-07-01,04V,2218,1085,3303,0.6715107478050257
3861,2012-07-01,04X,1383,984,2367,0.5842839036755386
3862,2012-07-01,04Y,1109,390,1499,0.7398265510340227
3863,2012-07-01,05A,2561,1368,3929,0.6518198014762026
3864,2012-07-01,05C,1204,1718,2922,0.41204654346338127
3865,2012-07-01,05D,828,464,1292,0.6408668730650154
3866,2012-07-01,05F,1245,455,1700,0.7323529411764705
3867,2012-07-01,05G,1327,509,1836,0.7227668845315904
3868,2012-07-01,05H,1195,579,1774,0.673618940248027
3869,2012-07-01,05J,1447,507,1954,0.740532241555783
3870,2012-07-01,05L,2571,1097,3668,0.70092693565976
3871,2012-07-01,05N,2164,654,2818,0.7679205110007097
3872,2012-07-01,05P,1433,658,2091,0.6853180296508847
3873,2012-07-01,05Q,1456,569,2025,0.7190123456790124
3874,2012-07-01,05R,1822,1066,2888,0.6308864265927978
3875,2012-07-01,05T,2051,909,2960,0.6929054054054054
3876,2012-07-01,05V,982,371,1353,0.7257945306725795
3877,2012-07-01,05W,1548,741,2289,0.6762778505897772
3878,2012-07-01,05X,1183,348,1531,0.7726975832789027
3879,2012-07-01,05Y,1687,784,2471,0.6827195467422096
3880,2012-07-01,06A,1595,579,2174,0.733670653173873
3881,2012-07-01,06D,838,329,1167,0.7180805484147387
3882,2012-07-01,06F,1744,2409,4153,0.41993739465446667
3883,2012-07-01,06H,5353,2652,8005,0.6687070580886946
3884,2012-07-01,06K,3145,2017,5162,0.6092599767531964
3885,2012-07-01,06L,2351,1021,3372,0.6972123368920522
3886,2012-07-01,06M,1998,827,2825,0.7072566371681416
3887,2012-07-01,06N,3535,2038,5573,0.6343082720258388
3888,2012-07-01,06P,981,819,1800,0.545
3889,2012-07-01,06Q,2270,1205,3475,0.6532374100719425
3890,2012-07-01,06T,2357,1204,3561,0.6618927267621455
3891,2012-07-01,06V,1462,524,1986,0.7361530715005036
3892,2012-07-01,06W,1602,462,2064,0.7761627906976745
3893,2012-07-01,06Y,1294,399,1693,0.7643236857649144
3894,2012-07-01,07G,991,299,1290,0.7682170542635659
3895,2012-07-01,07H,1777,947,2724,0.6523494860499266
3896,2012-07-01,07J,733,410,1143,0.6412948381452318
3897,2012-07-01,07K,1531,738,2269,0.6747465843984134
3898,2012-07-01,07L,839,233,1072,0.7826492537313433
3899,2012-07-01,07M,1279,750,2029,0.6303597831444061
3900,2012-07-01,07N,1278,638,1916,0.6670146137787056
3901,2012-07-01,07P,847,388,1235,0.68582995951417
3902,2012-07-01,07Q,1712,841,2553,0.6705836271053662
3903,2012-07-01,07R,807,526,1333,0.6054013503375844
3904,2012-07-01,07T,688,398,1086,0.6335174953959485
3905,2012-07-01,07V,1882,818,2700,0.697037037037037
3906,2012-07-01,07W,1104,689,1793,0.6157278304517568
3907,2012-07-01,07X,1288,596,1884,0.6836518046709129
3908,2012-07-01,07Y,844,506,1350,0.6251851851851852
3909,2012-07-01,08A,1194,622,1816,0.6574889867841409
3910,2012-07-01,08C,677,330,1007,0.6722939424031777
3911,2012-07-01,08D,906,464,1370,0.6613138686131387
3912,2012-07-01,08E,923,386,1309,0.7051184110007639
3913,2012-07-01,08F,1324,532,1856,0.7133620689655172
3914,2012-07-01,08G,523,1258,1781,0.29365524985962943
3915,2012-07-01,08H,852,535,1387,0.6142754145638067
3916,2012-07-01,08J,870,367,1237,0.7033144704931286
3917,2012-07-01,08K,1184,577,1761,0.6723452583759227
3918,2012-07-01,08L,817,868,1685,0.48486646884273
3919,2012-07-01,08M,1042,315,1357,0.7678703021370671
3920,2012-07-01,08N,1136,402,1538,0.7386215864759428
3921,2012-07-01,08P,1011,413,1424,0.7099719101123596
3922,2012-07-01,08Q,1035,415,1450,0.7137931034482758
3923,2012-07-01,08R,850,377,1227,0.6927465362673186
3924,2012-07-01,08T,1038,520,1558,0.6662387676508345
3925,2012-07-01,08V,1127,376,1503,0.7498336660013307
3926,2012-07-01,08W,1073,396,1469,0.730428863172226
3927,2012-07-01,08X,1296,539,1835,0.706267029972752
3928,2012-07-01,08Y,699,411,1110,0.6297297297297297
3929,2012-07-01,09A,536,368,904,0.5929203539823009
3930,2012-07-01,09C,738,363,1101,0.670299727520436
3931,2012-07-01,09D,1457,988,2445,0.5959100204498977
3932,2012-07-01,09E,1510,550,2060,0.7330097087378641
3933,2012-07-01,09F,1424,589,2013,0.7074018877297565
3934,2012-07-01,09G,3390,2088,5478,0.6188389923329682
3935,2012-07-01,09H,665,332,997,0.6670010030090271
3936,2012-07-01,09J,1586,754,2340,0.6777777777777778
3937,2012-07-01,09L,925,456,1381,0.6698044895003621
3938,2012-07-01,09N,1083,690,1773,0.61082910321489
3939,2012-07-01,09P,1196,833,2029,0.5894529324790537
3940,2012-07-01,09W,1541,580,2121,0.7265440829797265
3941,2012-07-01,09X,1151,781,1932,0.5957556935817805
3942,2012-07-01,09Y,1605,1137,2742,0.5853391684901532
3943,2012-07-01,10A,1176,618,1794,0.6555183946488294
3944,2012-07-01,10C,463,247,710,0.652112676056338
3945,2012-07-01,10D,630,184,814,0.773955773955774
3946,2012-07-01,10E,762,312,1074,0.7094972067039106
3947,2012-07-01,10G,704,385,1089,0.6464646464646465
3948,2012-07-01,10H,1860,1075,2935,0.6337308347529813
3949,2012-07-01,10J,1039,958,1997,0.5202804206309464
3950,2012-07-01,10K,1311,691,2002,0.6548451548451548
3951,2012-07-01,10L,962,388,1350,0.7125925925925926
3952,2012-07-01,10M,589,339,928,0.634698275862069
3953,2012-07-01,10N,449,371,820,0.5475609756097561
3954,2012-07-01,10Q,2803,2726,5529,0.5069632844999096
3955,2012-07-01,10R,1390,540,1930,0.7202072538860104
3956,2012-07-01,10T,610,309,919,0.6637649619151251
3957,2012-07-01,10V,1119,805,1924,0.5816008316008316
3958,2012-07-01,10W,590,320,910,0.6483516483516484
3959,2012-07-01,10X,1273,670,1943,0.6551724137931034
3960,2012-07-01,10Y,1278,753,2031,0.6292466765140325
3961,2012-07-01,11A,3398,1922,5320,0.6387218045112782
3962,2012-07-01,11C,839,372,1211,0.6928158546655656
3963,2012-07-01,11D,707,504,1211,0.5838150289017341
3964,2012-07-01,11E,1270,869,2139,0.5937353903693314
3965,2012-07-01,11H,2486,1498,3984,0.623995983935743
3966,2012-07-01,11J,5232,2691,7923,0.6603559257856872
3967,2012-07-01,11M,3775,1851,5626,0.670991823675791
3968,2012-07-01,11N,4360,1436,5796,0.7522429261559697
3969,2012-07-01,11T,1558,863,2421,0.6435357290375878
3970,2012-07-01,11X,3519,1999,5518,0.6377310619789779
3971,2012-07-01,12A,1436,823,2259,0.6356795042054006
3972,2012-07-01,12D,1210,614,1824,0.6633771929824561
3973,2012-07-01,12F,2655,575,3230,0.8219814241486069
3974,2012-07-01,13P,3200,1635,4835,0.6618407445708376
3975,2012-07-01,13T,3288,1282,4570,0.7194748358862144
3976,2012-07-01,14L,2987,1742,4729,0.631634595051808
3977,2012-07-01,99A,2826,818,3644,0.7755214050493963
3978,2012-07-01,99C,1550,727,2277,0.6807202459376372
3979,2012-07-01,99D,1115,627,1742,0.6400688863375431
3980,2012-07-01,99E,1541,519,2060,0.7480582524271845
3981,2012-07-01,99F,1162,296,1458,0.7969821673525377
3982,2012-07-01,99G,1084,319,1403,0.7726300784034212
3983,2012-07-01,99H,1650,881,2531,0.6519162386408535
3984,2012-07-01,99J,3124,1316,4440,0.7036036036036036
3985,2012-07-01,99K,1024,606,1630,0.6282208588957056
3986,2012-07-01,99M,1070,883,1953,0.5478750640040962
3987,2012-07-01,99N,2952,2443,5395,0.5471733086190917
3988,2012-07-01,99P,6555,2301,8856,0.7401761517615176
3989,2012-07-01,99Q,2071,857,2928,0.707308743169399
3990,2012-08-01,00C,771,296,1067,0.7225866916588566
3991,2012-08-01,00D,2319,1183,3502,0.6621930325528269
3992,2012-08-01,00F,26,4,30,0.8666666666666667
3993,2012-08-01,00J,1721,935,2656,0.6479668674698795
3994,2012-08-01,00K,2199,1180,3379,0.6507842556969518
3995,2012-08-01,00L,2501,1541,4042,0.6187530925284512
3996,2012-08-01,00M,2213,1064,3277,0.6753127860848337
3997,2012-08-01,00N,1286,605,1891,0.6800634584875727
3998,2012-08-01,00P,2083,731,2814,0.740227434257285
3999,2012-08-01,00Q,935,391,1326,0.7051282051282052
4000,2012-08-01,00R,1361,511,1872,0.7270299145299145
4001,2012-08-01,00T,2041,1071,3112,0.6558483290488432
4002,2012-08-01,00V,1422,680,2102,0.6764985727878211
4003,2012-08-01,00W,79,32,111,0.7117117117117117
4004,2012-08-01,00X,1118,257,1375,0.8130909090909091
4005,2012-08-01,00Y,1871,857,2728,0.6858504398826979
4006,2012-08-01,01A,2692,1261,3953,0.681001770806982
4007,2012-08-01,01C,1400,817,2217,0.6314839873703203
4008,2012-08-01,01D,1634,725,2359,0.6926663840610429
4009,2012-08-01,01E,1197,231,1428,0.8382352941176471
4010,2012-08-01,01F,985,500,1485,0.6632996632996633
4011,2012-08-01,01G,1391,1126,2517,0.5526420341676599
4012,2012-08-01,01H,2733,936,3669,0.7448896156991006
4013,2012-08-01,01J,1027,437,1464,0.7015027322404371
4014,2012-08-01,01K,2346,1180,3526,0.6653431650595576
4015,2012-08-01,01N,27,14,41,0.6585365853658537
4016,2012-08-01,01R,1115,614,1729,0.6448814343551186
4017,2012-08-01,01T,809,468,1277,0.6335160532498042
4018,2012-08-01,01V,878,377,1255,0.699601593625498
4019,2012-08-01,01W,2077,908,2985,0.6958123953098827
4020,2012-08-01,01X,1481,666,2147,0.6897997205402888
4021,2012-08-01,01Y,1487,745,2232,0.6662186379928315
4022,2012-08-01,02A,1374,871,2245,0.6120267260579064
4023,2012-08-01,02D,603,424,1027,0.5871470301850049
4024,2012-08-01,02E,1289,544,1833,0.7032187670485542
4025,2012-08-01,02F,1704,661,2365,0.720507399577167
4026,2012-08-01,02G,693,368,1061,0.65315739868049
4027,2012-08-01,02H,1784,1417,3201,0.5573258356763512
4028,2012-08-01,02M,1037,422,1459,0.7107607950651131
4029,2012-08-01,02N,1121,630,1751,0.6402055968018275
4030,2012-08-01,02P,1421,1264,2685,0.5292364990689014
4031,2012-08-01,02Q,611,456,1067,0.5726335520149953
4032,2012-08-01,02R,2271,1033,3304,0.6873486682808717
4033,2012-08-01,02T,1173,689,1862,0.6299677765843179
4034,2012-08-01,02V,1514,668,2182,0.693858845096242
4035,2012-08-01,02W,547,233,780,0.7012820512820512
4036,2012-08-01,02X,2012,1121,3133,0.6421959782955634
4037,2012-08-01,02Y,2154,883,3037,0.7092525518603885
4038,2012-08-01,03A,1208,627,1835,0.6583106267029972
4039,2012-08-01,03C,2074,939,3013,0.6883504812479256
4040,2012-08-01,03D,948,398,1346,0.7043090638930164
4041,2012-08-01,03E,1018,528,1546,0.6584734799482536
4042,2012-08-01,03F,1611,750,2361,0.6823379923761118
4043,2012-08-01,03G,1778,787,2565,0.69317738791423
4044,2012-08-01,03H,1310,483,1793,0.7306190741773564
4045,2012-08-01,03J,1212,448,1660,0.7301204819277108
4046,2012-08-01,03K,1078,289,1367,0.7885881492318947
4047,2012-08-01,03L,1382,983,2365,0.584355179704017
4048,2012-08-01,03M,925,455,1380,0.6702898550724637
4049,2012-08-01,03N,3440,856,4296,0.8007448789571695
4050,2012-08-01,03Q,2032,1044,3076,0.6605981794538361
4051,2012-08-01,03R,2568,1047,3615,0.7103734439834025
4052,2012-08-01,03T,2064,656,2720,0.7588235294117647
4053,2012-08-01,03V,361,264,625,0.5776
4054,2012-08-01,03W,2315,1262,3577,0.6471903830025161
4055,2012-08-01,03X,533,193,726,0.7341597796143251
4056,2012-08-01,03Y,722,397,1119,0.645218945487042
4057,2012-08-01,04C,1959,954,2913,0.6725025746652935
4058,2012-08-01,04D,1408,631,2039,0.6905345757724375
4059,2012-08-01,04E,1228,573,1801,0.6818434203220433
4060,2012-08-01,04F,1547,964,2511,0.616089207487057
4061,2012-08-01,04G,4482,2167,6649,0.6740863287712437
4062,2012-08-01,04H,768,341,1109,0.6925157799819658
4063,2012-08-01,04J,2170,1108,3278,0.6619890176937157
4064,2012-08-01,04K,1675,735,2410,0.6950207468879668
4065,2012-08-01,04L,958,359,1317,0.7274107820804859
4066,2012-08-01,04M,623,257,880,0.7079545454545455
4067,2012-08-01,04N,728,308,1036,0.7027027027027027
4068,2012-08-01,04Q,899,337,1236,0.7273462783171522
4069,2012-08-01,04R,2922,1287,4209,0.6942266571632216
4070,2012-08-01,04V,2341,1161,3502,0.6684751570531126
4071,2012-08-01,04X,1324,1042,2366,0.5595942519019442
4072,2012-08-01,04Y,1187,410,1597,0.7432686286787727
4073,2012-08-01,05A,2686,1432,4118,0.6522583778533269
4074,2012-08-01,05C,1234,1784,3018,0.4088800530152419
4075,2012-08-01,05D,848,431,1279,0.6630179827990618
4076,2012-08-01,05F,1364,537,1901,0.7175170962651236
4077,2012-08-01,05G,1443,586,2029,0.7111877772301627
4078,2012-08-01,05H,1255,586,1841,0.6816947311243889
4079,2012-08-01,05J,1576,558,2134,0.7385192127460168
4080,2012-08-01,05L,2658,1157,3815,0.6967234600262123
4081,2012-08-01,05N,2384,740,3124,0.7631241997439181
4082,2012-08-01,05P,1484,693,2177,0.6816720257234726
4083,2012-08-01,05Q,1497,538,2035,0.7356265356265356
4084,2012-08-01,05R,2017,1118,3135,0.6433811802232855
4085,2012-08-01,05T,2248,999,3247,0.692331382814906
4086,2012-08-01,05V,1080,422,1502,0.7190412782956058
4087,2012-08-01,05W,1508,748,2256,0.6684397163120568
4088,2012-08-01,05X,1257,360,1617,0.7773654916512059
4089,2012-08-01,05Y,1695,900,2595,0.653179190751445
4090,2012-08-01,06A,1715,621,2336,0.7341609589041096
4091,2012-08-01,06D,896,409,1305,0.6865900383141762
4092,2012-08-01,06F,1818,2495,4313,0.4215163459309066
4093,2012-08-01,06H,5491,2939,8430,0.6513641755634638
4094,2012-08-01,06K,3203,2112,5315,0.6026340545625588
4095,2012-08-01,06L,2442,1107,3549,0.6880811496196112
4096,2012-08-01,06M,2176,981,3157,0.6892619575546405
4097,2012-08-01,06N,3539,2142,5681,0.6229537053335681
4098,2012-08-01,06P,983,729,1712,0.5741822429906542
4099,2012-08-01,06Q,2543,1254,3797,0.669739267843034
4100,2012-08-01,06T,2446,1134,3580,0.6832402234636872
4101,2012-08-01,06V,1468,576,2044,0.7181996086105675
4102,2012-08-01,06W,1659,501,2160,0.7680555555555556
4103,2012-08-01,06Y,1509,450,1959,0.7702909647779479
4104,2012-08-01,07G,936,337,1273,0.7352710133542812
4105,2012-08-01,07H,1778,1031,2809,0.6329654681381275
4106,2012-08-01,07J,759,465,1224,0.6200980392156863
4107,2012-08-01,07K,1632,795,2427,0.6724351050679852
4108,2012-08-01,07L,819,261,1080,0.7583333333333333
4109,2012-08-01,07M,1310,765,2075,0.6313253012048192
4110,2012-08-01,07N,1397,675,2072,0.6742277992277992
4111,2012-08-01,07P,800,392,1192,0.6711409395973155
4112,2012-08-01,07Q,1745,815,2560,0.681640625
4113,2012-08-01,07R,800,475,1275,0.6274509803921569
4114,2012-08-01,07T,673,377,1050,0.6409523809523809
4115,2012-08-01,07V,1831,855,2686,0.6816827997021594
4116,2012-08-01,07W,1160,660,1820,0.6373626373626373
4117,2012-08-01,07X,1332,657,1989,0.669683257918552
4118,2012-08-01,07Y,886,606,1492,0.5938337801608579
4119,2012-08-01,08A,1181,663,1844,0.6404555314533622
4120,2012-08-01,08C,641,375,1016,0.6309055118110236
4121,2012-08-01,08D,940,519,1459,0.6442769019876627
4122,2012-08-01,08E,936,481,1417,0.6605504587155964
4123,2012-08-01,08F,1377,561,1938,0.7105263157894737
4124,2012-08-01,08G,532,1382,1914,0.2779519331243469
4125,2012-08-01,08H,793,539,1332,0.5953453453453453
4126,2012-08-01,08J,874,452,1326,0.6591251885369532
4127,2012-08-01,08K,1172,535,1707,0.6865846514352666
4128,2012-08-01,08L,877,987,1864,0.47049356223175964
4129,2012-08-01,08M,952,309,1261,0.7549563838223632
4130,2012-08-01,08N,1149,399,1548,0.7422480620155039
4131,2012-08-01,08P,927,495,1422,0.6518987341772152
4132,2012-08-01,08Q,1064,391,1455,0.7312714776632302
4133,2012-08-01,08R,958,447,1405,0.6818505338078292
4134,2012-08-01,08T,1050,533,1583,0.6632975363234365
4135,2012-08-01,08V,1098,359,1457,0.7536032944406315
4136,2012-08-01,08W,1082,467,1549,0.6985151710781149
4137,2012-08-01,08X,1283,606,1889,0.6791953414505029
4138,2012-08-01,08Y,696,440,1136,0.6126760563380281
4139,2012-08-01,09A,527,340,867,0.6078431372549019
4140,2012-08-01,09C,782,385,1167,0.6700942587832048
4141,2012-08-01,09D,1485,1012,2497,0.5947136563876652
4142,2012-08-01,09E,1568,517,2085,0.7520383693045564
4143,2012-08-01,09F,1526,639,2165,0.704849884526559
4144,2012-08-01,09G,3549,2251,5800,0.6118965517241379
4145,2012-08-01,09H,688,335,1023,0.6725317693059628
4146,2012-08-01,09J,1637,801,2438,0.6714520098441346
4147,2012-08-01,09L,913,528,1441,0.6335877862595419
4148,2012-08-01,09N,1197,712,1909,0.6270298585646935
4149,2012-08-01,09P,1208,845,2053,0.5884072089624939
4150,2012-08-01,09W,1636,637,2273,0.7197536295644522
4151,2012-08-01,09X,1224,884,2108,0.5806451612903226
4152,2012-08-01,09Y,1842,1242,3084,0.5972762645914397
4153,2012-08-01,10A,1189,698,1887,0.6301006889242183
4154,2012-08-01,10C,524,297,821,0.6382460414129111
4155,2012-08-01,10D,711,233,944,0.753177966101695
4156,2012-08-01,10E,818,351,1169,0.699743370402053
4157,2012-08-01,10G,652,408,1060,0.6150943396226415
4158,2012-08-01,10H,1985,1150,3135,0.6331738437001595
4159,2012-08-01,10J,1071,966,2037,0.5257731958762887
4160,2012-08-01,10K,1306,734,2040,0.6401960784313725
4161,2012-08-01,10L,1092,390,1482,0.7368421052631579
4162,2012-08-01,10M,603,428,1031,0.5848690591658584
4163,2012-08-01,10N,492,355,847,0.5808736717827627
4164,2012-08-01,10Q,2867,2871,5738,0.4996514464970373
4165,2012-08-01,10R,1468,538,2006,0.7318045862412762
4166,2012-08-01,10T,641,257,898,0.7138084632516704
4167,2012-08-01,10V,1210,844,2054,0.5890944498539435
4168,2012-08-01,10W,684,330,1014,0.6745562130177515
4169,2012-08-01,10X,1324,706,2030,0.6522167487684729
4170,2012-08-01,10Y,1387,813,2200,0.6304545454545455
4171,2012-08-01,11A,3743,2087,5830,0.6420240137221269
4172,2012-08-01,11C,884,471,1355,0.6523985239852399
4173,2012-08-01,11D,740,536,1276,0.5799373040752351
4174,2012-08-01,11E,1281,882,2163,0.5922330097087378
4175,2012-08-01,11H,2710,1526,4236,0.6397544853635505
4176,2012-08-01,11J,5384,2834,8218,0.6551472377707471
4177,2012-08-01,11M,4005,1982,5987,0.6689493903457491
4178,2012-08-01,11N,4895,1615,6510,0.7519201228878648
4179,2012-08-01,11T,1685,1021,2706,0.622690317812269
4180,2012-08-01,11X,3630,2137,5767,0.6294433847754465
4181,2012-08-01,12A,1718,871,2589,0.6635766705291618
4182,2012-08-01,12D,1253,674,1927,0.6502335236118318
4183,2012-08-01,12F,2647,607,3254,0.813460356484327
4184,2012-08-01,13P,3396,1593,4989,0.6806975345760673
4185,2012-08-01,13T,3395,1353,4748,0.7150379106992418
4186,2012-08-01,14L,2907,1794,4701,0.618379068283344
4187,2012-08-01,99A,2901,908,3809,0.7616172223680756
4188,2012-08-01,99C,1642,777,2419,0.6787928896238115
4189,2012-08-01,99D,1139,668,1807,0.6303265080243498
4190,2012-08-01,99E,1756,598,2354,0.745964316057774
4191,2012-08-01,99F,1171,315,1486,0.7880215343203231
4192,2012-08-01,99G,1062,320,1382,0.768451519536903
4193,2012-08-01,99H,1609,963,2572,0.6255832037325039
4194,2012-08-01,99J,3310,1463,4773,0.6934841818562749
4195,2012-08-01,99K,1087,675,1762,0.6169125993189557
4196,2012-08-01,99M,1226,910,2136,0.5739700374531835
4197,2012-08-01,99N,3121,2651,5772,0.5407137907137907
4198,2012-08-01,99P,7000,2565,9565,0.7318348144276007
4199,2012-08-01,99Q,2203,887,3090,0.7129449838187703
4200,2012-09-01,00C,776,328,1104,0.7028985507246377
4201,2012-09-01,00D,2171,1099,3270,0.6639143730886851
4202,2012-09-01,00F,23,10,33,0.696969696969697
4203,2012-09-01,00J,1651,826,2477,0.6665320952765442
4204,2012-09-01,00K,2105,1090,3195,0.6588419405320813
4205,2012-09-01,00L,2291,1416,3707,0.6180199622336121
4206,2012-09-01,00M,2086,1033,3119,0.6688041038794486
4207,2012-09-01,00N,1184,559,1743,0.6792885829030407
4208,2012-09-01,00P,1988,778,2766,0.7187274041937817
4209,2012-09-01,00Q,945,332,1277,0.7400156617071261
4210,2012-09-01,00R,1323,481,1804,0.733370288248337
4211,2012-09-01,00T,1902,1021,2923,0.650701334245638
4212,2012-09-01,00V,1400,623,2023,0.6920415224913494
4213,2012-09-01,00W,55,31,86,0.6395348837209303
4214,2012-09-01,00X,999,278,1277,0.7823022709475332
4215,2012-09-01,00Y,1748,866,2614,0.6687069625095639
4216,2012-09-01,01A,2576,1164,3740,0.6887700534759358
4217,2012-09-01,01C,1333,692,2025,0.6582716049382716
4218,2012-09-01,01D,1483,687,2170,0.6834101382488479
4219,2012-09-01,01E,1140,218,1358,0.8394698085419735
4220,2012-09-01,01F,932,417,1349,0.6908821349147517
4221,2012-09-01,01G,1382,1138,2520,0.5484126984126985
4222,2012-09-01,01H,2522,792,3314,0.7610138805069403
4223,2012-09-01,01J,1074,465,1539,0.6978557504873294
4224,2012-09-01,01K,2145,1106,3251,0.6597969855429099
4225,2012-09-01,01N,16,15,31,0.5161290322580645
4226,2012-09-01,01R,973,539,1512,0.6435185185185185
4227,2012-09-01,01T,803,464,1267,0.6337805840568271
4228,2012-09-01,01V,779,363,1142,0.6821366024518388
4229,2012-09-01,01W,1903,863,2766,0.687997107736804
4230,2012-09-01,01X,1459,667,2126,0.6862652869238005
4231,2012-09-01,01Y,1329,704,2033,0.6537137235612396
4232,2012-09-01,02A,1280,800,2080,0.6153846153846154
4233,2012-09-01,02D,563,377,940,0.5989361702127659
4234,2012-09-01,02E,1261,524,1785,0.7064425770308124
4235,2012-09-01,02F,1601,593,2194,0.7297174111212398
4236,2012-09-01,02G,654,343,997,0.6559679037111334
4237,2012-09-01,02H,1738,1233,2971,0.584988219454729
4238,2012-09-01,02M,973,371,1344,0.7239583333333334
4239,2012-09-01,02N,961,632,1593,0.6032642812303829
4240,2012-09-01,02P,1333,1235,2568,0.5190809968847352
4241,2012-09-01,02Q,607,436,1043,0.5819750719079578
4242,2012-09-01,02R,2165,968,3133,0.6910309607405043
4243,2012-09-01,02T,1105,641,1746,0.6328751431844215
4244,2012-09-01,02V,1379,658,2037,0.6769759450171822
4245,2012-09-01,02W,540,275,815,0.6625766871165644
4246,2012-09-01,02X,1915,972,2887,0.6633183235192242
4247,2012-09-01,02Y,1938,840,2778,0.6976241900647948
4248,2012-09-01,03A,1180,573,1753,0.6731317741015402
4249,2012-09-01,03C,1898,925,2823,0.6723343960325895
4250,2012-09-01,03D,839,360,1199,0.6997497914929107
4251,2012-09-01,03E,933,534,1467,0.6359918200408998
4252,2012-09-01,03F,1501,635,2136,0.7027153558052435
4253,2012-09-01,03G,1708,734,2442,0.6994266994266994
4254,2012-09-01,03H,1114,455,1569,0.710006373486297
4255,2012-09-01,03J,1115,417,1532,0.7278067885117493
4256,2012-09-01,03K,1023,267,1290,0.7930232558139535
4257,2012-09-01,03L,1315,976,2291,0.5739851593190747
4258,2012-09-01,03M,898,419,1317,0.6818526955201215
4259,2012-09-01,03N,3107,784,3891,0.7985093806219481
4260,2012-09-01,03Q,1943,974,2917,0.6660953033938979
4261,2012-09-01,03R,2277,1027,3304,0.6891646489104116
4262,2012-09-01,03T,1844,594,2438,0.756357670221493
4263,2012-09-01,03V,401,268,669,0.5994020926756353
4264,2012-09-01,03W,2159,1091,3250,0.6643076923076923
4265,2012-09-01,03X,462,269,731,0.6320109439124487
4266,2012-09-01,03Y,729,337,1066,0.6838649155722326
4267,2012-09-01,04C,1956,872,2828,0.6916548797736917
4268,2012-09-01,04D,1337,603,1940,0.6891752577319588
4269,2012-09-01,04E,1137,499,1636,0.6949877750611247
4270,2012-09-01,04F,1453,919,2372,0.6125632377740303
4271,2012-09-01,04G,4115,2156,6271,0.6561951841811513
4272,2012-09-01,04H,717,308,1025,0.6995121951219512
4273,2012-09-01,04J,1918,1014,2932,0.6541609822646658
4274,2012-09-01,04K,1588,662,2250,0.7057777777777777
4275,2012-09-01,04L,856,361,1217,0.7033689400164339
4276,2012-09-01,04M,563,255,818,0.6882640586797066
4277,2012-09-01,04N,735,278,1013,0.7255676209279368
4278,2012-09-01,04Q,889,300,1189,0.7476871320437343
4279,2012-09-01,04R,2625,1275,3900,0.6730769230769231
4280,2012-09-01,04V,2155,1135,3290,0.6550151975683891
4281,2012-09-01,04X,1251,1018,2269,0.5513442044953724
4282,2012-09-01,04Y,1117,333,1450,0.7703448275862069
4283,2012-09-01,05A,2581,1376,3957,0.6522618145059389
4284,2012-09-01,05C,1226,1761,2987,0.4104452628054905
4285,2012-09-01,05D,794,417,1211,0.6556564822460776
4286,2012-09-01,05F,1285,508,1793,0.716675962074735
4287,2012-09-01,05G,1298,545,1843,0.7042864894194248
4288,2012-09-01,05H,1170,547,1717,0.6814210832847991
4289,2012-09-01,05J,1467,490,1957,0.7496167603474706
4290,2012-09-01,05L,2455,1176,3631,0.6761222803635362
4291,2012-09-01,05N,2146,679,2825,0.759646017699115
4292,2012-09-01,05P,1409,654,2063,0.6829859428017451
4293,2012-09-01,05Q,1445,495,1940,0.7448453608247423
4294,2012-09-01,05R,1751,959,2710,0.6461254612546126
4295,2012-09-01,05T,1852,909,2761,0.6707714596160811
4296,2012-09-01,05V,1007,360,1367,0.7366495976591075
4297,2012-09-01,05W,1479,675,2154,0.6866295264623955
4298,2012-09-01,05X,1218,339,1557,0.7822736030828517
4299,2012-09-01,05Y,1657,838,2495,0.6641282565130261
4300,2012-09-01,06A,1459,619,2078,0.7021174205967277
4301,2012-09-01,06D,861,344,1205,0.7145228215767635
4302,2012-09-01,06F,1613,2423,4036,0.3996531219028741
4303,2012-09-01,06H,5221,2786,8007,0.6520544523541901
4304,2012-09-01,06K,3121,2029,5150,0.6060194174757282
4305,2012-09-01,06L,2234,1073,3307,0.6755367402479588
4306,2012-09-01,06M,1983,837,2820,0.7031914893617022
4307,2012-09-01,06N,3317,1947,5264,0.630129179331307
4308,2012-09-01,06P,951,784,1735,0.5481268011527377
4309,2012-09-01,06Q,2284,1172,3456,0.6608796296296297
4310,2012-09-01,06T,2384,1115,3499,0.681337525007145
4311,2012-09-01,06V,1474,569,2043,0.7214880078316201
4312,2012-09-01,06W,1520,500,2020,0.7524752475247525
4313,2012-09-01,06Y,1354,524,1878,0.7209797657082002
4314,2012-09-01,07G,865,299,1164,0.743127147766323
4315,2012-09-01,07H,1662,990,2652,0.6266968325791855
4316,2012-09-01,07J,746,418,1164,0.6408934707903781
4317,2012-09-01,07K,1596,756,2352,0.6785714285714286
4318,2012-09-01,07L,769,298,1067,0.7207122774133083
4319,2012-09-01,07M,1273,775,2048,0.62158203125
4320,2012-09-01,07N,1360,630,1990,0.6834170854271356
4321,2012-09-01,07P,850,373,1223,0.6950122649223222
4322,2012-09-01,07Q,1536,785,2321,0.6617837139164153
4323,2012-09-01,07R,715,483,1198,0.5968280467445742
4324,2012-09-01,07T,645,370,1015,0.6354679802955665
4325,2012-09-01,07V,1834,802,2636,0.6957511380880121
4326,2012-09-01,07W,1081,670,1751,0.6173615077098801
4327,2012-09-01,07X,1289,598,1887,0.6830948595654478
4328,2012-09-01,07Y,836,534,1370,0.6102189781021898
4329,2012-09-01,08A,1200,607,1807,0.6640841173215274
4330,2012-09-01,08C,595,345,940,0.6329787234042553
4331,2012-09-01,08D,897,479,1376,0.6518895348837209
4332,2012-09-01,08E,894,462,1356,0.6592920353982301
4333,2012-09-01,08F,1238,512,1750,0.7074285714285714
4334,2012-09-01,08G,526,1326,1852,0.2840172786177106
4335,2012-09-01,08H,774,526,1300,0.5953846153846154
4336,2012-09-01,08J,831,375,1206,0.6890547263681592
4337,2012-09-01,08K,1209,526,1735,0.6968299711815562
4338,2012-09-01,08L,764,1049,1813,0.4214009928295643
4339,2012-09-01,08M,901,323,1224,0.7361111111111112
4340,2012-09-01,08N,1111,394,1505,0.7382059800664452
4341,2012-09-01,08P,919,484,1403,0.6550249465431219
4342,2012-09-01,08Q,999,399,1398,0.7145922746781116
4343,2012-09-01,08R,882,375,1257,0.7016706443914081
4344,2012-09-01,08T,943,482,1425,0.6617543859649123
4345,2012-09-01,08V,1066,423,1489,0.7159167226326394
4346,2012-09-01,08W,1058,450,1508,0.7015915119363395
4347,2012-09-01,08X,1253,592,1845,0.6791327913279133
4348,2012-09-01,08Y,715,463,1178,0.6069609507640068
4349,2012-09-01,09A,525,400,925,0.5675675675675675
4350,2012-09-01,09C,685,316,1001,0.6843156843156843
4351,2012-09-01,09D,1392,992,2384,0.5838926174496645
4352,2012-09-01,09E,1463,506,1969,0.7430167597765364
4353,2012-09-01,09F,1350,634,1984,0.6804435483870968
4354,2012-09-01,09G,3185,1921,5106,0.6237759498629064
4355,2012-09-01,09H,663,303,966,0.6863354037267081
4356,2012-09-01,09J,1654,793,2447,0.6759297098487944
4357,2012-09-01,09L,830,487,1317,0.6302201974183751
4358,2012-09-01,09N,1102,635,1737,0.6344271732872769
4359,2012-09-01,09P,1134,800,1934,0.5863495346432265
4360,2012-09-01,09W,1528,597,2125,0.7190588235294118
4361,2012-09-01,09X,1146,756,1902,0.6025236593059937
4362,2012-09-01,09Y,1679,1109,2788,0.6022238163558106
4363,2012-09-01,10A,1148,623,1771,0.6482213438735178
4364,2012-09-01,10C,531,277,808,0.6571782178217822
4365,2012-09-01,10D,637,171,808,0.7883663366336634
4366,2012-09-01,10E,752,319,1071,0.7021475256769374
4367,2012-09-01,10G,714,363,1077,0.6629526462395543
4368,2012-09-01,10H,1882,1098,2980,0.6315436241610738
4369,2012-09-01,10J,1032,923,1955,0.5278772378516624
4370,2012-09-01,10K,1186,667,1853,0.6400431732325957
4371,2012-09-01,10L,882,383,1265,0.6972332015810276
4372,2012-09-01,10M,540,425,965,0.5595854922279793
4373,2012-09-01,10N,486,393,879,0.552901023890785
4374,2012-09-01,10Q,2851,2913,5764,0.49462179042331716
4375,2012-09-01,10R,1343,578,1921,0.6991150442477876
4376,2012-09-01,10T,610,292,902,0.6762749445676275
4377,2012-09-01,10V,1210,770,1980,0.6111111111111112
4378,2012-09-01,10W,583,304,887,0.657271702367531
4379,2012-09-01,10X,1269,618,1887,0.6724960254372019
4380,2012-09-01,10Y,1283,744,2027,0.6329551060680809
4381,2012-09-01,11A,3257,1859,5116,0.6366301798279906
4382,2012-09-01,11C,869,406,1275,0.6815686274509803
4383,2012-09-01,11D,675,560,1235,0.5465587044534413
4384,2012-09-01,11E,1186,767,1953,0.6072708653353814
4385,2012-09-01,11H,2550,1511,4061,0.627924156611672
4386,2012-09-01,11J,4838,2535,7373,0.6561779465617794
4387,2012-09-01,11M,3786,1888,5674,0.6672541416989778
4388,2012-09-01,11N,4241,1564,5805,0.7305770887166236
4389,2012-09-01,11T,1518,912,2430,0.6246913580246913
4390,2012-09-01,11X,3588,1974,5562,0.645091693635383
4391,2012-09-01,12A,1432,812,2244,0.6381461675579323
4392,2012-09-01,12D,1181,630,1811,0.6521258972943126
4393,2012-09-01,12F,2623,535,3158,0.8305889803673211
4394,2012-09-01,13P,3212,1626,4838,0.6639107069036793
4395,2012-09-01,13T,3049,1281,4330,0.7041570438799076
4396,2012-09-01,14L,2861,1694,4555,0.6281009879253567
4397,2012-09-01,99A,2763,832,3595,0.768567454798331
4398,2012-09-01,99C,1490,718,2208,0.6748188405797102
4399,2012-09-01,99D,1038,609,1647,0.6302367941712204
4400,2012-09-01,99E,1570,596,2166,0.7248384118190212
4401,2012-09-01,99F,1066,319,1385,0.7696750902527075
4402,2012-09-01,99G,1061,278,1339,0.7923823749066468
4403,2012-09-01,99H,1539,888,2427,0.6341161928306551
4404,2012-09-01,99J,3080,1327,4407,0.6988881325164511
4405,2012-09-01,99K,1037,650,1687,0.6147006520450504
4406,2012-09-01,99M,1107,833,1940,0.5706185567010309
4407,2012-09-01,99N,2855,2405,5260,0.5427756653992395
4408,2012-09-01,99P,6337,2354,8691,0.7291450926245542
4409,2012-09-01,99Q,2067,914,2981,0.6933914793693392
4410,2012-10-01,00C,803,325,1128,0.7118794326241135
4411,2012-10-01,00D,2376,1178,3554,0.6685424873382104
4412,2012-10-01,00F,21,6,27,0.7777777777777778
4413,2012-10-01,00J,1789,877,2666,0.6710427606901725
4414,2012-10-01,00K,2321,1180,3501,0.6629534418737504
4415,2012-10-01,00L,2515,1474,3989,0.6304838305339684
4416,2012-10-01,00M,2251,1104,3355,0.6709388971684054
4417,2012-10-01,00N,1280,606,1886,0.6786850477200425
4418,2012-10-01,00P,2103,805,2908,0.7231774415405777
4419,2012-10-01,00Q,1041,410,1451,0.7174362508614749
4420,2012-10-01,00R,1354,507,1861,0.7275658248253627
4421,2012-10-01,00T,2033,1117,3150,0.6453968253968254
4422,2012-10-01,00V,1447,707,2154,0.6717734447539462
4423,2012-10-01,00W,57,20,77,0.7402597402597403
4424,2012-10-01,00X,1072,281,1353,0.7923133776792314
4425,2012-10-01,00Y,1929,967,2896,0.6660911602209945
4426,2012-10-01,01A,2559,1312,3871,0.6610694910875743
4427,2012-10-01,01C,1409,750,2159,0.6526169522927281
4428,2012-10-01,01D,1685,733,2418,0.6968569065343259
4429,2012-10-01,01E,1292,186,1478,0.8741542625169147
4430,2012-10-01,01F,1016,513,1529,0.6644865925441465
4431,2012-10-01,01G,1460,1171,2631,0.5549220828582289
4432,2012-10-01,01H,2653,899,3552,0.7469031531531531
4433,2012-10-01,01J,1082,490,1572,0.688295165394402
4434,2012-10-01,01K,2296,1257,3553,0.6462144666479032
4435,2012-10-01,01N,16,16,32,0.5
4436,2012-10-01,01R,1085,577,1662,0.6528279181708785
4437,2012-10-01,01T,886,480,1366,0.6486090775988287
4438,2012-10-01,01V,862,367,1229,0.7013832384052074
4439,2012-10-01,01W,2074,921,2995,0.6924874791318865
4440,2012-10-01,01X,1474,619,2093,0.7042522694696608
4441,2012-10-01,01Y,1435,791,2226,0.6446540880503144
4442,2012-10-01,02A,1327,873,2200,0.6031818181818182
4443,2012-10-01,02D,608,390,998,0.6092184368737475
4444,2012-10-01,02E,1258,593,1851,0.6796326310102647
4445,2012-10-01,02F,1739,564,2303,0.7551020408163265
4446,2012-10-01,02G,677,386,1063,0.6368767638758231
4447,2012-10-01,02H,1972,1387,3359,0.5870794879428402
4448,2012-10-01,02M,1085,462,1547,0.7013574660633484
4449,2012-10-01,02N,1094,644,1738,0.6294591484464902
4450,2012-10-01,02P,1397,1344,2741,0.5096680043779642
4451,2012-10-01,02Q,637,491,1128,0.5647163120567376
4452,2012-10-01,02R,2225,1113,3338,0.6665668064709407
4453,2012-10-01,02T,1220,712,1932,0.6314699792960663
4454,2012-10-01,02V,1490,668,2158,0.6904541241890639
4455,2012-10-01,02W,610,305,915,0.6666666666666666
4456,2012-10-01,02X,2004,1102,3106,0.6452028332260141
4457,2012-10-01,02Y,2104,916,3020,0.6966887417218544
4458,2012-10-01,03A,1318,633,1951,0.6755509994874423
4459,2012-10-01,03C,2092,1088,3180,0.6578616352201258
4460,2012-10-01,03D,874,405,1279,0.6833463643471462
4461,2012-10-01,03E,952,591,1543,0.6169799092676604
4462,2012-10-01,03F,1656,683,2339,0.7079948696023942
4463,2012-10-01,03G,1800,723,2523,0.713436385255648
4464,2012-10-01,03H,1301,457,1758,0.7400455062571104
4465,2012-10-01,03J,1308,450,1758,0.7440273037542662
4466,2012-10-01,03K,1146,281,1427,0.803083391730904
4467,2012-10-01,03L,1423,995,2418,0.5885028949545078
4468,2012-10-01,03M,913,472,1385,0.6592057761732852
4469,2012-10-01,03N,3410,905,4315,0.7902665121668598
4470,2012-10-01,03Q,1996,1039,3035,0.657660626029654
4471,2012-10-01,03R,2558,1159,3717,0.6881894000538068
4472,2012-10-01,03T,2071,589,2660,0.7785714285714286
4473,2012-10-01,03V,432,294,726,0.5950413223140496
4474,2012-10-01,03W,2192,1278,3470,0.631700288184438
4475,2012-10-01,03X,518,321,839,0.6174016686531585
4476,2012-10-01,03Y,720,401,1121,0.6422836752899197
4477,2012-10-01,04C,2093,1013,3106,0.6738570508692853
4478,2012-10-01,04D,1509,677,2186,0.6903019213174748
4479,2012-10-01,04E,1248,591,1839,0.6786296900489397
4480,2012-10-01,04F,1558,989,2547,0.6117000392618768
4481,2012-10-01,04G,4321,2243,6564,0.6582876294942108
4482,2012-10-01,04H,805,333,1138,0.7073813708260105
4483,2012-10-01,04J,2079,1041,3120,0.6663461538461538
4484,2012-10-01,04K,1819,828,2647,0.6871930487344163
4485,2012-10-01,04L,909,384,1293,0.703016241299304
4486,2012-10-01,04M,526,239,765,0.6875816993464052
4487,2012-10-01,04N,774,294,1068,0.7247191011235955
4488,2012-10-01,04Q,958,349,1307,0.7329762815608263
4489,2012-10-01,04R,2804,1413,4217,0.6649276737016837
4490,2012-10-01,04V,2379,1126,3505,0.6787446504992868
4491,2012-10-01,04X,1497,1088,2585,0.579110251450677
4492,2012-10-01,04Y,1133,395,1528,0.7414921465968587
4493,2012-10-01,05A,3001,1523,4524,0.6633510167992926
4494,2012-10-01,05C,1331,1809,3140,0.42388535031847135
4495,2012-10-01,05D,849,447,1296,0.6550925925925926
4496,2012-10-01,05F,1316,550,1866,0.7052518756698821
4497,2012-10-01,05G,1457,574,2031,0.7173806006893156
4498,2012-10-01,05H,1268,583,1851,0.6850351161534306
4499,2012-10-01,05J,1478,567,2045,0.7227383863080684
4500,2012-10-01,05L,2684,1265,3949,0.6796657381615598
4501,2012-10-01,05N,2503,709,3212,0.7792652552926526
4502,2012-10-01,05P,1551,765,2316,0.6696891191709845
4503,2012-10-01,05Q,1516,548,2064,0.7344961240310077
4504,2012-10-01,05R,1970,1179,3149,0.6255954271197205
4505,2012-10-01,05T,2270,998,3268,0.6946144430844553
4506,2012-10-01,05V,1088,418,1506,0.7224435590969456
4507,2012-10-01,05W,1622,747,2369,0.6846770789362601
4508,2012-10-01,05X,1250,376,1626,0.7687576875768758
4509,2012-10-01,05Y,1861,936,2797,0.6653557382910261
4510,2012-10-01,06A,1662,691,2353,0.7063323416914578
4511,2012-10-01,06D,910,375,1285,0.708171206225681
4512,2012-10-01,06F,1791,2559,4350,0.41172413793103446
4513,2012-10-01,06H,5530,2979,8509,0.6499001057703608
4514,2012-10-01,06K,3421,2220,5641,0.6064527566034391
4515,2012-10-01,06L,2581,1163,3744,0.6893696581196581
4516,2012-10-01,06M,2129,950,3079,0.6914582656706723
4517,2012-10-01,06N,3495,2270,5765,0.606244579358196
4518,2012-10-01,06P,964,812,1776,0.5427927927927928
4519,2012-10-01,06Q,2418,1257,3675,0.6579591836734694
4520,2012-10-01,06T,2537,1183,3720,0.681989247311828
4521,2012-10-01,06V,1427,591,2018,0.7071357779980179
4522,2012-10-01,06W,1760,512,2272,0.7746478873239436
4523,2012-10-01,06Y,1569,518,2087,0.751796837565884
4524,2012-10-01,07G,942,343,1285,0.7330739299610894
4525,2012-10-01,07H,1785,1028,2813,0.6345538570920726
4526,2012-10-01,07J,819,466,1285,0.6373540856031128
4527,2012-10-01,07K,1605,801,2406,0.6670822942643392
4528,2012-10-01,07L,894,268,1162,0.7693631669535284
4529,2012-10-01,07M,1332,820,2152,0.6189591078066915
4530,2012-10-01,07N,1310,595,1905,0.6876640419947506
4531,2012-10-01,07P,992,488,1480,0.6702702702702703
4532,2012-10-01,07Q,1624,884,2508,0.6475279106858054
4533,2012-10-01,07R,807,561,1368,0.5899122807017544
4534,2012-10-01,07T,771,423,1194,0.6457286432160804
4535,2012-10-01,07V,1926,829,2755,0.6990925589836661
4536,2012-10-01,07W,1134,768,1902,0.5962145110410094
4537,2012-10-01,07X,1481,618,2099,0.7055740828966174
4538,2012-10-01,07Y,922,572,1494,0.6171352074966533
4539,2012-10-01,08A,1185,591,1776,0.6672297297297297
4540,2012-10-01,08C,688,426,1114,0.6175942549371634
4541,2012-10-01,08D,1075,553,1628,0.6603194103194103
4542,2012-10-01,08E,971,460,1431,0.6785464709993012
4543,2012-10-01,08F,1464,657,2121,0.6902404526166902
4544,2012-10-01,08G,549,1401,1950,0.2815384615384615
4545,2012-10-01,08H,913,618,1531,0.5963422599608099
4546,2012-10-01,08J,836,382,1218,0.6863711001642037
4547,2012-10-01,08K,1346,587,1933,0.6963269529229178
4548,2012-10-01,08L,763,980,1743,0.43775100401606426
4549,2012-10-01,08M,990,366,1356,0.7300884955752213
4550,2012-10-01,08N,1193,498,1691,0.7054997043169722
4551,2012-10-01,08P,972,506,1478,0.6576454668470907
4552,2012-10-01,08Q,1136,425,1561,0.7277386290839206
4553,2012-10-01,08R,959,420,1379,0.6954314720812182
4554,2012-10-01,08T,1037,529,1566,0.6621966794380587
4555,2012-10-01,08V,1138,423,1561,0.7290198590647021
4556,2012-10-01,08W,1172,491,1663,0.7047504509921828
4557,2012-10-01,08X,1251,667,1918,0.6522419186652764
4558,2012-10-01,08Y,848,432,1280,0.6625
4559,2012-10-01,09A,629,398,1027,0.6124634858812074
4560,2012-10-01,09C,740,363,1103,0.670897552130553
4561,2012-10-01,09D,1662,1015,2677,0.6208442286141203
4562,2012-10-01,09E,1725,607,2332,0.7397084048027445
4563,2012-10-01,09F,1464,702,2166,0.6759002770083102
4564,2012-10-01,09G,3526,2089,5615,0.6279608192341941
4565,2012-10-01,09H,753,334,1087,0.6927322907083716
4566,2012-10-01,09J,1592,871,2463,0.6463662200568413
4567,2012-10-01,09L,885,523,1408,0.6285511363636364
4568,2012-10-01,09N,1303,686,1989,0.6551030668677728
4569,2012-10-01,09P,1250,891,2141,0.5838393274170948
4570,2012-10-01,09W,1630,683,2313,0.7047124945957631
4571,2012-10-01,09X,1249,939,2188,0.5708409506398537
4572,2012-10-01,09Y,1897,1206,3103,0.6113438607798904
4573,2012-10-01,10A,1261,761,2022,0.6236399604352126
4574,2012-10-01,10C,526,283,809,0.6501854140914709
4575,2012-10-01,10D,682,200,882,0.7732426303854876
4576,2012-10-01,10E,890,355,1245,0.714859437751004
4577,2012-10-01,10G,740,427,1167,0.6341045415595544
4578,2012-10-01,10H,1985,1202,3187,0.622842798870411
4579,2012-10-01,10J,1135,1082,2217,0.5119530897609382
4580,2012-10-01,10K,1306,762,2068,0.6315280464216635
4581,2012-10-01,10L,1103,412,1515,0.7280528052805281
4582,2012-10-01,10M,606,431,1037,0.5843780135004821
4583,2012-10-01,10N,505,445,950,0.531578947368421
4584,2012-10-01,10Q,3031,3153,6184,0.4901358344113842
4585,2012-10-01,10R,1511,620,2131,0.7090567808540591
4586,2012-10-01,10T,635,272,907,0.7001102535832414
4587,2012-10-01,10V,1307,822,2129,0.6139032409581964
4588,2012-10-01,10W,675,371,1046,0.6453154875717018
4589,2012-10-01,10X,1374,705,2079,0.6608946608946609
4590,2012-10-01,10Y,1359,800,2159,0.6294580824455767
4591,2012-10-01,11A,3666,2073,5739,0.6387872451646628
4592,2012-10-01,11C,894,384,1278,0.6995305164319249
4593,2012-10-01,11D,723,560,1283,0.5635229929851909
4594,2012-10-01,11E,1337,1014,2351,0.5686941726924712
4595,2012-10-01,11H,2836,1556,4392,0.6457194899817851
4596,2012-10-01,11J,5263,2825,8088,0.6507171117705243
4597,2012-10-01,11M,4088,1932,6020,0.6790697674418604
4598,2012-10-01,11N,4586,1571,6157,0.7448432678252396
4599,2012-10-01,11T,1642,928,2570,0.6389105058365758
4600,2012-10-01,11X,3759,2116,5875,0.6398297872340426
4601,2012-10-01,12A,1671,904,2575,0.6489320388349514
4602,2012-10-01,12D,1213,627,1840,0.6592391304347827
4603,2012-10-01,12F,2789,604,3393,0.8219864426760979
4604,2012-10-01,13P,3401,1708,5109,0.6656880015658642
4605,2012-10-01,13T,3439,1338,4777,0.7199078919824158
4606,2012-10-01,14L,3150,1865,5015,0.6281156530408774
4607,2012-10-01,99A,3138,867,4005,0.7835205992509363
4608,2012-10-01,99C,1625,744,2369,0.6859434360489658
4609,2012-10-01,99D,1151,708,1859,0.6191500806885423
4610,2012-10-01,99E,1703,603,2306,0.7385082393755421
4611,2012-10-01,99F,1136,368,1504,0.7553191489361702
4612,2012-10-01,99G,1072,305,1377,0.7785039941902687
4613,2012-10-01,99H,1694,1018,2712,0.6246312684365781
4614,2012-10-01,99J,3264,1433,4697,0.6949116457313179
4615,2012-10-01,99K,1149,714,1863,0.6167471819645732
4616,2012-10-01,99M,1222,916,2138,0.5715622076707203
4617,2012-10-01,99N,3091,2653,5744,0.5381267409470752
4618,2012-10-01,99P,6949,2516,9465,0.7341785525620708
4619,2012-10-01,99Q,2140,976,3116,0.686777920410783
4620,2012-11-01,00C,739,356,1095,0.6748858447488585
4621,2012-11-01,00D,2245,1187,3432,0.6541375291375291
4622,2012-11-01,00F,24,6,30,0.8
4623,2012-11-01,00J,1829,878,2707,0.675655707425194
4624,2012-11-01,00K,2218,1119,3337,0.6646688642493257
4625,2012-11-01,00L,2356,1461,3817,0.617238669111868
4626,2012-11-01,00M,2139,1018,3157,0.677541970224897
4627,2012-11-01,00N,1248,595,1843,0.6771568095496473
4628,2012-11-01,00P,2064,765,2829,0.7295864262990456
4629,2012-11-01,00Q,1004,375,1379,0.7280638143582306
4630,2012-11-01,00R,1232,458,1690,0.7289940828402367
4631,2012-11-01,00T,1907,1076,2983,0.6392893060677171
4632,2012-11-01,00V,1399,683,2082,0.6719500480307397
4633,2012-11-01,00W,84,26,110,0.7636363636363637
4634,2012-11-01,00X,1027,274,1301,0.7893927747886241
4635,2012-11-01,00Y,1909,915,2824,0.6759915014164306
4636,2012-11-01,01A,2399,1272,3671,0.6535004086080087
4637,2012-11-01,01C,1324,776,2100,0.6304761904761905
4638,2012-11-01,01D,1549,638,2187,0.7082761774119799
4639,2012-11-01,01E,1228,206,1434,0.8563458856345886
4640,2012-11-01,01F,936,465,1401,0.6680942184154176
4641,2012-11-01,01G,1436,1112,2548,0.5635792778649922
4642,2012-11-01,01H,2508,895,3403,0.736996767558037
4643,2012-11-01,01J,1052,431,1483,0.7093728927848955
4644,2012-11-01,01K,2256,1193,3449,0.6541026384459263
4645,2012-11-01,01N,25,7,32,0.78125
4646,2012-11-01,01R,1018,567,1585,0.6422712933753943
4647,2012-11-01,01T,852,403,1255,0.6788844621513944
4648,2012-11-01,01V,848,345,1193,0.71081307627829
4649,2012-11-01,01W,2015,912,2927,0.6884181756064229
4650,2012-11-01,01X,1535,674,2209,0.694884563150747
4651,2012-11-01,01Y,1251,732,1983,0.6308623298033282
4652,2012-11-01,02A,1282,823,2105,0.6090261282660333
4653,2012-11-01,02D,583,440,1023,0.5698924731182796
4654,2012-11-01,02E,1274,497,1771,0.7193675889328063
4655,2012-11-01,02F,1685,590,2275,0.7406593406593407
4656,2012-11-01,02G,601,344,945,0.635978835978836
4657,2012-11-01,02H,1967,1286,3253,0.6046726098985552
4658,2012-11-01,02M,1023,397,1420,0.7204225352112676
4659,2012-11-01,02N,1013,638,1651,0.6135675348273774
4660,2012-11-01,02P,1279,1204,2483,0.5151026983487716
4661,2012-11-01,02Q,615,488,1103,0.557570262919311
4662,2012-11-01,02R,2121,1031,3152,0.6729060913705583
4663,2012-11-01,02T,1180,688,1868,0.6316916488222698
4664,2012-11-01,02V,1451,681,2132,0.6805816135084428
4665,2012-11-01,02W,598,271,869,0.6881472957422324
4666,2012-11-01,02X,1856,1001,2857,0.6496324816240812
4667,2012-11-01,02Y,1982,928,2910,0.6810996563573883
4668,2012-11-01,03A,1146,586,1732,0.6616628175519631
4669,2012-11-01,03C,1930,1028,2958,0.6524678837052063
4670,2012-11-01,03D,842,396,1238,0.6801292407108239
4671,2012-11-01,03E,983,552,1535,0.6403908794788273
4672,2012-11-01,03F,1623,670,2293,0.7078063672045355
4673,2012-11-01,03G,1567,721,2288,0.6848776223776224
4674,2012-11-01,03H,1262,431,1693,0.7454223272297696
4675,2012-11-01,03J,1165,414,1579,0.7378087397086763
4676,2012-11-01,03K,1053,252,1305,0.8068965517241379
4677,2012-11-01,03L,1295,974,2269,0.5707360070515646
4678,2012-11-01,03M,822,403,1225,0.6710204081632654
4679,2012-11-01,03N,3379,850,4229,0.7990068574131001
4680,2012-11-01,03Q,1954,967,2921,0.6689489900718932
4681,2012-11-01,03R,2302,1030,3332,0.6908763505402161
4682,2012-11-01,03T,1896,631,2527,0.7502967946181243
4683,2012-11-01,03V,433,238,671,0.6453055141579732
4684,2012-11-01,03W,2210,1115,3325,0.6646616541353384
4685,2012-11-01,03X,460,270,730,0.6301369863013698
4686,2012-11-01,03Y,737,384,1121,0.6574487065120428
4687,2012-11-01,04C,1957,931,2888,0.6776315789473685
4688,2012-11-01,04D,1340,616,1956,0.6850715746421268
4689,2012-11-01,04E,1182,540,1722,0.686411149825784
4690,2012-11-01,04F,1418,1016,2434,0.5825801150369762
4691,2012-11-01,04G,4129,2239,6368,0.6483982412060302
4692,2012-11-01,04H,774,332,1106,0.6998191681735986
4693,2012-11-01,04J,2049,969,3018,0.6789264413518886
4694,2012-11-01,04K,1723,876,2599,0.6629472874182378
4695,2012-11-01,04L,851,361,1212,0.7021452145214522
4696,2012-11-01,04M,536,251,787,0.6810673443456162
4697,2012-11-01,04N,701,267,968,0.7241735537190083
4698,2012-11-01,04Q,874,340,1214,0.7199341021416804
4699,2012-11-01,04R,2658,1231,3889,0.6834661866803805
4700,2012-11-01,04V,2284,1094,3378,0.6761397276494967
4701,2012-11-01,04X,1338,1066,2404,0.5565723793677204
4702,2012-11-01,04Y,1095,370,1465,0.7474402730375427
4703,2012-11-01,05A,2689,1394,4083,0.6585843742346315
4704,2012-11-01,05C,1196,1733,2929,0.4083304882212359
4705,2012-11-01,05D,814,449,1263,0.6444972288202692
4706,2012-11-01,05F,1360,514,1874,0.7257203842049093
4707,2012-11-01,05G,1444,482,1926,0.7497403946002077
4708,2012-11-01,05H,1182,594,1776,0.6655405405405406
4709,2012-11-01,05J,1386,572,1958,0.7078651685393258
4710,2012-11-01,05L,2523,1210,3733,0.675863916421109
4711,2012-11-01,05N,2247,708,2955,0.7604060913705584
4712,2012-11-01,05P,1411,731,2142,0.6587301587301587
4713,2012-11-01,05Q,1389,557,1946,0.7137718396711202
4714,2012-11-01,05R,1918,1046,2964,0.6470985155195681
4715,2012-11-01,05T,2169,1013,3182,0.6816467630421119
4716,2012-11-01,05V,1030,425,1455,0.7079037800687286
4717,2012-11-01,05W,1547,673,2220,0.6968468468468468
4718,2012-11-01,05X,1175,404,1579,0.7441418619379354
4719,2012-11-01,05Y,1772,848,2620,0.6763358778625954
4720,2012-11-01,06A,1683,660,2343,0.7183098591549296
4721,2012-11-01,06D,852,372,1224,0.696078431372549
4722,2012-11-01,06F,1693,2409,4102,0.4127254997562165
4723,2012-11-01,06H,5300,2786,8086,0.6554538708879545
4724,2012-11-01,06K,3205,2164,5369,0.596945427453902
4725,2012-11-01,06L,2464,1138,3602,0.6840644086618545
4726,2012-11-01,06M,1891,897,2788,0.6782639885222381
4727,2012-11-01,06N,3290,2102,5392,0.6101632047477745
4728,2012-11-01,06P,870,818,1688,0.5154028436018957
4729,2012-11-01,06Q,2416,1286,3702,0.6526202052944354
4730,2012-11-01,06T,2472,1190,3662,0.6750409612233752
4731,2012-11-01,06V,1468,603,2071,0.7088363109608885
4732,2012-11-01,06W,1504,522,2026,0.7423494570582428
4733,2012-11-01,06Y,1381,526,1907,0.7241740954378605
4734,2012-11-01,07G,887,322,1209,0.7336641852770885
4735,2012-11-01,07H,1591,959,2550,0.623921568627451
4736,2012-11-01,07J,778,457,1235,0.6299595141700405
4737,2012-11-01,07K,1552,788,2340,0.6632478632478632
4738,2012-11-01,07L,843,249,1092,0.771978021978022
4739,2012-11-01,07M,1310,766,2076,0.6310211946050096
4740,2012-11-01,07N,1271,638,1909,0.6657936092194866
4741,2012-11-01,07P,929,482,1411,0.6583982990786676
4742,2012-11-01,07Q,1602,862,2464,0.6501623376623377
4743,2012-11-01,07R,764,494,1258,0.6073131955484896
4744,2012-11-01,07T,740,418,1158,0.6390328151986183
4745,2012-11-01,07V,1782,880,2662,0.6694214876033058
4746,2012-11-01,07W,1063,709,1772,0.5998871331828443
4747,2012-11-01,07X,1300,578,1878,0.6922257720979765
4748,2012-11-01,07Y,914,596,1510,0.6052980132450331
4749,2012-11-01,08A,1287,613,1900,0.6773684210526316
4750,2012-11-01,08C,659,405,1064,0.6193609022556391
4751,2012-11-01,08D,948,535,1483,0.6392447741065408
4752,2012-11-01,08E,870,456,1326,0.6561085972850679
4753,2012-11-01,08F,1342,616,1958,0.6853932584269663
4754,2012-11-01,08G,571,1318,1889,0.3022763366860773
4755,2012-11-01,08H,787,566,1353,0.581670362158167
4756,2012-11-01,08J,921,439,1360,0.6772058823529412
4757,2012-11-01,08K,1295,564,1859,0.6966110812264659
4758,2012-11-01,08L,780,1165,1945,0.40102827763496146
4759,2012-11-01,08M,1002,349,1351,0.7416728349370837
4760,2012-11-01,08N,1141,418,1559,0.731879409878127
4761,2012-11-01,08P,996,501,1497,0.6653306613226453
4762,2012-11-01,08Q,1063,393,1456,0.7300824175824175
4763,2012-11-01,08R,950,399,1349,0.704225352112676
4764,2012-11-01,08T,1034,563,1597,0.6474639949906074
4765,2012-11-01,08V,1105,392,1497,0.7381429525718103
4766,2012-11-01,08W,1128,469,1597,0.7063243581715717
4767,2012-11-01,08X,1181,596,1777,0.6646032639279685
4768,2012-11-01,08Y,698,440,1138,0.6133567662565905
4769,2012-11-01,09A,580,472,1052,0.5513307984790875
4770,2012-11-01,09C,786,344,1130,0.695575221238938
4771,2012-11-01,09D,1536,972,2508,0.6124401913875598
4772,2012-11-01,09E,1468,579,2047,0.7171470444553004
4773,2012-11-01,09F,1402,682,2084,0.6727447216890595
4774,2012-11-01,09G,3426,2055,5481,0.6250684181718664
4775,2012-11-01,09H,677,321,998,0.6783567134268537
4776,2012-11-01,09J,1676,829,2505,0.669061876247505
4777,2012-11-01,09L,897,500,1397,0.6420901932712957
4778,2012-11-01,09N,1139,698,1837,0.6200326619488297
4779,2012-11-01,09P,1199,791,1990,0.6025125628140704
4780,2012-11-01,09W,1562,628,2190,0.7132420091324201
4781,2012-11-01,09X,1150,818,1968,0.584349593495935
4782,2012-11-01,09Y,1688,1183,2871,0.5879484500174156
4783,2012-11-01,10A,1240,685,1925,0.6441558441558441
4784,2012-11-01,10C,550,305,855,0.6432748538011696
4785,2012-11-01,10D,637,203,840,0.7583333333333333
4786,2012-11-01,10E,855,326,1181,0.7239627434377646
4787,2012-11-01,10G,707,390,1097,0.6444849589790337
4788,2012-11-01,10H,1851,1170,3021,0.6127110228401191
4789,2012-11-01,10J,1097,1036,2133,0.5142991092358181
4790,2012-11-01,10K,1225,675,1900,0.6447368421052632
4791,2012-11-01,10L,968,384,1352,0.7159763313609467
4792,2012-11-01,10M,575,413,988,0.5819838056680162
4793,2012-11-01,10N,485,347,832,0.5829326923076923
4794,2012-11-01,10Q,2794,2967,5761,0.48498524561708034
4795,2012-11-01,10R,1472,561,2033,0.7240531234628628
4796,2012-11-01,10T,622,284,906,0.6865342163355408
4797,2012-11-01,10V,1205,806,2011,0.599204375932372
4798,2012-11-01,10W,694,348,1042,0.6660268714011516
4799,2012-11-01,10X,1311,677,1988,0.6594567404426559
4800,2012-11-01,10Y,1254,785,2039,0.6150073565473271
4801,2012-11-01,11A,3549,2136,5685,0.6242744063324538
4802,2012-11-01,11C,864,421,1285,0.6723735408560312
4803,2012-11-01,11D,698,549,1247,0.5597433841218925
4804,2012-11-01,11E,1227,919,2146,0.5717614165890028
4805,2012-11-01,11H,2597,1511,4108,0.6321811100292113
4806,2012-11-01,11J,5019,2639,7658,0.6553930530164533
4807,2012-11-01,11M,3779,1934,5713,0.6614738316121127
4808,2012-11-01,11N,4262,1474,5736,0.74302649930265
4809,2012-11-01,11T,1555,883,2438,0.6378178835110746
4810,2012-11-01,11X,3528,1964,5492,0.6423889293517844
4811,2012-11-01,12A,1494,757,2251,0.6637050199911151
4812,2012-11-01,12D,1162,647,1809,0.6423438363736871
4813,2012-11-01,12F,2721,602,3323,0.8188383990370147
4814,2012-11-01,13P,3190,1622,4812,0.6629260182876143
4815,2012-11-01,13T,3251,1382,4633,0.7017051586445068
4816,2012-11-01,14L,3062,1848,4910,0.6236252545824847
4817,2012-11-01,99A,2905,905,3810,0.7624671916010499
4818,2012-11-01,99C,1614,721,2335,0.691220556745182
4819,2012-11-01,99D,1013,667,1680,0.6029761904761904
4820,2012-11-01,99E,1596,610,2206,0.7234814143245694
4821,2012-11-01,99F,1181,328,1509,0.7826375082836315
4822,2012-11-01,99G,987,287,1274,0.7747252747252747
4823,2012-11-01,99H,1655,951,2606,0.6350729086722947
4824,2012-11-01,99J,3265,1442,4707,0.6936477586573189
4825,2012-11-01,99K,1064,755,1819,0.5849367784496976
4826,2012-11-01,99M,1049,788,1837,0.5710397387044094
4827,2012-11-01,99N,2969,2492,5461,0.5436733199047793
4828,2012-11-01,99P,6566,2470,9036,0.7266489597166887
4829,2012-11-01,99Q,2017,899,2916,0.6917009602194787
4830,2012-12-01,00C,709,331,1040,0.6817307692307693
4831,2012-12-01,00D,2038,1113,3151,0.6467788003808315
4832,2012-12-01,00F,22,8,30,0.7333333333333333
4833,2012-12-01,00J,1704,849,2553,0.6674500587544065
4834,2012-12-01,00K,2040,1053,3093,0.6595538312318138
4835,2012-12-01,00L,2213,1366,3579,0.6183291422184968
4836,2012-12-01,00M,1960,1023,2983,0.6570566543747904
4837,2012-12-01,00N,1144,529,1673,0.6838015540944411
4838,2012-12-01,00P,1754,738,2492,0.7038523274478331
4839,2012-12-01,00Q,918,354,1272,0.7216981132075472
4840,2012-12-01,00R,1193,438,1631,0.7314530962599632
4841,2012-12-01,00T,1878,1067,2945,0.6376910016977929
4842,2012-12-01,00V,1399,621,2020,0.6925742574257425
4843,2012-12-01,00W,61,25,86,0.7093023255813954
4844,2012-12-01,00X,940,262,1202,0.7820299500831946
4845,2012-12-01,00Y,1675,842,2517,0.6654747715534366
4846,2012-12-01,01A,2284,1211,3495,0.6535050071530758
4847,2012-12-01,01C,1259,730,1989,0.63298139768728
4848,2012-12-01,01D,1430,639,2069,0.6911551474142098
4849,2012-12-01,01E,1095,184,1279,0.856137607505864
4850,2012-12-01,01F,871,434,1305,0.6674329501915709
4851,2012-12-01,01G,1299,1047,2346,0.5537084398976982
4852,2012-12-01,01H,2376,860,3236,0.7342398022249691
4853,2012-12-01,01J,963,445,1408,0.6839488636363636
4854,2012-12-01,01K,2069,1156,3225,0.6415503875968992
4855,2012-12-01,01N,24,16,40,0.6
4856,2012-12-01,01R,969,573,1542,0.6284046692607004
4857,2012-12-01,01T,775,402,1177,0.6584536958368734
4858,2012-12-01,01V,824,360,1184,0.6959459459459459
4859,2012-12-01,01W,1833,818,2651,0.6914371935118823
4860,2012-12-01,01X,1360,635,1995,0.681704260651629
4861,2012-12-01,01Y,1267,683,1950,0.6497435897435897
4862,2012-12-01,02A,1254,771,2025,0.6192592592592593
4863,2012-12-01,02D,552,374,926,0.5961123110151187
4864,2012-12-01,02E,1104,495,1599,0.6904315196998124
4865,2012-12-01,02F,1563,574,2137,0.731399157697707
4866,2012-12-01,02G,549,299,848,0.6474056603773585
4867,2012-12-01,02H,1703,1195,2898,0.5876466528640442
4868,2012-12-01,02M,928,375,1303,0.7122026093630084
4869,2012-12-01,02N,895,608,1503,0.5954757152361942
4870,2012-12-01,02P,1220,1161,2381,0.5123897522049559
4871,2012-12-01,02Q,587,444,1031,0.5693501454898157
4872,2012-12-01,02R,1901,1022,2923,0.6503592199794731
4873,2012-12-01,02T,1110,626,1736,0.6394009216589862
4874,2012-12-01,02V,1388,658,2046,0.678396871945259
4875,2012-12-01,02W,582,229,811,0.717632552404439
4876,2012-12-01,02X,1721,957,2678,0.6426437640029873
4877,2012-12-01,02Y,1877,827,2704,0.6941568047337278
4878,2012-12-01,03A,1107,581,1688,0.6558056872037915
4879,2012-12-01,03C,1813,901,2714,0.6680176860722181
4880,2012-12-01,03D,831,386,1217,0.6828266228430567
4881,2012-12-01,03E,897,536,1433,0.6259595254710397
4882,2012-12-01,03F,1514,590,2104,0.7195817490494296
4883,2012-12-01,03G,1570,674,2244,0.6996434937611408
4884,2012-12-01,03H,1162,456,1618,0.7181705809641533
4885,2012-12-01,03J,1031,405,1436,0.717966573816156
4886,2012-12-01,03K,873,258,1131,0.7718832891246684
4887,2012-12-01,03L,1256,903,2159,0.5817508105604446
4888,2012-12-01,03M,836,422,1258,0.6645468998410174
4889,2012-12-01,03N,2970,783,3753,0.7913669064748201
4890,2012-12-01,03Q,1884,942,2826,0.6666666666666666
4891,2012-12-01,03R,2166,1007,3173,0.6826347305389222
4892,2012-12-01,03T,1783,586,2369,0.7526382439848037
4893,2012-12-01,03V,410,216,626,0.6549520766773163
4894,2012-12-01,03W,2054,1108,3162,0.6495888678051865
4895,2012-12-01,03X,397,255,652,0.6088957055214724
4896,2012-12-01,03Y,622,363,985,0.6314720812182741
4897,2012-12-01,04C,1839,814,2653,0.6931775348661893
4898,2012-12-01,04D,1339,559,1898,0.7054794520547946
4899,2012-12-01,04E,1041,507,1548,0.6724806201550387
4900,2012-12-01,04F,1330,906,2236,0.5948121645796064
4901,2012-12-01,04G,3905,2182,6087,0.6415311319204863
4902,2012-12-01,04H,678,292,970,0.6989690721649484
4903,2012-12-01,04J,1931,1003,2934,0.658145875937287
4904,2012-12-01,04K,1462,743,2205,0.6630385487528345
4905,2012-12-01,04L,780,318,1098,0.7103825136612022
4906,2012-12-01,04M,540,221,761,0.709592641261498
4907,2012-12-01,04N,685,283,968,0.7076446280991735
4908,2012-12-01,04Q,821,351,1172,0.7005119453924915
4909,2012-12-01,04R,2426,1124,3550,0.6833802816901409
4910,2012-12-01,04V,2095,1068,3163,0.6623458741700917
4911,2012-12-01,04X,1286,980,2266,0.5675198587819947
4912,2012-12-01,04Y,1040,364,1404,0.7407407407407407
4913,2012-12-01,05A,2517,1306,3823,0.6583834684802511
4914,2012-12-01,05C,1139,1585,2724,0.41813509544787075
4915,2012-12-01,05D,804,403,1207,0.6661143330571665
4916,2012-12-01,05F,1200,515,1715,0.6997084548104956
4917,2012-12-01,05G,1288,503,1791,0.7191513121161363
4918,2012-12-01,05H,1031,563,1594,0.6468005018820577
4919,2012-12-01,05J,1360,614,1974,0.6889564336372846
4920,2012-12-01,05L,2264,1131,3395,0.6668630338733431
4921,2012-12-01,05N,2174,688,2862,0.7596086652690426
4922,2012-12-01,05P,1330,719,2049,0.6490971205466081
4923,2012-12-01,05Q,1290,506,1796,0.7182628062360802
4924,2012-12-01,05R,1821,993,2814,0.6471215351812367
4925,2012-12-01,05T,2022,965,2987,0.6769333779712086
4926,2012-12-01,05V,954,375,1329,0.7178329571106095
4927,2012-12-01,05W,1454,665,2119,0.686172722982539
4928,2012-12-01,05X,1140,354,1494,0.7630522088353414
4929,2012-12-01,05Y,1592,758,2350,0.6774468085106383
4930,2012-12-01,06A,1537,560,2097,0.7329518359561278
4931,2012-12-01,06D,822,348,1170,0.7025641025641025
4932,2012-12-01,06F,1682,2244,3926,0.4284258787570046
4933,2012-12-01,06H,4983,2532,7515,0.6630738522954092
4934,2012-12-01,06K,3057,2048,5105,0.5988246816846229
4935,2012-12-01,06L,2305,1106,3411,0.6757549105834066
4936,2012-12-01,06M,1884,849,2733,0.6893523600439078
4937,2012-12-01,06N,3215,1972,5187,0.6198187777135146
4938,2012-12-01,06P,835,792,1627,0.5132145052243393
4939,2012-12-01,06Q,2316,1198,3514,0.6590779738190097
4940,2012-12-01,06T,2390,1075,3465,0.6897546897546898
4941,2012-12-01,06V,1382,570,1952,0.7079918032786885
4942,2012-12-01,06W,1423,558,1981,0.718324078748107
4943,2012-12-01,06Y,1258,485,1743,0.7217441193344808
4944,2012-12-01,07G,855,304,1159,0.7377049180327869
4945,2012-12-01,07H,1506,900,2406,0.6259351620947631
4946,2012-12-01,07J,723,403,1126,0.6420959147424512
4947,2012-12-01,07K,1501,772,2273,0.6603607567091949
4948,2012-12-01,07L,717,234,951,0.7539432176656151
4949,2012-12-01,07M,1163,733,1896,0.6133966244725738
4950,2012-12-01,07N,1234,592,1826,0.6757940854326396
4951,2012-12-01,07P,893,472,1365,0.6542124542124542
4952,2012-12-01,07Q,1555,800,2355,0.6602972399150743
4953,2012-12-01,07R,656,442,1098,0.5974499089253188
4954,2012-12-01,07T,622,340,962,0.6465696465696466
4955,2012-12-01,07V,1684,858,2542,0.6624704956726987
4956,2012-12-01,07W,1007,642,1649,0.6106731352334749
4957,2012-12-01,07X,1145,510,1655,0.6918429003021148
4958,2012-12-01,07Y,716,501,1217,0.5883319638455218
4959,2012-12-01,08A,1042,578,1620,0.6432098765432098
4960,2012-12-01,08C,592,368,960,0.6166666666666667
4961,2012-12-01,08D,841,534,1375,0.6116363636363636
4962,2012-12-01,08E,819,458,1277,0.6413469068128426
4963,2012-12-01,08F,1211,555,1766,0.6857304643261608
4964,2012-12-01,08G,557,1182,1739,0.320299022426682
4965,2012-12-01,08H,707,538,1245,0.5678714859437751
4966,2012-12-01,08J,747,388,1135,0.6581497797356828
4967,2012-12-01,08K,1049,548,1597,0.656856606136506
4968,2012-12-01,08L,662,982,1644,0.402676399026764
4969,2012-12-01,08M,935,325,1260,0.7420634920634921
4970,2012-12-01,08N,1060,409,1469,0.7215793056501021
4971,2012-12-01,08P,911,458,1369,0.6654492330168006
4972,2012-12-01,08Q,962,373,1335,0.7205992509363296
4973,2012-12-01,08R,922,413,1335,0.6906367041198502
4974,2012-12-01,08T,916,474,1390,0.6589928057553956
4975,2012-12-01,08V,916,394,1310,0.6992366412213741
4976,2012-12-01,08W,1006,483,1489,0.6756212222968435
4977,2012-12-01,08X,1054,566,1620,0.6506172839506172
4978,2012-12-01,08Y,658,412,1070,0.6149532710280374
4979,2012-12-01,09A,491,375,866,0.5669745958429562
4980,2012-12-01,09C,688,326,1014,0.6785009861932939
4981,2012-12-01,09D,1367,938,2305,0.593058568329718
4982,2012-12-01,09E,1535,600,2135,0.7189695550351288
4983,2012-12-01,09F,1257,649,1906,0.6594963273871983
4984,2012-12-01,09G,3200,1857,5057,0.6327862368993474
4985,2012-12-01,09H,639,322,961,0.6649323621227887
4986,2012-12-01,09J,1566,762,2328,0.6726804123711341
4987,2012-12-01,09L,800,480,1280,0.625
4988,2012-12-01,09N,1090,640,1730,0.630057803468208
4989,2012-12-01,09P,959,778,1737,0.5521013241220495
4990,2012-12-01,09W,1416,605,2021,0.7006432459178624
4991,2012-12-01,09X,1072,752,1824,0.5877192982456141
4992,2012-12-01,09Y,1615,1117,2732,0.5911420204978038
4993,2012-12-01,10A,1122,665,1787,0.6278679350867375
4994,2012-12-01,10C,463,278,741,0.6248313090418354
4995,2012-12-01,10D,605,197,802,0.7543640897755611
4996,2012-12-01,10E,785,325,1110,0.7072072072072072
4997,2012-12-01,10G,664,359,1023,0.6490713587487781
4998,2012-12-01,10H,1697,1066,2763,0.6141874773796598
4999,2012-12-01,10J,969,948,1917,0.5054773082942097
5000,2012-12-01,10K,1161,681,1842,0.6302931596091205
5001,2012-12-01,10L,937,390,1327,0.706103993971364
5002,2012-12-01,10M,471,395,866,0.5438799076212472
5003,2012-12-01,10N,439,375,814,0.5393120393120393
5004,2012-12-01,10Q,2716,2701,5417,0.501384530182758
5005,2012-12-01,10R,1341,566,1907,0.7031987414787625
5006,2012-12-01,10T,486,261,747,0.6506024096385542
5007,2012-12-01,10V,1187,795,1982,0.5988900100908173
5008,2012-12-01,10W,581,302,883,0.6579841449603624
5009,2012-12-01,10X,1158,616,1774,0.6527621195039459
5010,2012-12-01,10Y,1287,757,2044,0.6296477495107632
5011,2012-12-01,11A,3390,1890,5280,0.6420454545454546
5012,2012-12-01,11C,813,381,1194,0.6809045226130653
5013,2012-12-01,11D,640,525,1165,0.5493562231759657
5014,2012-12-01,11E,1209,883,2092,0.5779158699808795
5015,2012-12-01,11H,2370,1369,3739,0.633859320673977
5016,2012-12-01,11J,4537,2515,7052,0.6433635847986386
5017,2012-12-01,11M,3643,1807,5450,0.6684403669724771
5018,2012-12-01,11N,3916,1464,5380,0.7278810408921933
5019,2012-12-01,11T,1441,798,2239,0.6435908887896382
5020,2012-12-01,11X,3280,1858,5138,0.6383806928766057
5021,2012-12-01,12A,1375,714,2089,0.6582096696984203
5022,2012-12-01,12D,1039,658,1697,0.6122569239835003
5023,2012-12-01,12F,2394,593,2987,0.8014730498828255
5024,2012-12-01,13P,2859,1561,4420,0.6468325791855204
5025,2012-12-01,13T,3010,1251,4261,0.7064069467261206
5026,2012-12-01,14L,2811,1630,4441,0.6329655482999325
5027,2012-12-01,99A,2502,789,3291,0.7602552415679125
5028,2012-12-01,99C,1412,643,2055,0.6871046228710462
5029,2012-12-01,99D,1037,626,1663,0.6235718580877931
5030,2012-12-01,99E,1491,547,2038,0.7315996074582924
5031,2012-12-01,99F,1021,308,1329,0.7682468021068473
5032,2012-12-01,99G,852,276,1128,0.7553191489361702
5033,2012-12-01,99H,1582,908,2490,0.6353413654618474
5034,2012-12-01,99J,3101,1436,4537,0.6834912938064801
5035,2012-12-01,99K,957,646,1603,0.5970056144728634
5036,2012-12-01,99M,1083,807,1890,0.573015873015873
5037,2012-12-01,99N,2660,2281,4941,0.5383525602104837
5038,2012-12-01,99P,6226,2345,8571,0.7264029868160075
5039,2012-12-01,99Q,1904,863,2767,0.688109866281171
5040,2013-01-01,00C,752,337,1089,0.6905417814508723
5041,2013-01-01,00D,2203,1165,3368,0.6540973871733967
5042,2013-01-01,00F,21,5,26,0.8076923076923077
5043,2013-01-01,00J,1748,943,2691,0.6495726495726496
5044,2013-01-01,00K,2346,1057,3403,0.6893917131942404
5045,2013-01-01,00L,2378,1472,3850,0.6176623376623377
5046,2013-01-01,00M,2255,1076,3331,0.6769738817172021
5047,2013-01-01,00N,1311,572,1883,0.6962294211364843
5048,2013-01-01,00P,1979,800,2779,0.7121266642677222
5049,2013-01-01,00Q,1005,371,1376,0.7303779069767442
5050,2013-01-01,00R,1279,469,1748,0.7316933638443935
5051,2013-01-01,00T,1966,1211,3177,0.6188227887944602
5052,2013-01-01,00V,1403,736,2139,0.6559139784946236
5053,2013-01-01,00W,64,25,89,0.7191011235955056
5054,2013-01-01,00X,1006,259,1265,0.7952569169960474
5055,2013-01-01,00Y,1791,894,2685,0.6670391061452514
5056,2013-01-01,01A,2532,1309,3841,0.6592033324655038
5057,2013-01-01,01C,1326,763,2089,0.6347534705600766
5058,2013-01-01,01D,1648,720,2368,0.6959459459459459
5059,2013-01-01,01E,1268,186,1454,0.8720770288858322
5060,2013-01-01,01F,986,475,1461,0.6748802190280629
5061,2013-01-01,01G,1466,1167,2633,0.5567793391568553
5062,2013-01-01,01H,2592,912,3504,0.7397260273972602
5063,2013-01-01,01J,1118,482,1600,0.69875
5064,2013-01-01,01K,2137,1090,3227,0.6622249767585994
5065,2013-01-01,01N,15,23,38,0.39473684210526316
5066,2013-01-01,01R,1053,592,1645,0.6401215805471124
5067,2013-01-01,01T,848,454,1302,0.6513056835637481
5068,2013-01-01,01V,868,368,1236,0.7022653721682848
5069,2013-01-01,01W,2065,908,2973,0.6945845946855028
5070,2013-01-01,01X,1485,692,2177,0.6821313734497014
5071,2013-01-01,01Y,1437,756,2193,0.655266757865937
5072,2013-01-01,02A,1348,873,2221,0.6069338135974787
5073,2013-01-01,02D,571,418,989,0.5773508594539939
5074,2013-01-01,02E,1256,498,1754,0.7160775370581528
5075,2013-01-01,02F,1724,689,2413,0.7144633236634894
5076,2013-01-01,02G,623,366,989,0.6299292214357938
5077,2013-01-01,02H,1827,1336,3163,0.5776161871640847
5078,2013-01-01,02M,1122,387,1509,0.7435387673956262
5079,2013-01-01,02N,988,676,1664,0.59375
5080,2013-01-01,02P,1307,1195,2502,0.5223820943245404
5081,2013-01-01,02Q,627,510,1137,0.5514511873350924
5082,2013-01-01,02R,2170,1137,3307,0.6561838524342304
5083,2013-01-01,02T,1175,685,1860,0.6317204301075269
5084,2013-01-01,02V,1404,647,2051,0.6845441248171623
5085,2013-01-01,02W,591,280,871,0.6785304247990815
5086,2013-01-01,02X,1987,1064,3051,0.6512618813503769
5087,2013-01-01,02Y,2111,946,3057,0.6905462872096827
5088,2013-01-01,03A,1264,592,1856,0.6810344827586207
5089,2013-01-01,03C,2075,999,3074,0.6750162654521795
5090,2013-01-01,03D,827,406,1233,0.6707218167072182
5091,2013-01-01,03E,969,572,1541,0.6288124594419209
5092,2013-01-01,03F,1714,656,2370,0.7232067510548523
5093,2013-01-01,03G,1714,716,2430,0.7053497942386832
5094,2013-01-01,03H,1277,482,1759,0.7259806708357021
5095,2013-01-01,03J,1171,418,1589,0.736941472624292
5096,2013-01-01,03K,1055,288,1343,0.7855547282204021
5097,2013-01-01,03L,1332,1026,2358,0.5648854961832062
5098,2013-01-01,03M,797,405,1202,0.6630615640599001
5099,2013-01-01,03N,3313,889,4202,0.7884340790099953
5100,2013-01-01,03Q,1979,1026,3005,0.6585690515806988
5101,2013-01-01,03R,2473,1009,3482,0.7102240091901206
5102,2013-01-01,03T,1942,603,2545,0.7630648330058939
5103,2013-01-01,03V,418,228,646,0.6470588235294118
5104,2013-01-01,03W,2253,1044,3297,0.6833484986351228
5105,2013-01-01,03X,466,297,763,0.6107470511140236
5106,2013-01-01,03Y,650,402,1052,0.6178707224334601
5107,2013-01-01,04C,1957,887,2844,0.6881153305203939
5108,2013-01-01,04D,1443,638,2081,0.6934166266218165
5109,2013-01-01,04E,1191,548,1739,0.6848763657274296
5110,2013-01-01,04F,1417,981,2398,0.5909090909090909
5111,2013-01-01,04G,4249,2329,6578,0.645941015506233
5112,2013-01-01,04H,781,329,1110,0.7036036036036036
5113,2013-01-01,04J,2080,1060,3140,0.6624203821656051
5114,2013-01-01,04K,1788,833,2621,0.682182373140023
5115,2013-01-01,04L,941,379,1320,0.7128787878787879
5116,2013-01-01,04M,541,251,792,0.6830808080808081
5117,2013-01-01,04N,718,342,1060,0.6773584905660377
5118,2013-01-01,04Q,929,338,1267,0.7332280978689818
5119,2013-01-01,04R,2713,1285,3998,0.6785892946473236
5120,2013-01-01,04V,2287,1103,3390,0.6746312684365782
5121,2013-01-01,04X,1328,992,2320,0.5724137931034483
5122,2013-01-01,04Y,1120,380,1500,0.7466666666666667
5123,2013-01-01,05A,2795,1453,4248,0.6579566854990584
5124,2013-01-01,05C,1241,1715,2956,0.4198240866035183
5125,2013-01-01,05D,893,461,1354,0.6595273264401772
5126,2013-01-01,05F,1274,549,1823,0.6988480526604498
5127,2013-01-01,05G,1382,501,1883,0.733935209771641
5128,2013-01-01,05H,1139,600,1739,0.6549741230592294
5129,2013-01-01,05J,1379,577,1956,0.7050102249488752
5130,2013-01-01,05L,2446,1210,3656,0.6690371991247265
5131,2013-01-01,05N,2364,676,3040,0.7776315789473685
5132,2013-01-01,05P,1376,728,2104,0.6539923954372624
5133,2013-01-01,05Q,1487,573,2060,0.7218446601941747
5134,2013-01-01,05R,2015,1045,3060,0.6584967320261438
5135,2013-01-01,05T,2122,1135,3257,0.6515198035001535
5136,2013-01-01,05V,1027,403,1430,0.7181818181818181
5137,2013-01-01,05W,1555,726,2281,0.6817185444980272
5138,2013-01-01,05X,1177,320,1497,0.7862391449565799
5139,2013-01-01,05Y,1868,888,2756,0.6777939042089985
5140,2013-01-01,06A,1686,628,2314,0.7286084701815039
5141,2013-01-01,06D,949,394,1343,0.7066269545793
5142,2013-01-01,06F,1781,2420,4201,0.42394667936205666
5143,2013-01-01,06H,5525,2852,8377,0.659543989495046
5144,2013-01-01,06K,3266,2100,5366,0.6086470368989937
5145,2013-01-01,06L,2407,1113,3520,0.6838068181818182
5146,2013-01-01,06M,1949,868,2817,0.6918707845225417
5147,2013-01-01,06N,3354,2116,5470,0.613162705667276
5148,2013-01-01,06P,879,903,1782,0.49326599326599324
5149,2013-01-01,06Q,2359,1208,3567,0.6613400616764789
5150,2013-01-01,06T,2415,1127,3542,0.6818181818181818
5151,2013-01-01,06V,1546,585,2131,0.7254809948381041
5152,2013-01-01,06W,1504,524,2028,0.7416173570019724
5153,2013-01-01,06Y,1362,531,1893,0.7194928684627575
5154,2013-01-01,07G,964,380,1344,0.7172619047619048
5155,2013-01-01,07H,1616,965,2581,0.6261139093374661
5156,2013-01-01,07J,760,407,1167,0.6512425021422451
5157,2013-01-01,07K,1497,791,2288,0.6542832167832168
5158,2013-01-01,07L,853,269,1122,0.7602495543672014
5159,2013-01-01,07M,1259,768,2027,0.6211149481993093
5160,2013-01-01,07N,1266,642,1908,0.6635220125786163
5161,2013-01-01,07P,950,487,1437,0.6610995128740431
5162,2013-01-01,07Q,1638,866,2504,0.6541533546325878
5163,2013-01-01,07R,831,537,1368,0.6074561403508771
5164,2013-01-01,07T,775,402,1177,0.6584536958368734
5165,2013-01-01,07V,1807,910,2717,0.6650717703349283
5166,2013-01-01,07W,1092,658,1750,0.624
5167,2013-01-01,07X,1249,584,1833,0.6813966175668303
5168,2013-01-01,07Y,895,615,1510,0.5927152317880795
5169,2013-01-01,08A,1268,651,1919,0.6607608129233976
5170,2013-01-01,08C,659,363,1022,0.6448140900195695
5171,2013-01-01,08D,913,562,1475,0.6189830508474576
5172,2013-01-01,08E,865,469,1334,0.6484257871064468
5173,2013-01-01,08F,1379,582,1961,0.7032126466088731
5174,2013-01-01,08G,551,1389,1940,0.284020618556701
5175,2013-01-01,08H,886,638,1524,0.5813648293963255
5176,2013-01-01,08J,917,411,1328,0.6905120481927711
5177,2013-01-01,08K,1254,550,1804,0.6951219512195121
5178,2013-01-01,08L,754,1159,1913,0.3941453214845792
5179,2013-01-01,08M,1014,371,1385,0.7321299638989169
5180,2013-01-01,08N,1172,502,1674,0.7001194743130227
5181,2013-01-01,08P,1008,536,1544,0.6528497409326425
5182,2013-01-01,08Q,1106,386,1492,0.7412868632707775
5183,2013-01-01,08R,917,426,1343,0.6827997021593447
5184,2013-01-01,08T,1020,524,1544,0.6606217616580311
5185,2013-01-01,08V,1103,439,1542,0.7153047989623865
5186,2013-01-01,08W,1203,504,1707,0.7047451669595782
5187,2013-01-01,08X,1341,630,1971,0.680365296803653
5188,2013-01-01,08Y,692,426,1118,0.6189624329159212
5189,2013-01-01,09A,532,505,1037,0.5130183220829315
5190,2013-01-01,09C,817,350,1167,0.7000856898029134
5191,2013-01-01,09D,1423,918,2341,0.607859888936352
5192,2013-01-01,09E,1580,577,2157,0.7324988409828466
5193,2013-01-01,09F,1430,686,2116,0.6758034026465028
5194,2013-01-01,09G,3410,1933,5343,0.6382182294591053
5195,2013-01-01,09H,708,304,1012,0.6996047430830039
5196,2013-01-01,09J,1752,831,2583,0.6782810685249709
5197,2013-01-01,09L,907,464,1371,0.661560904449307
5198,2013-01-01,09N,1154,686,1840,0.6271739130434782
5199,2013-01-01,09P,1187,846,2033,0.5838662075750123
5200,2013-01-01,09W,1504,706,2210,0.6805429864253394
5201,2013-01-01,09X,1127,819,1946,0.579136690647482
5202,2013-01-01,09Y,1748,1220,2968,0.5889487870619946
5203,2013-01-01,10A,1125,636,1761,0.6388415672913118
5204,2013-01-01,10C,527,332,859,0.6135040745052387
5205,2013-01-01,10D,677,200,877,0.7719498289623717
5206,2013-01-01,10E,810,340,1150,0.7043478260869566
5207,2013-01-01,10G,685,386,1071,0.6395891690009337
5208,2013-01-01,10H,1872,1167,3039,0.6159921026653504
5209,2013-01-01,10J,1109,1027,2136,0.5191947565543071
5210,2013-01-01,10K,1258,686,1944,0.647119341563786
5211,2013-01-01,10L,1021,401,1422,0.7180028129395218
5212,2013-01-01,10M,552,447,999,0.5525525525525525
5213,2013-01-01,10N,503,390,893,0.5632698768197089
5214,2013-01-01,10Q,2981,2983,5964,0.499832327297116
5215,2013-01-01,10R,1507,613,2120,0.7108490566037736
5216,2013-01-01,10T,609,322,931,0.6541353383458647
5217,2013-01-01,10V,1260,774,2034,0.6194690265486725
5218,2013-01-01,10W,647,339,986,0.6561866125760649
5219,2013-01-01,10X,1303,643,1946,0.6695786228160329
5220,2013-01-01,10Y,1273,819,2092,0.608508604206501
5221,2013-01-01,11A,3667,2105,5772,0.6353083853083853
5222,2013-01-01,11C,888,437,1325,0.670188679245283
5223,2013-01-01,11D,692,642,1334,0.5187406296851574
5224,2013-01-01,11E,1269,947,2216,0.5726534296028881
5225,2013-01-01,11H,2524,1505,4029,0.6264581782079921
5226,2013-01-01,11J,5106,2635,7741,0.6596047022348533
5227,2013-01-01,11M,3878,1866,5744,0.6751392757660167
5228,2013-01-01,11N,4387,1591,5978,0.7338574774171964
5229,2013-01-01,11T,1592,895,2487,0.640128669079212
5230,2013-01-01,11X,3511,1982,5493,0.6391771345348626
5231,2013-01-01,12A,1449,718,2167,0.6686663590216889
5232,2013-01-01,12D,1169,757,1926,0.606957424714434
5233,2013-01-01,12F,2705,635,3340,0.8098802395209581
5234,2013-01-01,13P,3131,1638,4769,0.6565317676661774
5235,2013-01-01,13T,3347,1367,4714,0.7100127280441239
5236,2013-01-01,14L,3170,1779,4949,0.640533441099212
5237,2013-01-01,99A,2905,893,3798,0.7648762506582412
5238,2013-01-01,99C,1545,721,2266,0.6818181818181818
5239,2013-01-01,99D,1081,691,1772,0.6100451467268623
5240,2013-01-01,99E,1663,600,2263,0.7348652231551038
5241,2013-01-01,99F,1113,351,1464,0.7602459016393442
5242,2013-01-01,99G,1027,353,1380,0.7442028985507246
5243,2013-01-01,99H,1667,944,2611,0.6384527001148985
5244,2013-01-01,99J,3306,1559,4865,0.6795477903391572
5245,2013-01-01,99K,1037,629,1666,0.6224489795918368
5246,2013-01-01,99M,1082,853,1935,0.5591731266149871
5247,2013-01-01,99N,2873,2464,5337,0.5383174067828368
5248,2013-01-01,99P,6790,2672,9462,0.7176072711900232
5249,2013-01-01,99Q,2083,927,3010,0.6920265780730896
5250,2013-02-01,00C,694,310,1004,0.6912350597609562
5251,2013-02-01,00D,2021,1033,3054,0.6617550753110675
5252,2013-02-01,00F,19,6,25,0.76
5253,2013-02-01,00J,1576,850,2426,0.6496290189612531
5254,2013-02-01,00K,2094,1007,3101,0.6752660432118671
5255,2013-02-01,00L,2075,1317,3392,0.6117334905660378
5256,2013-02-01,00M,2003,1030,3033,0.660402242004616
5257,2013-02-01,00N,1114,494,1608,0.6927860696517413
5258,2013-02-01,00P,1763,738,2501,0.7049180327868853
5259,2013-02-01,00Q,877,335,1212,0.7235973597359736
5260,2013-02-01,00R,1117,496,1613,0.6924984500929944
5261,2013-02-01,00T,1734,979,2713,0.6391448580906746
5262,2013-02-01,00V,1292,626,1918,0.6736183524504692
5263,2013-02-01,00W,62,24,86,0.7209302325581395
5264,2013-02-01,00X,892,241,1133,0.7872903795233892
5265,2013-02-01,00Y,1645,781,2426,0.6780708985985161
5266,2013-02-01,01A,2236,1149,3385,0.6605612998522895
5267,2013-02-01,01C,1124,691,1815,0.6192837465564738
5268,2013-02-01,01D,1408,622,2030,0.6935960591133005
5269,2013-02-01,01E,1087,171,1258,0.8640699523052464
5270,2013-02-01,01F,902,450,1352,0.6671597633136095
5271,2013-02-01,01G,1324,1023,2347,0.5641244141457179
5272,2013-02-01,01H,2244,812,3056,0.7342931937172775
5273,2013-02-01,01J,1011,458,1469,0.6882232811436352
5274,2013-02-01,01K,1926,1014,2940,0.6551020408163265
5275,2013-02-01,01N,18,19,37,0.4864864864864865
5276,2013-02-01,01R,892,522,1414,0.6308345120226309
5277,2013-02-01,01T,761,400,1161,0.6554694229112834
5278,2013-02-01,01V,763,335,1098,0.6948998178506375
5279,2013-02-01,01W,1789,763,2552,0.7010188087774295
5280,2013-02-01,01X,1387,626,2013,0.6890213611525087
5281,2013-02-01,01Y,1235,654,1889,0.6537850714663843
5282,2013-02-01,02A,1216,753,1969,0.6175723717623159
5283,2013-02-01,02D,519,395,914,0.5678336980306345
5284,2013-02-01,02E,1136,440,1576,0.7208121827411168
5285,2013-02-01,02F,1521,587,2108,0.7215370018975332
5286,2013-02-01,02G,561,302,863,0.6500579374275782
5287,2013-02-01,02H,1686,1244,2930,0.5754266211604095
5288,2013-02-01,02M,948,353,1301,0.7286702536510377
5289,2013-02-01,02N,835,578,1413,0.5909412597310687
5290,2013-02-01,02P,1198,981,2179,0.5497934832491969
5291,2013-02-01,02Q,556,463,1019,0.5456329735034348
5292,2013-02-01,02R,1829,1019,2848,0.6422050561797753
5293,2013-02-01,02T,1082,616,1698,0.6372202591283863
5294,2013-02-01,02V,1209,627,1836,0.6584967320261438
5295,2013-02-01,02W,559,241,800,0.69875
5296,2013-02-01,02X,1714,1006,2720,0.6301470588235294
5297,2013-02-01,02Y,1849,822,2671,0.6922500935979035
5298,2013-02-01,03A,1145,532,1677,0.6827668455575432
5299,2013-02-01,03C,1745,929,2674,0.6525804038893044
5300,2013-02-01,03D,724,328,1052,0.688212927756654
5301,2013-02-01,03E,794,505,1299,0.611239414934565
5302,2013-02-01,03F,1464,531,1995,0.7338345864661654
5303,2013-02-01,03G,1475,679,2154,0.6847725162488394
5304,2013-02-01,03H,1099,413,1512,0.7268518518518519
5305,2013-02-01,03J,1046,387,1433,0.729937194696441
5306,2013-02-01,03K,884,254,1138,0.7768014059753954
5307,2013-02-01,03L,1184,854,2038,0.5809617271835132
5308,2013-02-01,03M,692,397,1089,0.63544536271809
5309,2013-02-01,03N,2933,830,3763,0.779431304809992
5310,2013-02-01,03Q,1805,982,2787,0.6476498026551848
5311,2013-02-01,03R,2235,959,3194,0.6997495303694427
5312,2013-02-01,03T,1747,666,2413,0.7239950269374223
5313,2013-02-01,03V,385,215,600,0.6416666666666667
5314,2013-02-01,03W,2039,930,2969,0.6867632199393735
5315,2013-02-01,03X,368,246,614,0.5993485342019544
5316,2013-02-01,03Y,660,320,980,0.673469387755102
5317,2013-02-01,04C,1745,831,2576,0.6774068322981367
5318,2013-02-01,04D,1343,647,1990,0.6748743718592964
5319,2013-02-01,04E,1075,533,1608,0.6685323383084577
5320,2013-02-01,04F,1413,877,2290,0.6170305676855895
5321,2013-02-01,04G,3716,2123,5839,0.6364103442370269
5322,2013-02-01,04H,665,308,973,0.6834532374100719
5323,2013-02-01,04J,1808,910,2718,0.6651949963208241
5324,2013-02-01,04K,1574,775,2349,0.6700723712217965
5325,2013-02-01,04L,792,350,1142,0.6935201401050788
5326,2013-02-01,04M,531,211,742,0.715633423180593
5327,2013-02-01,04N,619,297,916,0.675764192139738
5328,2013-02-01,04Q,824,315,1139,0.723441615452151
5329,2013-02-01,04R,2414,1217,3631,0.6648306251721289
5330,2013-02-01,04V,2033,956,2989,0.6801605888256942
5331,2013-02-01,04X,1209,876,2085,0.5798561151079137
5332,2013-02-01,04Y,956,346,1302,0.7342549923195084
5333,2013-02-01,05A,2557,1212,3769,0.678429291589281
5334,2013-02-01,05C,1084,1565,2649,0.4092110230275576
5335,2013-02-01,05D,778,403,1181,0.6587637595258256
5336,2013-02-01,05F,1162,467,1629,0.7133210558624923
5337,2013-02-01,05G,1317,503,1820,0.7236263736263736
5338,2013-02-01,05H,1044,560,1604,0.6508728179551122
5339,2013-02-01,05J,1311,494,1805,0.7263157894736842
5340,2013-02-01,05L,2230,1115,3345,0.6666666666666666
5341,2013-02-01,05N,1990,655,2645,0.7523629489603024
5342,2013-02-01,05P,1228,676,1904,0.6449579831932774
5343,2013-02-01,05Q,1272,514,1786,0.7122060470324748
5344,2013-02-01,05R,1729,991,2720,0.6356617647058823
5345,2013-02-01,05T,1952,984,2936,0.6648501362397821
5346,2013-02-01,05V,926,381,1307,0.7084927314460597
5347,2013-02-01,05W,1438,601,2039,0.7052476704266798
5348,2013-02-01,05X,1065,354,1419,0.7505285412262156
5349,2013-02-01,05Y,1554,809,2363,0.6576385950063479
5350,2013-02-01,06A,1436,606,2042,0.703232125367287
5351,2013-02-01,06D,825,354,1179,0.6997455470737913
5352,2013-02-01,06F,1588,2198,3786,0.41944004226096143
5353,2013-02-01,06H,4884,2582,7466,0.65416555049558
5354,2013-02-01,06K,2807,1952,4759,0.5898297961756671
5355,2013-02-01,06L,2240,1032,3272,0.684596577017115
5356,2013-02-01,06M,1755,794,2549,0.6885052961945861
5357,2013-02-01,06N,3075,1829,4904,0.6270391517128875
5358,2013-02-01,06P,759,738,1497,0.5070140280561122
5359,2013-02-01,06Q,2220,1107,3327,0.6672678088367899
5360,2013-02-01,06T,2132,1051,3183,0.66980835689601
5361,2013-02-01,06V,1360,570,1930,0.7046632124352331
5362,2013-02-01,06W,1304,502,1806,0.7220376522702104
5363,2013-02-01,06Y,1265,457,1722,0.7346109175377468
5364,2013-02-01,07G,921,342,1263,0.7292161520190024
5365,2013-02-01,07H,1414,865,2279,0.620447564721369
5366,2013-02-01,07J,717,425,1142,0.62784588441331
5367,2013-02-01,07K,1371,706,2077,0.660086663456909
5368,2013-02-01,07L,690,251,941,0.7332624867162593
5369,2013-02-01,07M,1095,683,1778,0.6158605174353206
5370,2013-02-01,07N,1174,581,1755,0.6689458689458689
5371,2013-02-01,07P,849,461,1310,0.6480916030534352
5372,2013-02-01,07Q,1375,773,2148,0.6401303538175046
5373,2013-02-01,07R,727,461,1188,0.6119528619528619
5374,2013-02-01,07T,654,362,1016,0.6437007874015748
5375,2013-02-01,07V,1671,771,2442,0.6842751842751843
5376,2013-02-01,07W,941,700,1641,0.5734308348567947
5377,2013-02-01,07X,1128,536,1664,0.6778846153846154
5378,2013-02-01,07Y,778,516,1294,0.6012364760432767
5379,2013-02-01,08A,1148,573,1721,0.6670540383497966
5380,2013-02-01,08C,603,373,976,0.617827868852459
5381,2013-02-01,08D,788,511,1299,0.6066204772902233
5382,2013-02-01,08E,749,413,1162,0.6445783132530121
5383,2013-02-01,08F,1171,536,1707,0.6859988283538372
5384,2013-02-01,08G,522,1197,1719,0.3036649214659686
5385,2013-02-01,08H,698,503,1201,0.5811823480432973
5386,2013-02-01,08J,788,331,1119,0.7042001787310098
5387,2013-02-01,08K,1122,491,1613,0.6955982641041537
5388,2013-02-01,08L,607,1087,1694,0.35832349468713104
5389,2013-02-01,08M,864,272,1136,0.7605633802816901
5390,2013-02-01,08N,1045,420,1465,0.7133105802047781
5391,2013-02-01,08P,825,479,1304,0.6326687116564417
5392,2013-02-01,08Q,961,383,1344,0.7150297619047619
5393,2013-02-01,08R,845,423,1268,0.666403785488959
5394,2013-02-01,08T,982,473,1455,0.6749140893470791
5395,2013-02-01,08V,1008,358,1366,0.7379209370424598
5396,2013-02-01,08W,984,396,1380,0.7130434782608696
5397,2013-02-01,08X,1156,576,1732,0.6674364896073903
5398,2013-02-01,08Y,699,437,1136,0.6153169014084507
5399,2013-02-01,09A,543,425,968,0.5609504132231405
5400,2013-02-01,09C,679,316,995,0.6824120603015076
5401,2013-02-01,09D,1409,879,2288,0.6158216783216783
5402,2013-02-01,09E,1350,546,1896,0.7120253164556962
5403,2013-02-01,09F,1226,634,1860,0.6591397849462366
5404,2013-02-01,09G,3066,1782,4848,0.6324257425742574
5405,2013-02-01,09H,604,300,904,0.668141592920354
5406,2013-02-01,09J,1468,755,2223,0.6603688708951867
5407,2013-02-01,09L,814,417,1231,0.661251015434606
5408,2013-02-01,09N,983,570,1553,0.6329684481648422
5409,2013-02-01,09P,988,729,1717,0.5754222481071637
5410,2013-02-01,09W,1397,592,1989,0.7023629964806435
5411,2013-02-01,09X,999,732,1731,0.5771230502599654
5412,2013-02-01,09Y,1540,1052,2592,0.5941358024691358
5413,2013-02-01,10A,1039,624,1663,0.6247745039085989
5414,2013-02-01,10C,452,220,672,0.6726190476190477
5415,2013-02-01,10D,646,185,831,0.7773766546329723
5416,2013-02-01,10E,708,305,1013,0.6989141164856861
5417,2013-02-01,10G,609,371,980,0.6214285714285714
5418,2013-02-01,10H,1567,1024,2591,0.6047857969895793
5419,2013-02-01,10J,963,883,1846,0.5216684723726978
5420,2013-02-01,10K,1171,622,1793,0.6530953708867819
5421,2013-02-01,10L,964,359,1323,0.7286470143613001
5422,2013-02-01,10M,514,394,908,0.566079295154185
5423,2013-02-01,10N,397,368,765,0.5189542483660131
5424,2013-02-01,10Q,2706,2709,5415,0.4997229916897507
5425,2013-02-01,10R,1227,545,1772,0.6924379232505643
5426,2013-02-01,10T,543,289,832,0.6526442307692307
5427,2013-02-01,10V,1098,626,1724,0.6368909512761021
5428,2013-02-01,10W,548,324,872,0.6284403669724771
5429,2013-02-01,10X,1107,611,1718,0.6443538998835856
5430,2013-02-01,10Y,1177,717,1894,0.6214361140443506
5431,2013-02-01,11A,3110,1899,5009,0.6208824116590138
5432,2013-02-01,11C,804,377,1181,0.68077900084674
5433,2013-02-01,11D,599,538,1137,0.5268249780123131
5434,2013-02-01,11E,1220,881,2101,0.5806758686339838
5435,2013-02-01,11H,2311,1323,3634,0.6359383599339571
5436,2013-02-01,11J,4477,2299,6776,0.6607142857142857
5437,2013-02-01,11M,3615,1705,5320,0.6795112781954887
5438,2013-02-01,11N,3769,1369,5138,0.7335539120280264
5439,2013-02-01,11T,1355,796,2151,0.6299395629939563
5440,2013-02-01,11X,3140,1750,4890,0.6421267893660532
5441,2013-02-01,12A,1402,692,2094,0.6695319961795606
5442,2013-02-01,12D,1071,599,1670,0.641317365269461
5443,2013-02-01,12F,2305,579,2884,0.7992371705963939
5444,2013-02-01,13P,2812,1443,4255,0.6608695652173913
5445,2013-02-01,13T,2875,1267,4142,0.6941091260260743
5446,2013-02-01,14L,2761,1629,4390,0.6289293849658314
5447,2013-02-01,99A,2534,784,3318,0.7637130801687764
5448,2013-02-01,99C,1386,677,2063,0.671837130392632
5449,2013-02-01,99D,902,583,1485,0.6074074074074074
5450,2013-02-01,99E,1367,513,1880,0.7271276595744681
5451,2013-02-01,99F,1031,325,1356,0.7603244837758112
5452,2013-02-01,99G,902,301,1203,0.7497921862011637
5453,2013-02-01,99H,1418,839,2257,0.6282676118741692
5454,2013-02-01,99J,2874,1339,4213,0.6821742226441966
5455,2013-02-01,99K,865,588,1453,0.5953200275292498
5456,2013-02-01,99M,932,713,1645,0.5665653495440729
5457,2013-02-01,99N,2482,2243,4725,0.5252910052910053
5458,2013-02-01,99P,5865,2331,8196,0.7155929721815519
5459,2013-02-01,99Q,1791,802,2593,0.6907057462398766
5460,2013-03-01,00C,754,334,1088,0.6930147058823529
5461,2013-03-01,00D,2042,1124,3166,0.6449778900821226
5462,2013-03-01,00F,17,7,24,0.7083333333333334
5463,2013-03-01,00J,1670,887,2557,0.6531091122409073
5464,2013-03-01,00K,2141,1034,3175,0.6743307086614173
5465,2013-03-01,00L,2212,1355,3567,0.6201289599102887
5466,2013-03-01,00M,2018,1013,3031,0.6657868690201254
5467,2013-03-01,00N,1120,585,1705,0.656891495601173
5468,2013-03-01,00P,1906,764,2670,0.7138576779026217
5469,2013-03-01,00Q,904,364,1268,0.7129337539432177
5470,2013-03-01,00R,1168,464,1632,0.7156862745098039
5471,2013-03-01,00T,1827,1084,2911,0.6276193747852972
5472,2013-03-01,00V,1328,691,2019,0.657751362060426
5473,2013-03-01,00W,57,20,77,0.7402597402597403
5474,2013-03-01,00X,937,253,1190,0.7873949579831933
5475,2013-03-01,00Y,1614,777,2391,0.6750313676286073
5476,2013-03-01,01A,2353,1230,3583,0.6567122523025398
5477,2013-03-01,01C,1190,672,1862,0.6390977443609023
5478,2013-03-01,01D,1517,666,2183,0.6949152542372882
5479,2013-03-01,01E,1094,186,1280,0.8546875
5480,2013-03-01,01F,864,476,1340,0.6447761194029851
5481,2013-03-01,01G,1255,1001,2256,0.5562943262411347
5482,2013-03-01,01H,2341,853,3194,0.7329367564182843
5483,2013-03-01,01J,918,479,1397,0.6571224051539012
5484,2013-03-01,01K,1969,1074,3043,0.6470588235294118
5485,2013-03-01,01N,12,19,31,0.3870967741935484
5486,2013-03-01,01R,974,563,1537,0.6337020169160703
5487,2013-03-01,01T,818,407,1225,0.6677551020408163
5488,2013-03-01,01V,775,331,1106,0.7007233273056058
5489,2013-03-01,01W,1897,849,2746,0.6908230152949745
5490,2013-03-01,01X,1432,620,2052,0.6978557504873294
5491,2013-03-01,01Y,1215,699,1914,0.6347962382445141
5492,2013-03-01,02A,1216,715,1931,0.6297255308130503
5493,2013-03-01,02D,512,385,897,0.5707915273132664
5494,2013-03-01,02E,1137,487,1624,0.7001231527093597
5495,2013-03-01,02F,1556,534,2090,0.7444976076555024
5496,2013-03-01,02G,577,333,910,0.634065934065934
5497,2013-03-01,02H,1648,1206,2854,0.5774351786965662
5498,2013-03-01,02M,1064,360,1424,0.7471910112359551
5499,2013-03-01,02N,937,608,1545,0.6064724919093851
5500,2013-03-01,02P,1134,1064,2198,0.5159235668789809
5501,2013-03-01,02Q,561,459,1020,0.55
5502,2013-03-01,02R,1944,1042,2986,0.6510381781647689
5503,2013-03-01,02T,1062,667,1729,0.6142278773857721
5504,2013-03-01,02V,1239,645,1884,0.6576433121019108
5505,2013-03-01,02W,541,281,822,0.6581508515815085
5506,2013-03-01,02X,1850,928,2778,0.665946724262059
5507,2013-03-01,02Y,1856,831,2687,0.6907331596576107
5508,2013-03-01,03A,1035,581,1616,0.6404702970297029
5509,2013-03-01,03C,1800,945,2745,0.6557377049180327
5510,2013-03-01,03D,885,366,1251,0.7074340527577938
5511,2013-03-01,03E,841,495,1336,0.6294910179640718
5512,2013-03-01,03F,1534,616,2150,0.7134883720930233
5513,2013-03-01,03G,1550,652,2202,0.703905540417802
5514,2013-03-01,03H,1217,443,1660,0.733132530120482
5515,2013-03-01,03J,1109,403,1512,0.7334656084656085
5516,2013-03-01,03K,983,292,1275,0.7709803921568628
5517,2013-03-01,03L,1164,871,2035,0.571990171990172
5518,2013-03-01,03M,795,457,1252,0.6349840255591054
5519,2013-03-01,03N,3089,798,3887,0.7947002829945974
5520,2013-03-01,03Q,1760,929,2689,0.6545184083302343
5521,2013-03-01,03R,2213,986,3199,0.6917786808377618
5522,2013-03-01,03T,1796,655,2451,0.7327621379028968
5523,2013-03-01,03V,369,238,607,0.6079077429983526
5524,2013-03-01,03W,2113,1060,3173,0.6659312953041285
5525,2013-03-01,03X,389,234,623,0.6243980738362761
5526,2013-03-01,03Y,695,363,1058,0.6568998109640832
5527,2013-03-01,04C,1849,754,2603,0.7103342297349212
5528,2013-03-01,04D,1242,617,1859,0.6681011296395912
5529,2013-03-01,04E,1050,498,1548,0.6782945736434108
5530,2013-03-01,04F,1445,914,2359,0.612547689699025
5531,2013-03-01,04G,3810,2086,5896,0.6462008141112618
5532,2013-03-01,04H,685,327,1012,0.6768774703557312
5533,2013-03-01,04J,1831,975,2806,0.6525302922309337
5534,2013-03-01,04K,1604,786,2390,0.6711297071129707
5535,2013-03-01,04L,771,360,1131,0.6816976127320955
5536,2013-03-01,04M,515,211,726,0.709366391184573
5537,2013-03-01,04N,639,289,928,0.6885775862068966
5538,2013-03-01,04Q,817,364,1181,0.6917866215071973
5539,2013-03-01,04R,2499,1166,3665,0.6818553888130968
5540,2013-03-01,04V,2105,960,3065,0.6867862969004894
5541,2013-03-01,04X,1315,964,2279,0.5770074594120228
5542,2013-03-01,04Y,964,367,1331,0.724267468069121
5543,2013-03-01,05A,2635,1343,3978,0.6623931623931624
5544,2013-03-01,05C,1177,1524,2701,0.4357645316549426
5545,2013-03-01,05D,799,389,1188,0.6725589225589226
5546,2013-03-01,05F,1132,555,1687,0.6710136336692353
5547,2013-03-01,05G,1196,494,1690,0.7076923076923077
5548,2013-03-01,05H,1079,560,1639,0.6583282489322758
5549,2013-03-01,05J,1352,579,1931,0.7001553599171414
5550,2013-03-01,05L,2329,1095,3424,0.6801985981308412
5551,2013-03-01,05N,2074,654,2728,0.7602639296187683
5552,2013-03-01,05P,1254,703,1957,0.6407766990291263
5553,2013-03-01,05Q,1349,527,1876,0.7190831556503199
5554,2013-03-01,05R,1800,992,2792,0.6446991404011462
5555,2013-03-01,05T,1908,996,2904,0.6570247933884298
5556,2013-03-01,05V,882,379,1261,0.6994448850118953
5557,2013-03-01,05W,1437,675,2112,0.6803977272727273
5558,2013-03-01,05X,1078,378,1456,0.7403846153846154
5559,2013-03-01,05Y,1576,817,2393,0.6585875470121186
5560,2013-03-01,06A,1486,579,2065,0.7196125907990315
5561,2013-03-01,06D,834,344,1178,0.7079796264855688
5562,2013-03-01,06F,1596,2185,3781,0.4221105527638191
5563,2013-03-01,06H,4985,2585,7570,0.6585204755614267
5564,2013-03-01,06K,3106,2072,5178,0.5998455001931248
5565,2013-03-01,06L,2337,1081,3418,0.6837331772966647
5566,2013-03-01,06M,1777,839,2616,0.6792813455657493
5567,2013-03-01,06N,3081,1885,4966,0.6204188481675392
5568,2013-03-01,06P,817,810,1627,0.5021511985248924
5569,2013-03-01,06Q,2212,1201,3413,0.6481101670084969
5570,2013-03-01,06T,2145,1145,3290,0.6519756838905775
5571,2013-03-01,06V,1330,542,1872,0.7104700854700855
5572,2013-03-01,06W,1460,476,1936,0.7541322314049587
5573,2013-03-01,06Y,1261,542,1803,0.6993899057127011
5574,2013-03-01,07G,844,314,1158,0.7288428324697754
5575,2013-03-01,07H,1465,913,2378,0.6160639192598822
5576,2013-03-01,07J,692,449,1141,0.6064855390008764
5577,2013-03-01,07K,1447,757,2204,0.6565335753176044
5578,2013-03-01,07L,697,274,971,0.717816683831102
5579,2013-03-01,07M,1165,717,1882,0.6190223166843783
5580,2013-03-01,07N,1132,637,1769,0.6399095534200113
5581,2013-03-01,07P,869,462,1331,0.6528925619834711
5582,2013-03-01,07Q,1449,862,2311,0.6270012981393336
5583,2013-03-01,07R,684,522,1206,0.5671641791044776
5584,2013-03-01,07T,613,393,1006,0.6093439363817097
5585,2013-03-01,07V,1713,826,2539,0.6746750689247736
5586,2013-03-01,07W,979,654,1633,0.5995101041028781
5587,2013-03-01,07X,1225,554,1779,0.6885890949971895
5588,2013-03-01,07Y,828,525,1353,0.6119733924611973
5589,2013-03-01,08A,1144,652,1796,0.6369710467706013
5590,2013-03-01,08C,605,370,975,0.6205128205128205
5591,2013-03-01,08D,808,490,1298,0.6224961479198767
5592,2013-03-01,08E,852,478,1330,0.6406015037593985
5593,2013-03-01,08F,1220,568,1788,0.6823266219239373
5594,2013-03-01,08G,577,1196,1773,0.3254371122391427
5595,2013-03-01,08H,786,542,1328,0.5918674698795181
5596,2013-03-01,08J,776,375,1151,0.6741963509991312
5597,2013-03-01,08K,1055,519,1574,0.670266836086404
5598,2013-03-01,08L,620,1084,1704,0.36384976525821594
5599,2013-03-01,08M,991,327,1318,0.7518968133535661
5600,2013-03-01,08N,1080,406,1486,0.7267833109017496
5601,2013-03-01,08P,894,492,1386,0.645021645021645
5602,2013-03-01,08Q,1021,351,1372,0.7441690962099126
5603,2013-03-01,08R,839,405,1244,0.6744372990353698
5604,2013-03-01,08T,959,479,1438,0.6668984700973575
5605,2013-03-01,08V,956,370,1326,0.7209653092006033
5606,2013-03-01,08W,971,431,1402,0.6925820256776034
5607,2013-03-01,08X,1191,571,1762,0.6759364358683314
5608,2013-03-01,08Y,680,427,1107,0.6142728093947606
5609,2013-03-01,09A,525,446,971,0.5406797116374872
5610,2013-03-01,09C,695,331,1026,0.6773879142300195
5611,2013-03-01,09D,1437,973,2410,0.5962655601659751
5612,2013-03-01,09E,1455,549,2004,0.7260479041916168
5613,2013-03-01,09F,1254,637,1891,0.6631411951348493
5614,2013-03-01,09G,3250,1814,5064,0.641785150078989
5615,2013-03-01,09H,624,305,929,0.6716899892357373
5616,2013-03-01,09J,1567,836,2403,0.6521015397419891
5617,2013-03-01,09L,721,459,1180,0.6110169491525423
5618,2013-03-01,09N,1046,604,1650,0.6339393939393939
5619,2013-03-01,09P,1052,795,1847,0.5695722793719545
5620,2013-03-01,09W,1340,576,1916,0.6993736951983298
5621,2013-03-01,09X,1079,759,1838,0.5870511425462459
5622,2013-03-01,09Y,1672,1121,2793,0.5986394557823129
5623,2013-03-01,10A,1066,642,1708,0.6241217798594848
5624,2013-03-01,10C,441,250,691,0.638205499276411
5625,2013-03-01,10D,585,211,796,0.7349246231155779
5626,2013-03-01,10E,757,304,1061,0.7134778510838832
5627,2013-03-01,10G,616,338,954,0.6457023060796646
5628,2013-03-01,10H,1765,1089,2854,0.6184302733006307
5629,2013-03-01,10J,1010,924,1934,0.5222337125129266
5630,2013-03-01,10K,1129,619,1748,0.6458810068649885
5631,2013-03-01,10L,890,363,1253,0.7102952913008779
5632,2013-03-01,10M,530,394,924,0.5735930735930735
5633,2013-03-01,10N,417,370,787,0.5298602287166455
5634,2013-03-01,10Q,2823,2776,5599,0.5041971780675121
5635,2013-03-01,10R,1324,479,1803,0.7343316694398225
5636,2013-03-01,10T,552,311,863,0.6396292004634995
5637,2013-03-01,10V,1135,719,1854,0.6121898597626753
5638,2013-03-01,10W,576,339,915,0.6295081967213115
5639,2013-03-01,10X,1162,651,1813,0.640926640926641
5640,2013-03-01,10Y,1171,735,1906,0.6143756558237146
5641,2013-03-01,11A,3413,1839,5252,0.6498476770753998
5642,2013-03-01,11C,852,424,1276,0.6677115987460815
5643,2013-03-01,11D,673,560,1233,0.545823195458232
5644,2013-03-01,11E,1114,960,2074,0.5371263259402121
5645,2013-03-01,11H,2367,1379,3746,0.6318739989321943
5646,2013-03-01,11J,4653,2488,7141,0.6515894132474443
5647,2013-03-01,11M,3609,1850,5459,0.661110093423704
5648,2013-03-01,11N,3988,1531,5519,0.7225946729479978
5649,2013-03-01,11T,1410,871,2281,0.6181499342393687
5650,2013-03-01,11X,3210,1913,5123,0.6265859847745462
5651,2013-03-01,12A,1356,691,2047,0.6624328285295554
5652,2013-03-01,12D,1002,697,1699,0.5897586815773985
5653,2013-03-01,12F,2267,573,2840,0.7982394366197183
5654,2013-03-01,13P,2920,1569,4489,0.6504789485408777
5655,2013-03-01,13T,3084,1307,4391,0.7023457071282168
5656,2013-03-01,14L,2836,1646,4482,0.6327532351628737
5657,2013-03-01,99A,2587,796,3383,0.7647058823529411
5658,2013-03-01,99C,1410,672,2082,0.6772334293948127
5659,2013-03-01,99D,1067,689,1756,0.607630979498861
5660,2013-03-01,99E,1365,537,1902,0.7176656151419558
5661,2013-03-01,99F,965,325,1290,0.748062015503876
5662,2013-03-01,99G,920,331,1251,0.7354116706634692
5663,2013-03-01,99H,1463,900,2363,0.6191282268303004
5664,2013-03-01,99J,3092,1414,4506,0.686196182867288
5665,2013-03-01,99K,912,576,1488,0.6129032258064516
5666,2013-03-01,99M,930,752,1682,0.5529131985731273
5667,2013-03-01,99N,2693,2303,4996,0.539031224979984
5668,2013-03-01,99P,6127,2275,8402,0.7292311354439419
5669,2013-03-01,99Q,1747,847,2594,0.6734772552043177
5670,2013-04-01,00C,658,298,956,0.6882845188284519
5671,2013-04-01,00D,2041,1161,3202,0.6374141161773891
5672,2013-04-01,00F,10,2,12,0.8333333333333334
5673,2013-04-01,00J,1592,881,2473,0.6437525272947837
5674,2013-04-01,00K,2073,1123,3196,0.6486232790988736
5675,2013-04-01,00L,2165,1326,3491,0.6201661415067315
5676,2013-04-01,00M,2017,978,2995,0.6734557595993322
5677,2013-04-01,00N,1150,559,1709,0.6729081334113517
5678,2013-04-01,00P,1874,766,2640,0.7098484848484848
5679,2013-04-01,00Q,901,383,1284,0.7017133956386293
5680,2013-04-01,00R,1156,463,1619,0.7140210006176653
5681,2013-04-01,00T,1759,1068,2827,0.6222143615139724
5682,2013-04-01,00V,1343,666,2009,0.6684917869586859
5683,2013-04-01,00W,63,18,81,0.7777777777777778
5684,2013-04-01,00X,957,262,1219,0.7850697292863003
5685,2013-04-01,00Y,1760,916,2676,0.6576980568011959
5686,2013-04-01,01A,2326,1295,3621,0.6423639878486606
5687,2013-04-01,01C,1162,685,1847,0.6291283161884137
5688,2013-04-01,01D,1359,680,2039,0.6665031878371751
5689,2013-04-01,01E,1149,177,1326,0.8665158371040724
5690,2013-04-01,01F,854,514,1368,0.6242690058479532
5691,2013-04-01,01G,1393,1067,2460,0.566260162601626
5692,2013-04-01,01H,2302,849,3151,0.730561726436052
5693,2013-04-01,01J,844,469,1313,0.6428027418126429
5694,2013-04-01,01K,2162,1137,3299,0.6553501060927553
5695,2013-04-01,01N,11,21,32,0.34375
5696,2013-04-01,01R,899,538,1437,0.6256089074460682
5697,2013-04-01,01T,735,444,1179,0.6234096692111959
5698,2013-04-01,01V,798,337,1135,0.7030837004405286
5699,2013-04-01,01W,1937,853,2790,0.6942652329749104
5700,2013-04-01,01X,1349,691,2040,0.6612745098039216
5701,2013-04-01,01Y,1294,721,2015,0.6421836228287842
5702,2013-04-01,02A,1271,689,1960,0.648469387755102
5703,2013-04-01,02D,472,409,881,0.5357548240635641
5704,2013-04-01,02E,1182,490,1672,0.7069377990430622
5705,2013-04-01,02F,1569,673,2242,0.699821587867975
5706,2013-04-01,02G,556,344,900,0.6177777777777778
5707,2013-04-01,02H,1704,1288,2992,0.56951871657754
5708,2013-04-01,02M,971,396,1367,0.7103145574250183
5709,2013-04-01,02N,912,632,1544,0.5906735751295337
5710,2013-04-01,02P,1149,1127,2276,0.5048330404217927
5711,2013-04-01,02Q,580,457,1037,0.5593056894889104
5712,2013-04-01,02R,1984,1111,3095,0.6410339256865912
5713,2013-04-01,02T,1035,691,1726,0.5996523754345308
5714,2013-04-01,02V,1288,635,1923,0.6697867914716589
5715,2013-04-01,02W,540,291,831,0.6498194945848376
5716,2013-04-01,02X,1734,997,2731,0.6349322592456975
5717,2013-04-01,02Y,1900,871,2771,0.6856730422230242
5718,2013-04-01,03A,1244,544,1788,0.6957494407158836
5719,2013-04-01,03C,1758,1017,2775,0.6335135135135135
5720,2013-04-01,03D,798,380,1178,0.6774193548387096
5721,2013-04-01,03E,878,456,1334,0.6581709145427287
5722,2013-04-01,03F,1538,621,2159,0.7123668364983788
5723,2013-04-01,03G,1559,693,2252,0.6922735346358793
5724,2013-04-01,03H,1206,441,1647,0.73224043715847
5725,2013-04-01,03J,1118,497,1615,0.6922600619195046
5726,2013-04-01,03K,922,275,1197,0.7702589807852965
5727,2013-04-01,03L,1183,895,2078,0.5692974013474494
5728,2013-04-01,03M,819,415,1234,0.6636952998379254
5729,2013-04-01,03N,3089,821,3910,0.7900255754475703
5730,2013-04-01,03Q,1749,932,2681,0.6523685192092503
5731,2013-04-01,03R,2214,1061,3275,0.676030534351145
5732,2013-04-01,03T,1718,680,2398,0.7164303586321935
5733,2013-04-01,03V,390,221,611,0.6382978723404256
5734,2013-04-01,03W,2099,1001,3100,0.6770967741935484
5735,2013-04-01,03X,437,221,658,0.6641337386018237
5736,2013-04-01,03Y,632,361,993,0.6364551863041289
5737,2013-04-01,04C,1811,793,2604,0.695468509984639
5738,2013-04-01,04D,1365,634,1999,0.6828414207103551
5739,2013-04-01,04E,1101,575,1676,0.6569212410501193
5740,2013-04-01,04F,1368,922,2290,0.5973799126637555
5741,2013-04-01,04G,3844,2286,6130,0.6270799347471452
5742,2013-04-01,04H,634,331,965,0.6569948186528497
5743,2013-04-01,04J,1886,987,2873,0.6564566655064392
5744,2013-04-01,04K,1659,709,2368,0.7005912162162162
5745,2013-04-01,04L,789,362,1151,0.685490877497828
5746,2013-04-01,04M,530,212,742,0.7142857142857143
5747,2013-04-01,04N,636,303,939,0.6773162939297125
5748,2013-04-01,04Q,841,341,1182,0.7115059221658206
5749,2013-04-01,04R,2515,1205,3720,0.6760752688172043
5750,2013-04-01,04V,2091,1059,3150,0.6638095238095238
5751,2013-04-01,04X,1336,917,2253,0.5929871282734133
5752,2013-04-01,04Y,977,307,1284,0.7609034267912772
5753,2013-04-01,05A,2620,1409,4029,0.6502854306279474
5754,2013-04-01,05C,1160,1638,2798,0.4145818441744103
5755,2013-04-01,05D,909,427,1336,0.6803892215568862
5756,2013-04-01,05F,1225,547,1772,0.6913092550790068
5757,2013-04-01,05G,1388,585,1973,0.7034972123669538
5758,2013-04-01,05H,1088,587,1675,0.6495522388059701
5759,2013-04-01,05J,1399,547,1946,0.7189105858170607
5760,2013-04-01,05L,2461,1157,3618,0.6802100608070757
5761,2013-04-01,05N,2194,686,2880,0.7618055555555555
5762,2013-04-01,05P,1282,745,2027,0.6324617661568821
5763,2013-04-01,05Q,1306,569,1875,0.6965333333333333
5764,2013-04-01,05R,1742,1034,2776,0.627521613832853
5765,2013-04-01,05T,1978,989,2967,0.6666666666666666
5766,2013-04-01,05V,960,391,1351,0.7105847520355293
5767,2013-04-01,05W,1494,674,2168,0.6891143911439115
5768,2013-04-01,05X,1073,337,1410,0.7609929078014185
5769,2013-04-01,05Y,1615,780,2395,0.6743215031315241
5770,2013-04-01,06A,1479,610,2089,0.7079942556247009
5771,2013-04-01,06D,840,338,1178,0.7130730050933786
5772,2013-04-01,06F,1540,2201,3741,0.4116546377973804
5773,2013-04-01,06H,4827,2796,7623,0.633215269578906
5774,2013-04-01,06K,3057,2152,5209,0.5868688807832597
5775,2013-04-01,06L,2371,1155,3526,0.6724333522404992
5776,2013-04-01,06M,1824,823,2647,0.6890819795995466
5777,2013-04-01,06N,3114,1911,5025,0.6197014925373134
5778,2013-04-01,06P,815,847,1662,0.49037304452466907
5779,2013-04-01,06Q,2167,1159,3326,0.6515333734215274
5780,2013-04-01,06T,2242,1186,3428,0.6540256709451575
5781,2013-04-01,06V,1392,621,2013,0.6915052160953801
5782,2013-04-01,06W,1392,478,1870,0.7443850267379679
5783,2013-04-01,06Y,1225,504,1729,0.708502024291498
5784,2013-04-01,07G,859,359,1218,0.7052545155993432
5785,2013-04-01,07H,1558,942,2500,0.6232
5786,2013-04-01,07J,738,411,1149,0.6422976501305483
5787,2013-04-01,07K,1388,731,2119,0.6550259556394525
5788,2013-04-01,07L,734,278,1012,0.7252964426877471
5789,2013-04-01,07M,1218,720,1938,0.628482972136223
5790,2013-04-01,07N,1186,609,1795,0.660724233983287
5791,2013-04-01,07P,867,511,1378,0.6291727140783745
5792,2013-04-01,07Q,1427,824,2251,0.6339404709018214
5793,2013-04-01,07R,674,496,1170,0.576068376068376
5794,2013-04-01,07T,640,410,1050,0.6095238095238096
5795,2013-04-01,07V,1708,921,2629,0.6496766831494865
5796,2013-04-01,07W,1027,716,1743,0.5892139988525531
5797,2013-04-01,07X,1330,596,1926,0.6905503634475597
5798,2013-04-01,07Y,765,532,1297,0.5898226676946801
5799,2013-04-01,08A,1123,639,1762,0.6373439273552781
5800,2013-04-01,08C,593,383,976,0.6075819672131147
5801,2013-04-01,08D,852,465,1317,0.6469248291571754
5802,2013-04-01,08E,818,454,1272,0.6430817610062893
5803,2013-04-01,08F,1259,622,1881,0.6693248272195641
5804,2013-04-01,08G,539,1229,1768,0.3048642533936652
5805,2013-04-01,08H,715,490,1205,0.5933609958506224
5806,2013-04-01,08J,787,345,1132,0.6952296819787986
5807,2013-04-01,08K,1111,493,1604,0.692643391521197
5808,2013-04-01,08L,668,1049,1717,0.3890506697728596
5809,2013-04-01,08M,950,281,1231,0.7717303005686433
5810,2013-04-01,08N,1009,444,1453,0.6944253269098417
5811,2013-04-01,08P,916,450,1366,0.6705710102489019
5812,2013-04-01,08Q,977,389,1366,0.7152269399707174
5813,2013-04-01,08R,816,437,1253,0.6512370311252993
5814,2013-04-01,08T,938,492,1430,0.6559440559440559
5815,2013-04-01,08V,941,401,1342,0.7011922503725783
5816,2013-04-01,08W,983,437,1420,0.6922535211267605
5817,2013-04-01,08X,1178,599,1777,0.662915025323579
5818,2013-04-01,08Y,629,396,1025,0.6136585365853658
5819,2013-04-01,09A,527,347,874,0.602974828375286
5820,2013-04-01,09C,704,322,1026,0.6861598440545809
5821,2013-04-01,09D,1321,891,2212,0.5971971066907775
5822,2013-04-01,09E,1418,582,2000,0.709
5823,2013-04-01,09F,1339,678,2017,0.6638572136836887
5824,2013-04-01,09G,3220,1934,5154,0.6247574699262709
5825,2013-04-01,09H,667,315,982,0.6792260692464358
5826,2013-04-01,09J,1647,825,2472,0.6662621359223301
5827,2013-04-01,09L,843,423,1266,0.6658767772511849
5828,2013-04-01,09N,1086,594,1680,0.6464285714285715
5829,2013-04-01,09P,1097,851,1948,0.563141683778234
5830,2013-04-01,09W,1465,597,2062,0.7104752667313288
5831,2013-04-01,09X,1052,743,1795,0.5860724233983287
5832,2013-04-01,09Y,1564,1063,2627,0.5953559192995813
5833,2013-04-01,10A,1228,716,1944,0.6316872427983539
5834,2013-04-01,10C,512,235,747,0.6854082998661312
5835,2013-04-01,10D,641,203,844,0.759478672985782
5836,2013-04-01,10E,814,329,1143,0.7121609798775154
5837,2013-04-01,10G,605,340,945,0.6402116402116402
5838,2013-04-01,10H,1648,1052,2700,0.6103703703703703
5839,2013-04-01,10J,995,885,1880,0.5292553191489362
5840,2013-04-01,10K,1194,638,1832,0.6517467248908297
5841,2013-04-01,10L,958,356,1314,0.7290715372907154
5842,2013-04-01,10M,515,380,895,0.5754189944134078
5843,2013-04-01,10N,434,386,820,0.5292682926829269
5844,2013-04-01,10Q,2795,2734,5529,0.5055163682401881
5845,2013-04-01,10R,1318,569,1887,0.6984631690514044
5846,2013-04-01,10T,525,284,809,0.6489493201483313
5847,2013-04-01,10V,1221,667,1888,0.6467161016949152
5848,2013-04-01,10W,546,282,828,0.6594202898550725
5849,2013-04-01,10X,1186,672,1858,0.6383207750269106
5850,2013-04-01,10Y,1184,775,1959,0.6043899948953547
5851,2013-04-01,11A,3479,1962,5441,0.6394045212277155
5852,2013-04-01,11C,843,392,1235,0.682591093117409
5853,2013-04-01,11D,625,478,1103,0.5666364460562103
5854,2013-04-01,11E,1157,903,2060,0.5616504854368932
5855,2013-04-01,11H,2506,1384,3890,0.6442159383033419
5856,2013-04-01,11J,4788,2446,7234,0.6618744816145977
5857,2013-04-01,11M,3750,1803,5553,0.6753106428957321
5858,2013-04-01,11N,4109,1547,5656,0.7264851485148515
5859,2013-04-01,11T,1371,870,2241,0.6117804551539491
5860,2013-04-01,11X,3292,1966,5258,0.6260935717002662
5861,2013-04-01,12A,1476,726,2202,0.670299727520436
5862,2013-04-01,12D,1106,738,1844,0.5997830802603037
5863,2013-04-01,12F,2438,616,3054,0.7982973149967256
5864,2013-04-01,13P,3049,1602,4651,0.6555579445280585
5865,2013-04-01,13T,3089,1310,4399,0.7022050466015003
5866,2013-04-01,14L,2834,1630,4464,0.6348566308243727
5867,2013-04-01,99A,2538,809,3347,0.7582910068718255
5868,2013-04-01,99C,1442,705,2147,0.671634839310666
5869,2013-04-01,99D,1058,665,1723,0.6140452698781196
5870,2013-04-01,99E,1343,547,1890,0.7105820105820105
5871,2013-04-01,99F,1133,329,1462,0.7749658002735978
5872,2013-04-01,99G,939,331,1270,0.7393700787401575
5873,2013-04-01,99H,1484,876,2360,0.6288135593220339
5874,2013-04-01,99J,2927,1434,4361,0.6711763357028204
5875,2013-04-01,99K,939,625,1564,0.600383631713555
5876,2013-04-01,99M,1037,791,1828,0.5672866520787746
5877,2013-04-01,99N,2760,2377,5137,0.537278567257154
5878,2013-04-01,99P,6428,2322,8750,0.7346285714285714
5879,2013-04-01,99Q,1879,837,2716,0.6918262150220913
5880,2013-05-01,00C,756,351,1107,0.6829268292682927
5881,2013-05-01,00D,1991,1137,3128,0.6365089514066496
5882,2013-05-01,00F,21,6,27,0.7777777777777778
5883,2013-05-01,00J,1722,884,2606,0.6607828089025326
5884,2013-05-01,00K,2148,1065,3213,0.6685340802987861
5885,2013-05-01,00L,2290,1372,3662,0.6253413435281268
5886,2013-05-01,00M,2026,991,3017,0.6715280079549221
5887,2013-05-01,00N,1206,597,1803,0.6688851913477537
5888,2013-05-01,00P,1987,858,2845,0.6984182776801406
5889,2013-05-01,00Q,948,395,1343,0.7058823529411765
5890,2013-05-01,00R,1146,478,1624,0.7056650246305419
5891,2013-05-01,00T,1937,1091,3028,0.6396961690885072
5892,2013-05-01,00V,1288,673,1961,0.6568077511473738
5893,2013-05-01,00W,50,16,66,0.7575757575757576
5894,2013-05-01,00X,983,243,1226,0.8017944535073409
5895,2013-05-01,00Y,1727,883,2610,0.6616858237547892
5896,2013-05-01,01A,2382,1249,3631,0.6560176259983476
5897,2013-05-01,01C,1267,722,1989,0.6370035193564605
5898,2013-05-01,01D,1420,740,2160,0.6574074074074074
5899,2013-05-01,01E,1132,179,1311,0.8634630053394355
5900,2013-05-01,01F,874,521,1395,0.6265232974910394
5901,2013-05-01,01G,1432,1122,2554,0.5606891151135474
5902,2013-05-01,01H,2323,871,3194,0.7273011897307452
5903,2013-05-01,01J,897,444,1341,0.668903803131991
5904,2013-05-01,01K,2165,1169,3334,0.649370125974805
5905,2013-05-01,01N,15,21,36,0.4166666666666667
5906,2013-05-01,01R,872,554,1426,0.6115007012622721
5907,2013-05-01,01T,788,432,1220,0.6459016393442623
5908,2013-05-01,01V,776,366,1142,0.6795096322241682
5909,2013-05-01,01W,1985,896,2881,0.6889968760846928
5910,2013-05-01,01X,1403,712,2115,0.6633569739952718
5911,2013-05-01,01Y,1373,730,2103,0.6528768426058013
5912,2013-05-01,02A,1285,688,1973,0.6512924480486568
5913,2013-05-01,02D,540,405,945,0.5714285714285714
5914,2013-05-01,02E,1242,524,1766,0.7032842582106456
5915,2013-05-01,02F,1536,630,2166,0.7091412742382271
5916,2013-05-01,02G,550,365,915,0.6010928961748634
5917,2013-05-01,02H,1683,1201,2884,0.5835644937586685
5918,2013-05-01,02M,1018,378,1396,0.7292263610315186
5919,2013-05-01,02N,1045,650,1695,0.616519174041298
5920,2013-05-01,02P,1169,1081,2250,0.5195555555555555
5921,2013-05-01,02Q,642,502,1144,0.5611888111888111
5922,2013-05-01,02R,2031,1138,3169,0.6408961817608079
5923,2013-05-01,02T,1167,676,1843,0.6332067281606077
5924,2013-05-01,02V,1353,637,1990,0.6798994974874372
5925,2013-05-01,02W,546,323,869,0.6283084004602992
5926,2013-05-01,02X,1782,997,2779,0.6412378553436487
5927,2013-05-01,02Y,1884,864,2748,0.6855895196506551
5928,2013-05-01,03A,1248,614,1862,0.6702470461868958
5929,2013-05-01,03C,1993,1060,3053,0.6528005240746806
5930,2013-05-01,03D,822,440,1262,0.6513470681458003
5931,2013-05-01,03E,964,497,1461,0.6598220396988365
5932,2013-05-01,03F,1579,674,2253,0.7008433200177541
5933,2013-05-01,03G,1639,687,2326,0.7046431642304385
5934,2013-05-01,03H,1229,468,1697,0.7242192103712434
5935,2013-05-01,03J,1100,467,1567,0.7019783024888322
5936,2013-05-01,03K,923,273,1196,0.7717391304347826
5937,2013-05-01,03L,1196,1011,2207,0.5419120978704123
5938,2013-05-01,03M,804,445,1249,0.6437149719775821
5939,2013-05-01,03N,3138,922,4060,0.7729064039408867
5940,2013-05-01,03Q,1940,1009,2949,0.6578501186842998
5941,2013-05-01,03R,2311,1028,3339,0.6921233902365977
5942,2013-05-01,03T,1815,702,2517,0.7210965435041716
5943,2013-05-01,03V,424,225,649,0.6533127889060092
5944,2013-05-01,03W,2196,1061,3257,0.6742400982499233
5945,2013-05-01,03X,415,265,680,0.6102941176470589
5946,2013-05-01,03Y,639,391,1030,0.6203883495145631
5947,2013-05-01,04C,1819,817,2636,0.6900606980273141
5948,2013-05-01,04D,1312,650,1962,0.6687054026503568
5949,2013-05-01,04E,1167,593,1760,0.6630681818181818
5950,2013-05-01,04F,1439,1042,2481,0.5800080612656187
5951,2013-05-01,04G,3966,2327,6293,0.6302240584776736
5952,2013-05-01,04H,681,277,958,0.7108559498956158
5953,2013-05-01,04J,1933,1041,2974,0.6499663752521856
5954,2013-05-01,04K,1693,742,2435,0.6952772073921971
5955,2013-05-01,04L,865,355,1220,0.7090163934426229
5956,2013-05-01,04M,519,226,745,0.6966442953020134
5957,2013-05-01,04N,640,279,919,0.6964091403699674
5958,2013-05-01,04Q,833,333,1166,0.7144082332761578
5959,2013-05-01,04R,2537,1275,3812,0.6655299055613851
5960,2013-05-01,04V,2185,1046,3231,0.6762612194367069
5961,2013-05-01,04X,1274,1009,2283,0.5580376697328077
5962,2013-05-01,04Y,978,379,1357,0.7207074428887251
5963,2013-05-01,05A,2640,1528,4168,0.6333973128598849
5964,2013-05-01,05C,1146,1673,2819,0.4065271372827244
5965,2013-05-01,05D,939,445,1384,0.6784682080924855
5966,2013-05-01,05F,1226,609,1835,0.6681198910081744
5967,2013-05-01,05G,1465,584,2049,0.7149829184968277
5968,2013-05-01,05H,1072,584,1656,0.6473429951690821
5969,2013-05-01,05J,1351,630,1981,0.6819787985865724
5970,2013-05-01,05L,2397,1186,3583,0.6689924644152945
5971,2013-05-01,05N,2290,759,3049,0.7510659232535257
5972,2013-05-01,05P,1253,861,2114,0.5927152317880795
5973,2013-05-01,05Q,1367,578,1945,0.702827763496144
5974,2013-05-01,05R,1808,1006,2814,0.642501776830135
5975,2013-05-01,05T,2000,1073,3073,0.6508298080052066
5976,2013-05-01,05V,893,437,1330,0.6714285714285714
5977,2013-05-01,05W,1521,715,2236,0.6802325581395349
5978,2013-05-01,05X,1082,395,1477,0.7325660121868652
5979,2013-05-01,05Y,1789,843,2632,0.6797112462006079
5980,2013-05-01,06A,1537,659,2196,0.6999089253187614
5981,2013-05-01,06D,907,354,1261,0.7192704203013481
5982,2013-05-01,06F,1690,2132,3822,0.4421768707482993
5983,2013-05-01,06H,5156,2952,8108,0.6359151455352738
5984,2013-05-01,06K,3079,2271,5350,0.5755140186915888
5985,2013-05-01,06L,2446,1134,3580,0.6832402234636872
5986,2013-05-01,06M,1938,859,2797,0.692885234179478
5987,2013-05-01,06N,3106,1986,5092,0.6099764336213669
5988,2013-05-01,06P,851,850,1701,0.5002939447383892
5989,2013-05-01,06Q,2345,1251,3596,0.6521134593993326
5990,2013-05-01,06T,2314,1188,3502,0.6607652769845802
5991,2013-05-01,06V,1378,672,2050,0.6721951219512196
5992,2013-05-01,06W,1483,507,1990,0.7452261306532664
5993,2013-05-01,06Y,1266,569,1835,0.6899182561307902
5994,2013-05-01,07G,905,352,1257,0.7199681782020684
5995,2013-05-01,07H,1511,927,2438,0.6197703035274815
5996,2013-05-01,07J,661,455,1116,0.5922939068100358
5997,2013-05-01,07K,1432,757,2189,0.654179990863408
5998,2013-05-01,07L,746,290,1036,0.7200772200772201
5999,2013-05-01,07M,1277,783,2060,0.6199029126213592
6000,2013-05-01,07N,1134,660,1794,0.6321070234113713
6001,2013-05-01,07P,818,463,1281,0.6385636221701796
6002,2013-05-01,07Q,1503,869,2372,0.6336424957841484
6003,2013-05-01,07R,715,532,1247,0.5733761026463512
6004,2013-05-01,07T,651,439,1090,0.5972477064220183
6005,2013-05-01,07V,1707,885,2592,0.6585648148148148
6006,2013-05-01,07W,1004,774,1778,0.5646794150731158
6007,2013-05-01,07X,1259,546,1805,0.6975069252077563
6008,2013-05-01,07Y,805,536,1341,0.6002982848620433
6009,2013-05-01,08A,1141,637,1778,0.6417322834645669
6010,2013-05-01,08C,624,391,1015,0.6147783251231527
6011,2013-05-01,08D,873,498,1371,0.6367614879649891
6012,2013-05-01,08E,893,461,1354,0.6595273264401772
6013,2013-05-01,08F,1366,741,2107,0.6483151400094922
6014,2013-05-01,08G,522,1235,1757,0.2970973249857712
6015,2013-05-01,08H,815,575,1390,0.5863309352517986
6016,2013-05-01,08J,907,361,1268,0.7152996845425867
6017,2013-05-01,08K,1118,503,1621,0.6896977174583591
6018,2013-05-01,08L,707,1016,1723,0.4103308183401045
6019,2013-05-01,08M,955,327,1282,0.7449297971918877
6020,2013-05-01,08N,1080,432,1512,0.7142857142857143
6021,2013-05-01,08P,895,563,1458,0.6138545953360768
6022,2013-05-01,08Q,978,417,1395,0.7010752688172043
6023,2013-05-01,08R,850,431,1281,0.663544106167057
6024,2013-05-01,08T,1055,506,1561,0.6758488148622678
6025,2013-05-01,08V,1094,410,1504,0.7273936170212766
6026,2013-05-01,08W,1048,487,1535,0.6827361563517915
6027,2013-05-01,08X,1257,625,1882,0.6679064824654622
6028,2013-05-01,08Y,662,424,1086,0.6095764272559853
6029,2013-05-01,09A,527,395,922,0.571583514099783
6030,2013-05-01,09C,688,357,1045,0.6583732057416268
6031,2013-05-01,09D,1506,964,2470,0.6097165991902834
6032,2013-05-01,09E,1593,589,2182,0.73006416131989
6033,2013-05-01,09F,1287,686,1973,0.6523061327927014
6034,2013-05-01,09G,3286,1975,5261,0.6245960843946018
6035,2013-05-01,09H,651,364,1015,0.6413793103448275
6036,2013-05-01,09J,1705,868,2573,0.6626506024096386
6037,2013-05-01,09L,878,435,1313,0.6686976389946687
6038,2013-05-01,09N,1071,694,1765,0.6067988668555241
6039,2013-05-01,09P,1150,784,1934,0.594622543950362
6040,2013-05-01,09W,1433,669,2102,0.6817316841103711
6041,2013-05-01,09X,1080,766,1846,0.5850487540628385
6042,2013-05-01,09Y,1680,1089,2769,0.6067172264355363
6043,2013-05-01,10A,1139,641,1780,0.6398876404494382
6044,2013-05-01,10C,452,272,724,0.6243093922651933
6045,2013-05-01,10D,604,192,796,0.7587939698492462
6046,2013-05-01,10E,799,320,1119,0.7140303842716711
6047,2013-05-01,10G,701,307,1008,0.6954365079365079
6048,2013-05-01,10H,1865,1168,3033,0.6149027365644576
6049,2013-05-01,10J,1132,891,2023,0.5595650024715768
6050,2013-05-01,10K,1275,622,1897,0.6721138639957828
6051,2013-05-01,10L,954,370,1324,0.7205438066465257
6052,2013-05-01,10M,550,385,935,0.5882352941176471
6053,2013-05-01,10N,419,361,780,0.5371794871794872
6054,2013-05-01,10Q,2902,2810,5712,0.5080532212885154
6055,2013-05-01,10R,1436,562,1998,0.7187187187187187
6056,2013-05-01,10T,527,295,822,0.6411192214111923
6057,2013-05-01,10V,1227,675,1902,0.6451104100946372
6058,2013-05-01,10W,617,394,1011,0.6102868447082097
6059,2013-05-01,10X,1268,668,1936,0.6549586776859504
6060,2013-05-01,10Y,1284,811,2095,0.6128878281622911
6061,2013-05-01,11A,3586,1998,5584,0.6421919770773639
6062,2013-05-01,11C,854,405,1259,0.6783161239078633
6063,2013-05-01,11D,640,554,1194,0.5360134003350083
6064,2013-05-01,11E,1296,988,2284,0.5674255691768827
6065,2013-05-01,11H,2565,1408,3973,0.6456078530078027
6066,2013-05-01,11J,4860,2545,7405,0.6563133018230926
6067,2013-05-01,11M,3668,1782,5450,0.6730275229357798
6068,2013-05-01,11N,4063,1628,5691,0.7139342821999649
6069,2013-05-01,11T,1480,939,2419,0.6118230673832162
6070,2013-05-01,11X,3414,1945,5359,0.63705915282702
6071,2013-05-01,12A,1510,769,2279,0.6625713032031593
6072,2013-05-01,12D,1089,769,1858,0.5861141011840689
6073,2013-05-01,12F,2437,570,3007,0.8104423012969737
6074,2013-05-01,13P,3132,1561,4693,0.6673769443852546
6075,2013-05-01,13T,3052,1366,4418,0.6908103214124038
6076,2013-05-01,14L,3060,1752,4812,0.6359102244389028
6077,2013-05-01,99A,2599,825,3424,0.759053738317757
6078,2013-05-01,99C,1459,732,2191,0.6659059790050206
6079,2013-05-01,99D,1032,688,1720,0.6
6080,2013-05-01,99E,1434,552,1986,0.7220543806646526
6081,2013-05-01,99F,1062,348,1410,0.7531914893617021
6082,2013-05-01,99G,1057,340,1397,0.7566213314244811
6083,2013-05-01,99H,1540,922,2462,0.6255077173030057
6084,2013-05-01,99J,2981,1464,4445,0.6706411698537683
6085,2013-05-01,99K,1031,678,1709,0.6032767700409596
6086,2013-05-01,99M,1031,765,1796,0.5740534521158129
6087,2013-05-01,99N,2752,2484,5236,0.5255920550038197
6088,2013-05-01,99P,6279,2475,8754,0.7172721041809459
6089,2013-05-01,99Q,1903,913,2816,0.67578125
6090,2013-06-01,00C,686,321,1007,0.6812313803376365
6091,2013-06-01,00D,1952,1110,3062,0.6374918354016982
6092,2013-06-01,00F,13,5,18,0.7222222222222222
6093,2013-06-01,00J,1515,845,2360,0.6419491525423728
6094,2013-06-01,00K,2052,971,3023,0.6787958981144558
6095,2013-06-01,00L,2139,1295,3434,0.6228887594641818
6096,2013-06-01,00M,1934,1015,2949,0.655815530688369
6097,2013-06-01,00N,1071,530,1601,0.6689569019362899
6098,2013-06-01,00P,1817,752,2569,0.7072790969248735
6099,2013-06-01,00Q,935,370,1305,0.7164750957854407
6100,2013-06-01,00R,1037,444,1481,0.7002025658338961
6101,2013-06-01,00T,1761,1068,2829,0.6224814422057264
6102,2013-06-01,00V,1332,707,2039,0.6532614026483571
6103,2013-06-01,00W,43,23,66,0.6515151515151515
6104,2013-06-01,00X,929,253,1182,0.7859560067681896
6105,2013-06-01,00Y,1591,846,2437,0.6528518670496513
6106,2013-06-01,01A,2215,1186,3401,0.6512790355777712
6107,2013-06-01,01C,1178,727,1905,0.6183727034120735
6108,2013-06-01,01D,1390,725,2115,0.6572104018912529
6109,2013-06-01,01E,1077,163,1240,0.8685483870967742
6110,2013-06-01,01F,807,502,1309,0.6165011459129106
6111,2013-06-01,01G,1306,1036,2342,0.5576430401366353
6112,2013-06-01,01H,2275,900,3175,0.7165354330708661
6113,2013-06-01,01J,918,483,1401,0.6552462526766595
6114,2013-06-01,01K,1932,1103,3035,0.6365733113673806
6115,2013-06-01,01N,16,17,33,0.48484848484848486
6116,2013-06-01,01R,854,502,1356,0.6297935103244838
6117,2013-06-01,01T,797,411,1208,0.6597682119205298
6118,2013-06-01,01V,724,323,1047,0.6914995224450812
6119,2013-06-01,01W,1793,850,2643,0.6783957623912221
6120,2013-06-01,01X,1305,635,1940,0.6726804123711341
6121,2013-06-01,01Y,1293,757,2050,0.6307317073170732
6122,2013-06-01,02A,1251,629,1880,0.6654255319148936
6123,2013-06-01,02D,464,416,880,0.5272727272727272
6124,2013-06-01,02E,1165,455,1620,0.7191358024691358
6125,2013-06-01,02F,1447,572,2019,0.716691431401684
6126,2013-06-01,02G,559,329,888,0.6295045045045045
6127,2013-06-01,02H,1540,1171,2711,0.5680560678716341
6128,2013-06-01,02M,1011,356,1367,0.7395757132406731
6129,2013-06-01,02N,886,603,1489,0.5950302216252519
6130,2013-06-01,02P,1097,1067,2164,0.5069316081330869
6131,2013-06-01,02Q,544,437,981,0.5545361875637105
6132,2013-06-01,02R,1886,1000,2886,0.6534996534996536
6133,2013-06-01,02T,1005,655,1660,0.6054216867469879
6134,2013-06-01,02V,1259,563,1822,0.6909989023051591
6135,2013-06-01,02W,472,302,774,0.6098191214470284
6136,2013-06-01,02X,1843,915,2758,0.6682378535170413
6137,2013-06-01,02Y,1878,822,2700,0.6955555555555556
6138,2013-06-01,03A,1197,597,1794,0.6672240802675585
6139,2013-06-01,03C,1730,920,2650,0.6528301886792452
6140,2013-06-01,03D,769,417,1186,0.648397976391231
6141,2013-06-01,03E,825,475,1300,0.6346153846153846
6142,2013-06-01,03F,1425,640,2065,0.6900726392251816
6143,2013-06-01,03G,1494,722,2216,0.674187725631769
6144,2013-06-01,03H,1106,459,1565,0.7067092651757189
6145,2013-06-01,03J,1153,457,1610,0.7161490683229814
6146,2013-06-01,03K,936,256,1192,0.785234899328859
6147,2013-06-01,03L,1165,980,2145,0.5431235431235432
6148,2013-06-01,03M,728,429,1157,0.6292134831460674
6149,2013-06-01,03N,2996,828,3824,0.7834728033472803
6150,2013-06-01,03Q,1738,927,2665,0.652157598499062
6151,2013-06-01,03R,2136,939,3075,0.6946341463414634
6152,2013-06-01,03T,1733,702,2435,0.7117043121149897
6153,2013-06-01,03V,385,219,604,0.6374172185430463
6154,2013-06-01,03W,2088,995,3083,0.6772624067466754
6155,2013-06-01,03X,441,243,684,0.6447368421052632
6156,2013-06-01,03Y,623,334,957,0.6509926854754441
6157,2013-06-01,04C,1783,789,2572,0.6932348367029549
6158,2013-06-01,04D,1229,636,1865,0.6589812332439678
6159,2013-06-01,04E,1097,560,1657,0.6620398310199155
6160,2013-06-01,04F,1399,933,2332,0.5999142367066895
6161,2013-06-01,04G,3714,2102,5816,0.6385832187070152
6162,2013-06-01,04H,664,286,950,0.6989473684210527
6163,2013-06-01,04J,1847,966,2813,0.6565943832207608
6164,2013-06-01,04K,1505,744,2249,0.6691863050244553
6165,2013-06-01,04L,804,333,1137,0.7071240105540897
6166,2013-06-01,04M,487,206,693,0.7027417027417028
6167,2013-06-01,04N,624,288,912,0.6842105263157895
6168,2013-06-01,04Q,837,364,1201,0.6969192339716903
6169,2013-06-01,04R,2553,1261,3814,0.6693759832197168
6170,2013-06-01,04V,2090,985,3075,0.6796747967479675
6171,2013-06-01,04X,1214,1004,2218,0.5473399458972047
6172,2013-06-01,04Y,897,346,1243,0.7216411906677394
6173,2013-06-01,05A,2417,1316,3733,0.6474685239753549
6174,2013-06-01,05C,1027,1590,2617,0.39243408482995795
6175,2013-06-01,05D,874,419,1293,0.6759474091260634
6176,2013-06-01,05F,1171,635,1806,0.6483942414174972
6177,2013-06-01,05G,1435,549,1984,0.7232862903225806
6178,2013-06-01,05H,1056,570,1626,0.6494464944649446
6179,2013-06-01,05J,1319,576,1895,0.696042216358839
6180,2013-06-01,05L,2317,1216,3533,0.6558165864704217
6181,2013-06-01,05N,2085,695,2780,0.75
6182,2013-06-01,05P,1237,788,2025,0.6108641975308642
6183,2013-06-01,05Q,1279,562,1841,0.694731124388919
6184,2013-06-01,05R,1580,1014,2594,0.6090979182729376
6185,2013-06-01,05T,1829,1008,2837,0.6446951004582305
6186,2013-06-01,05V,883,363,1246,0.7086677367576244
6187,2013-06-01,05W,1503,648,2151,0.698744769874477
6188,2013-06-01,05X,1020,347,1367,0.7461594732991953
6189,2013-06-01,05Y,1694,791,2485,0.6816901408450704
6190,2013-06-01,06A,1561,622,2183,0.7150710032065964
6191,2013-06-01,06D,815,337,1152,0.7074652777777778
6192,2013-06-01,06F,1551,2229,3780,0.4103174603174603
6193,2013-06-01,06H,4816,2676,7492,0.6428190069407368
6194,2013-06-01,06K,2988,2049,5037,0.593210244192972
6195,2013-06-01,06L,2257,1128,3385,0.666765140324963
6196,2013-06-01,06M,1919,759,2678,0.7165795369678865
6197,2013-06-01,06N,3064,1864,4928,0.6217532467532467
6198,2013-06-01,06P,781,818,1599,0.4884302689180738
6199,2013-06-01,06Q,2244,1188,3432,0.6538461538461539
6200,2013-06-01,06T,2194,1067,3261,0.6727997546764796
6201,2013-06-01,06V,1332,557,1889,0.7051349920592906
6202,2013-06-01,06W,1417,441,1858,0.7626480086114101
6203,2013-06-01,06Y,1219,481,1700,0.7170588235294117
6204,2013-06-01,07G,853,301,1154,0.7391681109185442
6205,2013-06-01,07H,1569,875,2444,0.6419803600654664
6206,2013-06-01,07J,693,440,1133,0.6116504854368932
6207,2013-06-01,07K,1373,739,2112,0.650094696969697
6208,2013-06-01,07L,666,275,941,0.7077577045696068
6209,2013-06-01,07M,1195,778,1973,0.6056766345666498
6210,2013-06-01,07N,1219,648,1867,0.6529191215854312
6211,2013-06-01,07P,865,469,1334,0.6484257871064468
6212,2013-06-01,07Q,1514,848,2362,0.6409822184589331
6213,2013-06-01,07R,736,528,1264,0.5822784810126582
6214,2013-06-01,07T,603,423,1026,0.5877192982456141
6215,2013-06-01,07V,1793,869,2662,0.6735537190082644
6216,2013-06-01,07W,1001,763,1764,0.5674603174603174
6217,2013-06-01,07X,1277,547,1824,0.700109649122807
6218,2013-06-01,07Y,737,474,1211,0.6085879438480595
6219,2013-06-01,08A,1139,614,1753,0.6497432972047917
6220,2013-06-01,08C,640,430,1070,0.5981308411214953
6221,2013-06-01,08D,831,463,1294,0.6421947449768161
6222,2013-06-01,08E,777,411,1188,0.6540404040404041
6223,2013-06-01,08F,1340,647,1987,0.6743834927025667
6224,2013-06-01,08G,533,1186,1719,0.3100639906922629
6225,2013-06-01,08H,778,522,1300,0.5984615384615385
6226,2013-06-01,08J,829,338,1167,0.7103684661525278
6227,2013-06-01,08K,1093,477,1570,0.6961783439490445
6228,2013-06-01,08L,747,1066,1813,0.4120242691671263
6229,2013-06-01,08M,918,351,1269,0.723404255319149
6230,2013-06-01,08N,1117,465,1582,0.7060682680151706
6231,2013-06-01,08P,878,514,1392,0.6307471264367817
6232,2013-06-01,08Q,957,398,1355,0.7062730627306273
6233,2013-06-01,08R,814,477,1291,0.6305189775367932
6234,2013-06-01,08T,911,477,1388,0.6563400576368876
6235,2013-06-01,08V,1048,439,1487,0.7047747141896435
6236,2013-06-01,08W,1027,433,1460,0.7034246575342465
6237,2013-06-01,08X,1224,661,1885,0.6493368700265252
6238,2013-06-01,08Y,711,443,1154,0.6161178509532063
6239,2013-06-01,09A,521,365,886,0.5880361173814899
6240,2013-06-01,09C,655,305,960,0.6822916666666666
6241,2013-06-01,09D,1354,910,2264,0.5980565371024735
6242,2013-06-01,09E,1377,573,1950,0.7061538461538461
6243,2013-06-01,09F,1281,651,1932,0.6630434782608695
6244,2013-06-01,09G,2969,1819,4788,0.6200918964076859
6245,2013-06-01,09H,605,315,920,0.657608695652174
6246,2013-06-01,09J,1509,799,2308,0.6538128249566725
6247,2013-06-01,09L,745,428,1173,0.6351236146632566
6248,2013-06-01,09N,1045,591,1636,0.6387530562347188
6249,2013-06-01,09P,1173,754,1927,0.6087182148417228
6250,2013-06-01,09W,1394,565,1959,0.7115875446656458
6251,2013-06-01,09X,1036,755,1791,0.5784477945281965
6252,2013-06-01,09Y,1572,1051,2623,0.5993137628669463
6253,2013-06-01,10A,1051,592,1643,0.6396835057821059
6254,2013-06-01,10C,464,256,720,0.6444444444444445
6255,2013-06-01,10D,603,198,801,0.7528089887640449
6256,2013-06-01,10E,788,328,1116,0.7060931899641577
6257,2013-06-01,10G,625,357,982,0.6364562118126272
6258,2013-06-01,10H,1767,1169,2936,0.6018392370572208
6259,2013-06-01,10J,1038,814,1852,0.5604751619870411
6260,2013-06-01,10K,1209,569,1778,0.6799775028121485
6261,2013-06-01,10L,946,309,1255,0.7537848605577689
6262,2013-06-01,10M,527,432,959,0.5495307612095933
6263,2013-06-01,10N,468,397,865,0.5410404624277456
6264,2013-06-01,10Q,2752,2762,5514,0.4990932172651433
6265,2013-06-01,10R,1297,520,1817,0.7138139790864062
6266,2013-06-01,10T,543,276,819,0.663003663003663
6267,2013-06-01,10V,1137,650,1787,0.6362618914381645
6268,2013-06-01,10W,558,368,926,0.6025917926565875
6269,2013-06-01,10X,1169,582,1751,0.6676185037121645
6270,2013-06-01,10Y,1205,746,1951,0.6176319835981547
6271,2013-06-01,11A,3363,1891,5254,0.6400837457175486
6272,2013-06-01,11C,802,411,1213,0.6611706512778236
6273,2013-06-01,11D,618,487,1105,0.5592760180995475
6274,2013-06-01,11E,1140,855,1995,0.5714285714285714
6275,2013-06-01,11H,2356,1342,3698,0.6371011357490536
6276,2013-06-01,11J,4628,2340,6968,0.664179104477612
6277,2013-06-01,11M,3472,1727,5199,0.667820734756684
6278,2013-06-01,11N,3998,1516,5514,0.72506347479144
6279,2013-06-01,11T,1393,899,2292,0.6077661431064573
6280,2013-06-01,11X,3090,1888,4978,0.620731217356368
6281,2013-06-01,12A,1291,657,1948,0.6627310061601642
6282,2013-06-01,12D,972,709,1681,0.578227245687091
6283,2013-06-01,12F,2399,563,2962,0.8099257258609048
6284,2013-06-01,13P,3036,1559,4595,0.6607181719260066
6285,2013-06-01,13T,2815,1283,4098,0.686920448999512
6286,2013-06-01,14L,2889,1603,4492,0.6431433659839715
6287,2013-06-01,99A,2413,798,3211,0.7514792899408284
6288,2013-06-01,99C,1394,700,2094,0.6657115568290354
6289,2013-06-01,99D,1007,706,1713,0.5878575598365441
6290,2013-06-01,99E,1437,544,1981,0.7253912165572943
6291,2013-06-01,99F,1051,330,1381,0.7610427226647357
6292,2013-06-01,99G,996,319,1315,0.7574144486692015
6293,2013-06-01,99H,1503,877,2380,0.6315126050420168
6294,2013-06-01,99J,3087,1571,4658,0.6627307857449549
6295,2013-06-01,99K,941,611,1552,0.6063144329896907
6296,2013-06-01,99M,1063,792,1855,0.5730458221024258
6297,2013-06-01,99N,2665,2310,4975,0.535678391959799
6298,2013-06-01,99P,5945,2211,8156,0.7289112309955861
6299,2013-06-01,99Q,1812,846,2658,0.6817155756207675
6300,2013-07-01,00C,777,338,1115,0.6968609865470852
6301,2013-07-01,00D,2151,1299,3450,0.6234782608695653
6302,2013-07-01,00F,18,3,21,0.8571428571428571
6303,2013-07-01,00J,1652,886,2538,0.6509062253743105
6304,2013-07-01,00K,2201,1103,3304,0.6661622276029056
6305,2013-07-01,00L,2288,1491,3779,0.6054511775602011
6306,2013-07-01,00M,2190,1100,3290,0.6656534954407295
6307,2013-07-01,00N,1207,595,1802,0.6698113207547169
6308,2013-07-01,00P,2022,897,2919,0.6927029804727647
6309,2013-07-01,00Q,1082,423,1505,0.718936877076412
6310,2013-07-01,00R,1216,503,1719,0.7073880162885399
6311,2013-07-01,00T,1969,1224,3193,0.6166614469151268
6312,2013-07-01,00V,1428,744,2172,0.6574585635359116
6313,2013-07-01,00W,73,34,107,0.6822429906542056
6314,2013-07-01,00X,991,280,1271,0.7797010228166797
6315,2013-07-01,00Y,1798,925,2723,0.6603011384502387
6316,2013-07-01,01A,2407,1306,3713,0.6482628602208457
6317,2013-07-01,01C,1233,777,2010,0.6134328358208955
6318,2013-07-01,01D,1618,756,2374,0.6815501263689975
6319,2013-07-01,01E,1191,211,1402,0.8495007132667618
6320,2013-07-01,01F,912,508,1420,0.6422535211267606
6321,2013-07-01,01G,1425,1163,2588,0.5506182380216383
6322,2013-07-01,01H,2458,925,3383,0.7265740467041087
6323,2013-07-01,01J,1017,518,1535,0.6625407166123779
6324,2013-07-01,01K,2242,1171,3413,0.656900087899209
6325,2013-07-01,01N,23,33,56,0.4107142857142857
6326,2013-07-01,01R,1006,593,1599,0.6291432145090682
6327,2013-07-01,01T,847,446,1293,0.6550657385924207
6328,2013-07-01,01V,810,363,1173,0.690537084398977
6329,2013-07-01,01W,2097,1001,3098,0.6768883150419626
6330,2013-07-01,01X,1395,665,2060,0.6771844660194175
6331,2013-07-01,01Y,1399,776,2175,0.6432183908045978
6332,2013-07-01,02A,1379,713,2092,0.6591778202676865
6333,2013-07-01,02D,519,437,956,0.5428870292887029
6334,2013-07-01,02E,1269,571,1840,0.6896739130434782
6335,2013-07-01,02F,1706,665,2371,0.7195276254744833
6336,2013-07-01,02G,578,406,984,0.5873983739837398
6337,2013-07-01,02H,1633,1265,2898,0.5634920634920635
6338,2013-07-01,02M,1033,429,1462,0.7065663474692202
6339,2013-07-01,02N,991,685,1676,0.5912887828162291
6340,2013-07-01,02P,1319,1180,2499,0.52781112444978
6341,2013-07-01,02Q,636,455,1091,0.5829514207149404
6342,2013-07-01,02R,2138,1110,3248,0.6582512315270936
6343,2013-07-01,02T,1161,703,1864,0.6228540772532188
6344,2013-07-01,02V,1434,661,2095,0.6844868735083532
6345,2013-07-01,02W,578,312,890,0.6494382022471911
6346,2013-07-01,02X,1915,993,2908,0.6585281980742779
6347,2013-07-01,02Y,1964,905,2869,0.6845590798187522
6348,2013-07-01,03A,1354,644,1998,0.6776776776776777
6349,2013-07-01,03C,1910,1001,2911,0.6561319134318103
6350,2013-07-01,03D,829,434,1263,0.6563737133808393
6351,2013-07-01,03E,927,536,1463,0.6336295283663704
6352,2013-07-01,03F,1527,685,2212,0.6903254972875226
6353,2013-07-01,03G,1663,746,2409,0.6903279369032793
6354,2013-07-01,03H,1266,465,1731,0.7313691507798961
6355,2013-07-01,03J,1265,507,1772,0.713882618510158
6356,2013-07-01,03K,1016,275,1291,0.7869868319132456
6357,2013-07-01,03L,1335,1085,2420,0.5516528925619835
6358,2013-07-01,03M,830,415,1245,0.6666666666666666
6359,2013-07-01,03N,3308,938,4246,0.7790861987753179
6360,2013-07-01,03Q,2015,1090,3105,0.6489533011272142
6361,2013-07-01,03R,2403,1157,3560,0.675
6362,2013-07-01,03T,1851,716,2567,0.7210751850409037
6363,2013-07-01,03V,462,235,697,0.6628407460545194
6364,2013-07-01,03W,2293,999,3292,0.6965370595382746
6365,2013-07-01,03X,475,283,758,0.6266490765171504
6366,2013-07-01,03Y,703,411,1114,0.6310592459605027
6367,2013-07-01,04C,1915,866,2781,0.6886012225818051
6368,2013-07-01,04D,1399,720,2119,0.660217083529967
6369,2013-07-01,04E,1224,601,1825,0.6706849315068493
6370,2013-07-01,04F,1468,1162,2630,0.5581749049429657
6371,2013-07-01,04G,4088,2331,6419,0.6368593238822247
6372,2013-07-01,04H,792,355,1147,0.6904969485614647
6373,2013-07-01,04J,1989,1140,3129,0.6356663470757431
6374,2013-07-01,04K,1687,747,2434,0.6930977814297453
6375,2013-07-01,04L,914,340,1254,0.7288676236044657
6376,2013-07-01,04M,540,221,761,0.709592641261498
6377,2013-07-01,04N,712,337,1049,0.678741658722593
6378,2013-07-01,04Q,871,407,1278,0.6815336463223787
6379,2013-07-01,04R,2693,1406,4099,0.6569895096364967
6380,2013-07-01,04V,2242,1076,3318,0.675708257986739
6381,2013-07-01,04X,1430,964,2394,0.5973266499582289
6382,2013-07-01,04Y,930,385,1315,0.7072243346007605
6383,2013-07-01,05A,2828,1515,4343,0.6511627906976745
6384,2013-07-01,05C,1208,1684,2892,0.41770401106500693
6385,2013-07-01,05D,972,454,1426,0.6816269284712483
6386,2013-07-01,05F,1288,576,1864,0.6909871244635193
6387,2013-07-01,05G,1521,582,2103,0.7232524964336662
6388,2013-07-01,05H,1121,669,1790,0.6262569832402235
6389,2013-07-01,05J,1459,643,2102,0.6941008563273073
6390,2013-07-01,05L,2385,1373,3758,0.6346460883448642
6391,2013-07-01,05N,2321,803,3124,0.7429577464788732
6392,2013-07-01,05P,1339,856,2195,0.6100227790432802
6393,2013-07-01,05Q,1443,607,2050,0.7039024390243902
6394,2013-07-01,05R,1880,1084,2964,0.6342780026990553
6395,2013-07-01,05T,2003,1157,3160,0.6338607594936709
6396,2013-07-01,05V,969,433,1402,0.6911554921540656
6397,2013-07-01,05W,1650,757,2407,0.6855006231823847
6398,2013-07-01,05X,1179,376,1555,0.7581993569131833
6399,2013-07-01,05Y,1784,844,2628,0.6788432267884322
6400,2013-07-01,06A,1593,692,2285,0.6971553610503283
6401,2013-07-01,06D,909,407,1316,0.6907294832826748
6402,2013-07-01,06F,1587,2282,3869,0.4101835099508917
6403,2013-07-01,06H,5249,2900,8149,0.6441281138790036
6404,2013-07-01,06K,3291,2353,5644,0.5830970942593905
6405,2013-07-01,06L,2442,1130,3572,0.6836506159014558
6406,2013-07-01,06M,2038,877,2915,0.6991423670668954
6407,2013-07-01,06N,3271,2110,5381,0.6078795762869356
6408,2013-07-01,06P,903,883,1786,0.5055991041433371
6409,2013-07-01,06Q,2485,1181,3666,0.6778505182760501
6410,2013-07-01,06T,2309,1172,3481,0.6633151393277794
6411,2013-07-01,06V,1539,642,2181,0.7056396148555708
6412,2013-07-01,06W,1453,511,1964,0.7398167006109979
6413,2013-07-01,06Y,1291,546,1837,0.7027762656505171
6414,2013-07-01,07G,878,347,1225,0.7167346938775511
6415,2013-07-01,07H,1546,960,2506,0.6169193934557063
6416,2013-07-01,07J,756,466,1222,0.618657937806874
6417,2013-07-01,07K,1430,787,2217,0.6450157870996842
6418,2013-07-01,07L,749,342,1091,0.6865261228230981
6419,2013-07-01,07M,1264,823,2087,0.6056540488739818
6420,2013-07-01,07N,1238,660,1898,0.6522655426765016
6421,2013-07-01,07P,864,475,1339,0.6452576549663929
6422,2013-07-01,07Q,1571,896,2467,0.6368058370490475
6423,2013-07-01,07R,764,538,1302,0.5867895545314901
6424,2013-07-01,07T,705,454,1159,0.6082830025884383
6425,2013-07-01,07V,1866,891,2757,0.676822633297062
6426,2013-07-01,07W,1075,827,1902,0.5651945320715037
6427,2013-07-01,07X,1294,627,1921,0.6736074960957834
6428,2013-07-01,07Y,801,512,1313,0.6100533130236101
6429,2013-07-01,08A,1165,600,1765,0.660056657223796
6430,2013-07-01,08C,704,391,1095,0.6429223744292237
6431,2013-07-01,08D,975,507,1482,0.6578947368421053
6432,2013-07-01,08E,865,461,1326,0.6523378582202112
6433,2013-07-01,08F,1419,686,2105,0.6741092636579572
6434,2013-07-01,08G,568,1299,1867,0.3042313872522764
6435,2013-07-01,08H,853,564,1417,0.6019760056457304
6436,2013-07-01,08J,841,384,1225,0.686530612244898
6437,2013-07-01,08K,1204,557,1761,0.683702441794435
6438,2013-07-01,08L,713,1160,1873,0.3806727175654031
6439,2013-07-01,08M,1028,441,1469,0.6997957794417972
6440,2013-07-01,08N,1137,501,1638,0.6941391941391941
6441,2013-07-01,08P,923,505,1428,0.646358543417367
6442,2013-07-01,08Q,1031,474,1505,0.6850498338870432
6443,2013-07-01,08R,876,446,1322,0.6626323751891074
6444,2013-07-01,08T,934,548,1482,0.6302294197031039
6445,2013-07-01,08V,1129,484,1613,0.6999380037197768
6446,2013-07-01,08W,1060,516,1576,0.6725888324873096
6447,2013-07-01,08X,1321,651,1972,0.6698782961460447
6448,2013-07-01,08Y,747,487,1234,0.6053484602917342
6449,2013-07-01,09A,559,392,951,0.5878023133543638
6450,2013-07-01,09C,732,333,1065,0.6873239436619718
6451,2013-07-01,09D,1426,922,2348,0.6073253833049403
6452,2013-07-01,09E,1627,616,2243,0.7253678109674543
6453,2013-07-01,09F,1369,716,2085,0.6565947242206235
6454,2013-07-01,09G,3341,1974,5315,0.6285983066792098
6455,2013-07-01,09H,646,358,1004,0.6434262948207171
6456,2013-07-01,09J,1701,923,2624,0.6482469512195121
6457,2013-07-01,09L,917,453,1370,0.6693430656934306
6458,2013-07-01,09N,1136,676,1812,0.6269315673289183
6459,2013-07-01,09P,1213,923,2136,0.5678838951310862
6460,2013-07-01,09W,1475,653,2128,0.6931390977443609
6461,2013-07-01,09X,1082,723,1805,0.5994459833795014
6462,2013-07-01,09Y,1694,1131,2825,0.5996460176991151
6463,2013-07-01,10A,1221,666,1887,0.6470588235294118
6464,2013-07-01,10C,483,254,737,0.655359565807327
6465,2013-07-01,10D,646,224,870,0.7425287356321839
6466,2013-07-01,10E,838,335,1173,0.7144075021312873
6467,2013-07-01,10G,696,305,1001,0.6953046953046953
6468,2013-07-01,10H,1875,1288,3163,0.5927916534935188
6469,2013-07-01,10J,1113,901,2014,0.5526315789473685
6470,2013-07-01,10K,1250,641,1891,0.6610259122157589
6471,2013-07-01,10L,1026,334,1360,0.7544117647058823
6472,2013-07-01,10M,559,408,967,0.578076525336091
6473,2013-07-01,10N,466,408,874,0.5331807780320366
6474,2013-07-01,10Q,2961,2953,5914,0.5006763611768684
6475,2013-07-01,10R,1362,538,1900,0.716842105263158
6476,2013-07-01,10T,594,292,886,0.6704288939051919
6477,2013-07-01,10V,1378,713,2091,0.6590148254423721
6478,2013-07-01,10W,635,350,985,0.6446700507614214
6479,2013-07-01,10X,1222,677,1899,0.6434965771458663
6480,2013-07-01,10Y,1239,822,2061,0.6011644832605532
6481,2013-07-01,11A,3689,1935,5624,0.6559388335704125
6482,2013-07-01,11C,821,403,1224,0.670751633986928
6483,2013-07-01,11D,664,539,1203,0.5519534497090607
6484,2013-07-01,11E,1352,907,2259,0.5984949092518813
6485,2013-07-01,11H,2542,1441,3983,0.638212402711524
6486,2013-07-01,11J,5014,2622,7636,0.6566265060240963
6487,2013-07-01,11M,3728,1886,5614,0.6640541503384396
6488,2013-07-01,11N,4553,1702,6255,0.7278976818545164
6489,2013-07-01,11T,1486,990,2476,0.6001615508885298
6490,2013-07-01,11X,3409,2020,5429,0.6279241112543746
6491,2013-07-01,12A,1445,808,2253,0.6413670661340435
6492,2013-07-01,12D,1209,839,2048,0.59033203125
6493,2013-07-01,12F,2530,627,3157,0.8013937282229965
6494,2013-07-01,13P,3321,1631,4952,0.6706381260096931
6495,2013-07-01,13T,3312,1532,4844,0.6837324525185797
6496,2013-07-01,14L,2997,1761,4758,0.6298865069356873
6497,2013-07-01,99A,2744,925,3669,0.7478877078222949
6498,2013-07-01,99C,1549,766,2315,0.6691144708423327
6499,2013-07-01,99D,1098,749,1847,0.5944775311315647
6500,2013-07-01,99E,1444,597,2041,0.7074963253307203
6501,2013-07-01,99F,1085,362,1447,0.7498272287491361
6502,2013-07-01,99G,1044,313,1357,0.7693441414885778
6503,2013-07-01,99H,1667,956,2623,0.6355318337781166
6504,2013-07-01,99J,3235,1681,4916,0.6580553295362083
6505,2013-07-01,99K,1008,682,1690,0.5964497041420118
6506,2013-07-01,99M,1104,844,1948,0.5667351129363449
6507,2013-07-01,99N,2920,2612,5532,0.5278380332610267
6508,2013-07-01,99P,6592,2401,8993,0.7330145668853553
6509,2013-07-01,99Q,2052,946,2998,0.6844563042028019
6510,2013-08-01,00C,797,330,1127,0.707187222715173
6511,2013-08-01,00D,2144,1384,3528,0.6077097505668935
6512,2013-08-01,00F,11,5,16,0.6875
6513,2013-08-01,00J,1704,918,2622,0.6498855835240275
6514,2013-08-01,00K,2178,1127,3305,0.6590015128593041
6515,2013-08-01,00L,2295,1518,3813,0.6018882769472856
6516,2013-08-01,00M,2235,1056,3291,0.6791248860528715
6517,2013-08-01,00N,1214,579,1793,0.6770775237032906
6518,2013-08-01,00P,2053,886,2939,0.698536917318816
6519,2013-08-01,00Q,987,403,1390,0.7100719424460432
6520,2013-08-01,00R,1242,487,1729,0.7183342972816658
6521,2013-08-01,00T,2030,1157,3187,0.6369626608095388
6522,2013-08-01,00V,1457,787,2244,0.6492869875222816
6523,2013-08-01,00W,49,21,70,0.7
6524,2013-08-01,00X,1051,299,1350,0.7785185185185185
6525,2013-08-01,00Y,1871,972,2843,0.6581076327822722
6526,2013-08-01,01A,2439,1313,3752,0.6500533049040512
6527,2013-08-01,01C,1313,787,2100,0.6252380952380953
6528,2013-08-01,01D,1557,768,2325,0.6696774193548387
6529,2013-08-01,01E,1147,180,1327,0.8643556895252449
6530,2013-08-01,01F,971,572,1543,0.6292935839274141
6531,2013-08-01,01G,1541,1161,2702,0.5703182827535159
6532,2013-08-01,01H,2659,926,3585,0.7417015341701534
6533,2013-08-01,01J,1036,508,1544,0.6709844559585493
6534,2013-08-01,01K,2260,1192,3452,0.6546929316338355
6535,2013-08-01,01N,16,20,36,0.4444444444444444
6536,2013-08-01,01R,1069,571,1640,0.651829268292683
6537,2013-08-01,01T,856,469,1325,0.6460377358490565
6538,2013-08-01,01V,844,379,1223,0.6901062959934587
6539,2013-08-01,01W,2231,968,3199,0.69740543919975
6540,2013-08-01,01X,1476,754,2230,0.6618834080717488
6541,2013-08-01,01Y,1381,832,2213,0.6240397650248531
6542,2013-08-01,02A,1309,687,1996,0.655811623246493
6543,2013-08-01,02D,582,417,999,0.5825825825825826
6544,2013-08-01,02E,1230,522,1752,0.702054794520548
6545,2013-08-01,02F,1764,642,2406,0.7331670822942643
6546,2013-08-01,02G,643,358,1001,0.6423576423576424
6547,2013-08-01,02H,1643,1261,2904,0.565771349862259
6548,2013-08-01,02M,1165,433,1598,0.7290362953692116
6549,2013-08-01,02N,1001,699,1700,0.5888235294117647
6550,2013-08-01,02P,1380,1261,2641,0.5225293449450965
6551,2013-08-01,02Q,658,493,1151,0.5716768027801912
6552,2013-08-01,02R,2092,1192,3284,0.6370280146163215
6553,2013-08-01,02T,1238,819,2057,0.6018473505104521
6554,2013-08-01,02V,1352,721,2073,0.6521948866377231
6555,2013-08-01,02W,567,282,849,0.6678445229681979
6556,2013-08-01,02X,1925,1056,2981,0.6457564575645757
6557,2013-08-01,02Y,1990,933,2923,0.6808073896681491
6558,2013-08-01,03A,1339,636,1975,0.6779746835443038
6559,2013-08-01,03C,2020,1052,3072,0.6575520833333334
6560,2013-08-01,03D,833,437,1270,0.6559055118110236
6561,2013-08-01,03E,1009,522,1531,0.659046374918354
6562,2013-08-01,03F,1696,695,2391,0.7093266415725638
6563,2013-08-01,03G,1760,771,2531,0.6953773212169103
6564,2013-08-01,03H,1331,489,1820,0.7313186813186813
6565,2013-08-01,03J,1154,487,1641,0.7032297379646557
6566,2013-08-01,03K,1073,345,1418,0.7566995768688294
6567,2013-08-01,03L,1326,1040,2366,0.5604395604395604
6568,2013-08-01,03M,892,454,1346,0.662704309063893
6569,2013-08-01,03N,3305,954,4259,0.7760037567504109
6570,2013-08-01,03Q,1985,1082,3067,0.6472122595370069
6571,2013-08-01,03R,2569,1112,3681,0.697908177125781
6572,2013-08-01,03T,1908,763,2671,0.7143391988019469
6573,2013-08-01,03V,487,257,744,0.6545698924731183
6574,2013-08-01,03W,2425,1077,3502,0.6924614505996574
6575,2013-08-01,03X,472,292,764,0.6178010471204188
6576,2013-08-01,03Y,731,397,1128,0.6480496453900709
6577,2013-08-01,04C,2002,863,2865,0.6987783595113438
6578,2013-08-01,04D,1373,731,2104,0.6525665399239544
6579,2013-08-01,04E,1321,648,1969,0.6708989334687658
6580,2013-08-01,04F,1532,1082,2614,0.5860749808722264
6581,2013-08-01,04G,4262,2415,6677,0.638310618541261
6582,2013-08-01,04H,762,311,1073,0.7101584342963654
6583,2013-08-01,04J,2111,1143,3254,0.648740012292563
6584,2013-08-01,04K,1566,725,2291,0.6835443037974683
6585,2013-08-01,04L,848,382,1230,0.6894308943089431
6586,2013-08-01,04M,571,205,776,0.7358247422680413
6587,2013-08-01,04N,709,312,1021,0.6944172380019589
6588,2013-08-01,04Q,908,399,1307,0.6947207345065034
6589,2013-08-01,04R,2783,1419,4202,0.662303664921466
6590,2013-08-01,04V,2295,1107,3402,0.6746031746031746
6591,2013-08-01,04X,1331,1113,2444,0.5445990180032734
6592,2013-08-01,04Y,1067,383,1450,0.7358620689655172
6593,2013-08-01,05A,2781,1474,4255,0.6535840188014101
6594,2013-08-01,05C,1203,1776,2979,0.4038267875125881
6595,2013-08-01,05D,972,453,1425,0.6821052631578948
6596,2013-08-01,05F,1363,645,2008,0.6787848605577689
6597,2013-08-01,05G,1652,634,2286,0.7226596675415573
6598,2013-08-01,05H,1225,606,1831,0.6690333151283452
6599,2013-08-01,05J,1514,681,2195,0.689749430523918
6600,2013-08-01,05L,2431,1336,3767,0.6453411202548447
6601,2013-08-01,05N,2443,790,3233,0.7556449118465821
6602,2013-08-01,05P,1392,888,2280,0.6105263157894737
6603,2013-08-01,05Q,1422,645,2067,0.6879535558780842
6604,2013-08-01,05R,1823,1165,2988,0.6101070950468541
6605,2013-08-01,05T,2191,1100,3291,0.6657550896384078
6606,2013-08-01,05V,1030,463,1493,0.6898861352980576
6607,2013-08-01,05W,1746,738,2484,0.7028985507246377
6608,2013-08-01,05X,1201,412,1613,0.7445753254804711
6609,2013-08-01,05Y,1768,931,2699,0.6550574286772879
6610,2013-08-01,06A,1694,699,2393,0.7078980359381529
6611,2013-08-01,06D,964,466,1430,0.6741258741258741
6612,2013-08-01,06F,1688,2450,4138,0.40792653455775735
6613,2013-08-01,06H,5538,3109,8647,0.6404533364172545
6614,2013-08-01,06K,3297,2449,5746,0.5737904629307344
6615,2013-08-01,06L,2441,1207,3648,0.6691337719298246
6616,2013-08-01,06M,1972,924,2896,0.680939226519337
6617,2013-08-01,06N,3323,2258,5581,0.5954130084214299
6618,2013-08-01,06P,866,914,1780,0.48651685393258426
6619,2013-08-01,06Q,2532,1318,3850,0.6576623376623376
6620,2013-08-01,06T,2464,1222,3686,0.6684753119913185
6621,2013-08-01,06V,1494,628,2122,0.704052780395853
6622,2013-08-01,06W,1508,510,2018,0.7472745292368682
6623,2013-08-01,06Y,1341,541,1882,0.7125398512221042
6624,2013-08-01,07G,920,360,1280,0.71875
6625,2013-08-01,07H,1605,953,2558,0.627443315089914
6626,2013-08-01,07J,801,497,1298,0.6171032357473035
6627,2013-08-01,07K,1608,817,2425,0.6630927835051547
6628,2013-08-01,07L,773,308,1081,0.7150786308973173
6629,2013-08-01,07M,1311,832,2143,0.6117592160522631
6630,2013-08-01,07N,1202,710,1912,0.6286610878661087
6631,2013-08-01,07P,835,538,1373,0.6081573197378004
6632,2013-08-01,07Q,1607,927,2534,0.6341752170481453
6633,2013-08-01,07R,764,518,1282,0.5959438377535101
6634,2013-08-01,07T,623,480,1103,0.5648232094288305
6635,2013-08-01,07V,1809,960,2769,0.6533044420368364
6636,2013-08-01,07W,1135,917,2052,0.5531189083820662
6637,2013-08-01,07X,1281,643,1924,0.6658004158004158
6638,2013-08-01,07Y,860,506,1366,0.6295754026354319
6639,2013-08-01,08A,1238,637,1875,0.6602666666666667
6640,2013-08-01,08C,670,467,1137,0.5892700087950747
6641,2013-08-01,08D,916,505,1421,0.6446164672765659
6642,2013-08-01,08E,863,472,1335,0.6464419475655431
6643,2013-08-01,08F,1360,771,2131,0.6381980290943219
6644,2013-08-01,08G,513,1287,1800,0.285
6645,2013-08-01,08H,846,557,1403,0.6029935851746258
6646,2013-08-01,08J,808,375,1183,0.6830092983939138
6647,2013-08-01,08K,1293,513,1806,0.7159468438538206
6648,2013-08-01,08L,689,1230,1919,0.3590411672746222
6649,2013-08-01,08M,1002,435,1437,0.697286012526096
6650,2013-08-01,08N,1124,502,1626,0.6912669126691267
6651,2013-08-01,08P,929,543,1472,0.6311141304347826
6652,2013-08-01,08Q,1006,425,1431,0.7030048916841369
6653,2013-08-01,08R,863,463,1326,0.6508295625942685
6654,2013-08-01,08T,1006,571,1577,0.6379201014584654
6655,2013-08-01,08V,1087,516,1603,0.6781035558328135
6656,2013-08-01,08W,1055,497,1552,0.6797680412371134
6657,2013-08-01,08X,1359,701,2060,0.6597087378640777
6658,2013-08-01,08Y,774,471,1245,0.6216867469879518
6659,2013-08-01,09A,536,435,971,0.5520082389289392
6660,2013-08-01,09C,795,341,1136,0.6998239436619719
6661,2013-08-01,09D,1514,968,2482,0.6099919419822724
6662,2013-08-01,09E,1432,626,2058,0.6958211856171039
6663,2013-08-01,09F,1374,741,2115,0.649645390070922
6664,2013-08-01,09G,3441,2023,5464,0.6297584187408491
6665,2013-08-01,09H,621,378,999,0.6216216216216216
6666,2013-08-01,09J,1675,913,2588,0.6472179289026275
6667,2013-08-01,09L,881,465,1346,0.6545319465081724
6668,2013-08-01,09N,1117,662,1779,0.6278808319280494
6669,2013-08-01,09P,1199,886,2085,0.5750599520383693
6670,2013-08-01,09W,1417,781,2198,0.6446769790718835
6671,2013-08-01,09X,1188,811,1999,0.5942971485742872
6672,2013-08-01,09Y,1718,1172,2890,0.5944636678200692
6673,2013-08-01,10A,1116,650,1766,0.6319365798414496
6674,2013-08-01,10C,518,273,791,0.6548672566371682
6675,2013-08-01,10D,616,247,863,0.7137891077636153
6676,2013-08-01,10E,802,278,1080,0.7425925925925926
6677,2013-08-01,10G,688,353,1041,0.6609029779058597
6678,2013-08-01,10H,1873,1275,3148,0.5949809402795425
6679,2013-08-01,10J,1220,939,2159,0.5650764242704956
6680,2013-08-01,10K,1383,669,2052,0.6739766081871345
6681,2013-08-01,10L,1012,367,1379,0.7338651196519217
6682,2013-08-01,10M,630,464,1094,0.5758683729433273
6683,2013-08-01,10N,452,420,872,0.518348623853211
6684,2013-08-01,10Q,3094,3017,6111,0.5063001145475372
6685,2013-08-01,10R,1461,575,2036,0.7175834970530451
6686,2013-08-01,10T,577,293,870,0.6632183908045977
6687,2013-08-01,10V,1279,759,2038,0.627576054955839
6688,2013-08-01,10W,625,431,1056,0.5918560606060606
6689,2013-08-01,10X,1222,687,1909,0.6401257202723939
6690,2013-08-01,10Y,1275,836,2111,0.6039791567977262
6691,2013-08-01,11A,3903,1993,5896,0.6619742198100407
6692,2013-08-01,11C,955,450,1405,0.6797153024911032
6693,2013-08-01,11D,712,571,1283,0.5549493374902572
6694,2013-08-01,11E,1292,978,2270,0.5691629955947136
6695,2013-08-01,11H,2626,1526,4152,0.632466281310212
6696,2013-08-01,11J,5326,2764,8090,0.6583436341161928
6697,2013-08-01,11M,3996,2002,5998,0.6662220740246749
6698,2013-08-01,11N,4811,1856,6667,0.7216139193040348
6699,2013-08-01,11T,1632,998,2630,0.620532319391635
6700,2013-08-01,11X,3532,2167,5699,0.6197578522547815
6701,2013-08-01,12A,1609,763,2372,0.6783305227655987
6702,2013-08-01,12D,1223,857,2080,0.5879807692307693
6703,2013-08-01,12F,2671,709,3380,0.7902366863905326
6704,2013-08-01,13P,3394,1751,5145,0.6596695821185617
6705,2013-08-01,13T,3231,1419,4650,0.6948387096774193
6706,2013-08-01,14L,2934,1710,4644,0.6317829457364341
6707,2013-08-01,99A,2719,851,3570,0.7616246498599439
6708,2013-08-01,99C,1626,792,2418,0.6724565756823822
6709,2013-08-01,99D,1156,776,1932,0.598343685300207
6710,2013-08-01,99E,1547,561,2108,0.7338709677419355
6711,2013-08-01,99F,1144,356,1500,0.7626666666666667
6712,2013-08-01,99G,1289,433,1722,0.7485481997677119
6713,2013-08-01,99H,1750,964,2714,0.6448047162859248
6714,2013-08-01,99J,3182,1651,4833,0.6583902338092282
6715,2013-08-01,99K,1073,689,1762,0.6089670828603859
6716,2013-08-01,99M,1083,841,1924,0.5628898128898129
6717,2013-08-01,99N,2946,2593,5539,0.5318649575735692
6718,2013-08-01,99P,6800,2528,9328,0.7289879931389366
6719,2013-08-01,99Q,2131,1014,3145,0.67758346581876
6720,2013-09-01,00C,731,303,1034,0.706963249516441
6721,2013-09-01,00D,2147,1275,3422,0.6274108708357685
6722,2013-09-01,00F,19,7,26,0.7307692307692307
6723,2013-09-01,00J,1743,881,2624,0.6642530487804879
6724,2013-09-01,00K,2274,1079,3353,0.6781986280942439
6725,2013-09-01,00L,2215,1443,3658,0.6055221432476763
6726,2013-09-01,00M,2093,1054,3147,0.6650778519224658
6727,2013-09-01,00N,1173,577,1750,0.6702857142857143
6728,2013-09-01,00P,1968,867,2835,0.6941798941798942
6729,2013-09-01,00Q,964,429,1393,0.6920315865039484
6730,2013-09-01,00R,1210,508,1718,0.7043073341094296
6731,2013-09-01,00T,1984,1209,3193,0.6213592233009708
6732,2013-09-01,00V,1478,802,2280,0.6482456140350877
6733,2013-09-01,00W,38,25,63,0.6031746031746031
6734,2013-09-01,00X,970,257,1227,0.7905460472697636
6735,2013-09-01,00Y,1761,889,2650,0.6645283018867925
6736,2013-09-01,01A,2548,1321,3869,0.6585681054536056
6737,2013-09-01,01C,1317,739,2056,0.6405642023346303
6738,2013-09-01,01D,1585,795,2380,0.6659663865546218
6739,2013-09-01,01E,1203,149,1352,0.889792899408284
6740,2013-09-01,01F,900,503,1403,0.6414825374198146
6741,2013-09-01,01G,1384,1200,2584,0.5356037151702786
6742,2013-09-01,01H,2521,924,3445,0.7317851959361393
6743,2013-09-01,01J,1092,550,1642,0.6650426309378806
6744,2013-09-01,01K,2157,1148,3305,0.6526475037821483
6745,2013-09-01,01N,27,16,43,0.627906976744186
6746,2013-09-01,01R,988,573,1561,0.6329276105060858
6747,2013-09-01,01T,878,450,1328,0.661144578313253
6748,2013-09-01,01V,837,341,1178,0.7105263157894737
6749,2013-09-01,01W,2007,913,2920,0.6873287671232877
6750,2013-09-01,01X,1434,715,2149,0.6672871102838529
6751,2013-09-01,01Y,1327,843,2170,0.6115207373271889
6752,2013-09-01,02A,1331,653,1984,0.670866935483871
6753,2013-09-01,02D,519,411,930,0.5580645161290323
6754,2013-09-01,02E,1231,551,1782,0.6907968574635241
6755,2013-09-01,02F,1724,668,2392,0.7207357859531772
6756,2013-09-01,02G,628,353,981,0.6401630988786952
6757,2013-09-01,02H,1684,1326,3010,0.5594684385382059
6758,2013-09-01,02M,1029,411,1440,0.7145833333333333
6759,2013-09-01,02N,1118,678,1796,0.6224944320712695
6760,2013-09-01,02P,1168,1224,2392,0.4882943143812709
6761,2013-09-01,02Q,684,479,1163,0.588134135855546
6762,2013-09-01,02R,2166,1222,3388,0.6393152302243211
6763,2013-09-01,02T,1148,769,1917,0.5988523735002608
6764,2013-09-01,02V,1384,646,2030,0.6817733990147783
6765,2013-09-01,02W,520,298,818,0.6356968215158925
6766,2013-09-01,02X,1895,1029,2924,0.6480848153214774
6767,2013-09-01,02Y,2056,887,2943,0.6986068637444784
6768,2013-09-01,03A,1320,649,1969,0.6703910614525139
6769,2013-09-01,03C,1963,1139,3102,0.6328175370728563
6770,2013-09-01,03D,936,400,1336,0.7005988023952096
6771,2013-09-01,03E,938,521,1459,0.6429061000685401
6772,2013-09-01,03F,1644,601,2245,0.7322939866369711
6773,2013-09-01,03G,1690,772,2462,0.6864337936636881
6774,2013-09-01,03H,1261,498,1759,0.7168845935190449
6775,2013-09-01,03J,1212,503,1715,0.7067055393586006
6776,2013-09-01,03K,990,266,1256,0.7882165605095541
6777,2013-09-01,03L,1338,1087,2425,0.5517525773195876
6778,2013-09-01,03M,826,449,1275,0.647843137254902
6779,2013-09-01,03N,3135,969,4104,0.7638888888888888
6780,2013-09-01,03Q,1972,1022,2994,0.6586506346025384
6781,2013-09-01,03R,2486,1112,3598,0.6909394107837687
6782,2013-09-01,03T,1824,732,2556,0.7136150234741784
6783,2013-09-01,03V,450,260,710,0.6338028169014085
6784,2013-09-01,03W,2366,1078,3444,0.6869918699186992
6785,2013-09-01,03X,486,286,772,0.6295336787564767
6786,2013-09-01,03Y,719,341,1060,0.6783018867924528
6787,2013-09-01,04C,2120,802,2922,0.7255304585900069
6788,2013-09-01,04D,1312,721,2033,0.6453516969995081
6789,2013-09-01,04E,1193,671,1864,0.6400214592274678
6790,2013-09-01,04F,1535,1066,2601,0.590157631680123
6791,2013-09-01,04G,4167,2353,6520,0.6391104294478528
6792,2013-09-01,04H,727,343,1070,0.6794392523364486
6793,2013-09-01,04J,2033,1130,3163,0.6427442301612394
6794,2013-09-01,04K,1616,704,2320,0.696551724137931
6795,2013-09-01,04L,835,377,1212,0.6889438943894389
6796,2013-09-01,04M,524,263,787,0.6658195679796697
6797,2013-09-01,04N,707,310,1017,0.6951819075712881
6798,2013-09-01,04Q,868,380,1248,0.6955128205128205
6799,2013-09-01,04R,2719,1365,4084,0.6657688540646425
6800,2013-09-01,04V,2306,1090,3396,0.6790341578327445
6801,2013-09-01,04X,1369,1115,2484,0.5511272141706924
6802,2013-09-01,04Y,981,371,1352,0.7255917159763313
6803,2013-09-01,05A,2873,1513,4386,0.6550387596899225
6804,2013-09-01,05C,1162,1717,2879,0.4036123654046544
6805,2013-09-01,05D,967,488,1455,0.6646048109965635
6806,2013-09-01,05F,1356,636,1992,0.6807228915662651
6807,2013-09-01,05G,1568,570,2138,0.7333956969130028
6808,2013-09-01,05H,1160,646,1806,0.6423034330011074
6809,2013-09-01,05J,1482,628,2110,0.7023696682464455
6810,2013-09-01,05L,2535,1293,3828,0.6622257053291536
6811,2013-09-01,05N,2273,823,3096,0.7341731266149871
6812,2013-09-01,05P,1484,866,2350,0.6314893617021277
6813,2013-09-01,05Q,1513,635,2148,0.7043761638733705
6814,2013-09-01,05R,1774,1133,2907,0.610251117991056
6815,2013-09-01,05T,2064,1068,3132,0.6590038314176245
6816,2013-09-01,05V,983,422,1405,0.699644128113879
6817,2013-09-01,05W,1710,693,2403,0.7116104868913857
6818,2013-09-01,05X,1159,355,1514,0.7655217965653897
6819,2013-09-01,05Y,1823,934,2757,0.6612259702575263
6820,2013-09-01,06A,1568,687,2255,0.6953436807095343
6821,2013-09-01,06D,1013,400,1413,0.7169143665958952
6822,2013-09-01,06F,1580,2420,4000,0.395
6823,2013-09-01,06H,5441,2919,8360,0.6508373205741627
6824,2013-09-01,06K,3262,2272,5534,0.5894470545717383
6825,2013-09-01,06L,2533,1129,3662,0.6916985253959584
6826,2013-09-01,06M,2052,874,2926,0.7012987012987013
6827,2013-09-01,06N,3351,2223,5574,0.601184068891281
6828,2013-09-01,06P,961,989,1950,0.4928205128205128
6829,2013-09-01,06Q,2533,1229,3762,0.6733120680489102
6830,2013-09-01,06T,2348,1169,3517,0.6676144441285187
6831,2013-09-01,06V,1426,596,2022,0.705242334322453
6832,2013-09-01,06W,1482,523,2005,0.7391521197007481
6833,2013-09-01,06Y,1353,555,1908,0.7091194968553459
6834,2013-09-01,07G,889,354,1243,0.7152051488334674
6835,2013-09-01,07H,1686,975,2661,0.6335963923337091
6836,2013-09-01,07J,736,502,1238,0.5945072697899838
6837,2013-09-01,07K,1569,777,2346,0.6687979539641944
6838,2013-09-01,07L,821,319,1140,0.7201754385964912
6839,2013-09-01,07M,1169,738,1907,0.6130047194546407
6840,2013-09-01,07N,1365,706,2071,0.6591018831482376
6841,2013-09-01,07P,965,579,1544,0.625
6842,2013-09-01,07Q,1679,881,2560,0.655859375
6843,2013-09-01,07R,747,571,1318,0.5667678300455236
6844,2013-09-01,07T,737,504,1241,0.5938759065269944
6845,2013-09-01,07V,1825,947,2772,0.6583694083694084
6846,2013-09-01,07W,1155,891,2046,0.5645161290322581
6847,2013-09-01,07X,1341,637,1978,0.6779575328614762
6848,2013-09-01,07Y,886,554,1440,0.6152777777777778
6849,2013-09-01,08A,1288,618,1906,0.6757607555089192
6850,2013-09-01,08C,692,421,1113,0.6217430368373764
6851,2013-09-01,08D,948,552,1500,0.632
6852,2013-09-01,08E,922,490,1412,0.6529745042492918
6853,2013-09-01,08F,1424,743,2167,0.6571296723580987
6854,2013-09-01,08G,535,1311,1846,0.2898158179848321
6855,2013-09-01,08H,861,567,1428,0.6029411764705882
6856,2013-09-01,08J,892,486,1378,0.6473149492017417
6857,2013-09-01,08K,1237,527,1764,0.7012471655328798
6858,2013-09-01,08L,747,1250,1997,0.3740610916374562
6859,2013-09-01,08M,1098,458,1556,0.705655526992288
6860,2013-09-01,08N,1168,600,1768,0.6606334841628959
6861,2013-09-01,08P,946,506,1452,0.6515151515151515
6862,2013-09-01,08Q,1170,436,1606,0.7285180572851806
6863,2013-09-01,08R,889,440,1329,0.6689240030097818
6864,2013-09-01,08T,1020,496,1516,0.6728232189973615
6865,2013-09-01,08V,1178,531,1709,0.6892919836161499
6866,2013-09-01,08W,1107,517,1624,0.6816502463054187
6867,2013-09-01,08X,1320,664,1984,0.6653225806451613
6868,2013-09-01,08Y,745,505,1250,0.596
6869,2013-09-01,09A,631,480,1111,0.5679567956795679
6870,2013-09-01,09C,768,342,1110,0.6918918918918919
6871,2013-09-01,09D,1487,896,2383,0.6240033571128829
6872,2013-09-01,09E,1512,595,2107,0.717607973421927
6873,2013-09-01,09F,1323,701,2024,0.6536561264822134
6874,2013-09-01,09G,3482,2017,5499,0.6332060374613566
6875,2013-09-01,09H,634,338,972,0.6522633744855967
6876,2013-09-01,09J,1697,955,2652,0.639894419306184
6877,2013-09-01,09L,924,468,1392,0.6637931034482759
6878,2013-09-01,09N,1195,660,1855,0.6442048517520216
6879,2013-09-01,09P,1248,852,2100,0.5942857142857143
6880,2013-09-01,09W,1396,731,2127,0.6563234602726845
6881,2013-09-01,09X,1172,768,1940,0.6041237113402061
6882,2013-09-01,09Y,1632,1159,2791,0.584736653529201
6883,2013-09-01,10A,1185,658,1843,0.6429734129137277
6884,2013-09-01,10C,477,270,747,0.6385542168674698
6885,2013-09-01,10D,663,248,911,0.7277716794731065
6886,2013-09-01,10E,809,296,1105,0.7321266968325791
6887,2013-09-01,10G,709,364,1073,0.6607642124883504
6888,2013-09-01,10H,1911,1371,3282,0.5822669104204753
6889,2013-09-01,10J,1098,898,1996,0.5501002004008017
6890,2013-09-01,10K,1372,713,2085,0.6580335731414868
6891,2013-09-01,10L,1073,397,1470,0.7299319727891157
6892,2013-09-01,10M,614,447,1061,0.5786993402450519
6893,2013-09-01,10N,519,381,900,0.5766666666666667
6894,2013-09-01,10Q,3099,2946,6045,0.5126550868486353
6895,2013-09-01,10R,1488,600,2088,0.7126436781609196
6896,2013-09-01,10T,588,306,894,0.6577181208053692
6897,2013-09-01,10V,1244,670,1914,0.6499477533960293
6898,2013-09-01,10W,584,376,960,0.6083333333333333
6899,2013-09-01,10X,1281,718,1999,0.6408204102051025
6900,2013-09-01,10Y,1290,799,2089,0.6175203446625179
6901,2013-09-01,11A,3691,1933,5624,0.656294452347084
6902,2013-09-01,11C,867,414,1281,0.6768149882903981
6903,2013-09-01,11D,708,551,1259,0.562351072279587
6904,2013-09-01,11E,1243,883,2126,0.5846660395108184
6905,2013-09-01,11H,2766,1519,4285,0.645507584597433
6906,2013-09-01,11J,5354,2682,8036,0.6662518666002987
6907,2013-09-01,11M,4014,1922,5936,0.6762129380053908
6908,2013-09-01,11N,4438,1758,6196,0.7162685603615235
6909,2013-09-01,11T,1514,956,2470,0.6129554655870445
6910,2013-09-01,11X,3541,2024,5565,0.6362982929020665
6911,2013-09-01,12A,1492,701,2193,0.6803465572275422
6912,2013-09-01,12D,1177,801,1978,0.5950455005055612
6913,2013-09-01,12F,2585,712,3297,0.7840461025174401
6914,2013-09-01,13P,3459,1687,5146,0.6721725612125923
6915,2013-09-01,13T,3260,1402,4662,0.6992706992706993
6916,2013-09-01,14L,3167,1801,4968,0.6374798711755234
6917,2013-09-01,99A,2811,926,3737,0.7522076531977522
6918,2013-09-01,99C,1565,761,2326,0.672828890799656
6919,2013-09-01,99D,1085,718,1803,0.6017748197448697
6920,2013-09-01,99E,1557,628,2185,0.7125858123569794
6921,2013-09-01,99F,1184,389,1573,0.7527018436109345
6922,2013-09-01,99G,1210,440,1650,0.7333333333333333
6923,2013-09-01,99H,1668,957,2625,0.6354285714285715
6924,2013-09-01,99J,3249,1672,4921,0.6602316602316602
6925,2013-09-01,99K,1054,566,1620,0.6506172839506172
6926,2013-09-01,99M,1064,846,1910,0.5570680628272251
6927,2013-09-01,99N,2870,2514,5384,0.5330609212481426
6928,2013-09-01,99P,6696,2443,9139,0.7326841011051537
6929,2013-09-01,99Q,2098,937,3035,0.6912685337726524
6930,2013-10-01,00C,815,277,1092,0.7463369963369964
6931,2013-10-01,00D,2258,1224,3482,0.6484778862722573
6932,2013-10-01,00J,1984,949,2933,0.6764405046027958
6933,2013-10-01,00K,2429,1101,3530,0.6881019830028329
6934,2013-10-01,00L,2457,1509,3966,0.6195158850226928
6935,2013-10-01,00M,2309,1145,3454,0.6685002895193978
6936,2013-10-01,00N,1241,637,1878,0.6608093716719915
6937,2013-10-01,00P,2146,926,3072,0.6985677083333334
6938,2013-10-01,00Q,1034,456,1490,0.6939597315436241
6939,2013-10-01,00R,1178,491,1669,0.7058118633912522
6940,2013-10-01,00T,2074,1211,3285,0.6313546423135464
6941,2013-10-01,00V,1515,852,2367,0.6400506970849176
6942,2013-10-01,00W,43,16,59,0.7288135593220338
6943,2013-10-01,00X,1088,272,1360,0.8
6944,2013-10-01,00Y,1907,997,2904,0.6566804407713499
6945,2013-10-01,01A,2658,1336,3994,0.6654982473710566
6946,2013-10-01,01C,1363,811,2174,0.6269549218031278
6947,2013-10-01,01D,1668,862,2530,0.6592885375494071
6948,2013-10-01,01E,1163,193,1356,0.8576696165191741
6949,2013-10-01,01F,974,528,1502,0.6484687083888149
6950,2013-10-01,01G,1531,1302,2833,0.54041651959054
6951,2013-10-01,01H,2580,933,3513,0.7344150298889838
6952,2013-10-01,01J,1158,551,1709,0.6775892334698654
6953,2013-10-01,01K,2294,1155,3449,0.6651203247318063
6954,2013-10-01,01N,18,23,41,0.43902439024390244
6955,2013-10-01,01R,1147,594,1741,0.6588167719701321
6956,2013-10-01,01T,927,473,1400,0.6621428571428571
6957,2013-10-01,01V,901,368,1269,0.7100078802206462
6958,2013-10-01,01W,2272,980,3252,0.6986469864698647
6959,2013-10-01,01X,1564,733,2297,0.6808881149325207
6960,2013-10-01,01Y,1441,853,2294,0.6281604184829991
6961,2013-10-01,02A,1437,697,2134,0.6733833177132146
6962,2013-10-01,02D,542,439,981,0.5524974515800204
6963,2013-10-01,02E,1421,562,1983,0.7165910237014624
6964,2013-10-01,02F,1772,688,2460,0.7203252032520325
6965,2013-10-01,02G,704,352,1056,0.6666666666666666
6966,2013-10-01,02H,1836,1433,3269,0.5616396451514225
6967,2013-10-01,02M,1182,398,1580,0.7481012658227848
6968,2013-10-01,02N,1075,672,1747,0.6153405838580424
6969,2013-10-01,02P,1353,1259,2612,0.5179938744257274
6970,2013-10-01,02Q,630,532,1162,0.5421686746987951
6971,2013-10-01,02R,2195,1224,3419,0.6420005849663645
6972,2013-10-01,02T,1271,841,2112,0.6017992424242424
6973,2013-10-01,02V,1407,719,2126,0.6618062088428974
6974,2013-10-01,02W,529,305,834,0.6342925659472423
6975,2013-10-01,02X,2152,1126,3278,0.6564978645515558
6976,2013-10-01,02Y,2093,935,3028,0.6912153236459709
6977,2013-10-01,03A,1454,650,2104,0.69106463878327
6978,2013-10-01,03C,2140,1297,3437,0.622636019784696
6979,2013-10-01,03D,911,414,1325,0.6875471698113208
6980,2013-10-01,03E,1028,567,1595,0.6445141065830721
6981,2013-10-01,03F,1853,701,2554,0.7255285826155051
6982,2013-10-01,03G,1890,817,2707,0.6981898780938308
6983,2013-10-01,03H,1283,499,1782,0.7199775533108866
6984,2013-10-01,03J,1228,507,1735,0.7077809798270893
6985,2013-10-01,03K,1055,293,1348,0.7826409495548962
6986,2013-10-01,03L,1386,1186,2572,0.5388802488335925
6987,2013-10-01,03M,905,462,1367,0.662033650329188
6988,2013-10-01,03N,3728,1032,4760,0.7831932773109244
6989,2013-10-01,03Q,2121,1122,3243,0.6540240518038853
6990,2013-10-01,03R,2642,1195,3837,0.688558769872296
6991,2013-10-01,03T,2031,785,2816,0.7212357954545454
6992,2013-10-01,03V,430,261,691,0.622286541244573
6993,2013-10-01,03W,2603,1119,3722,0.699355185384202
6994,2013-10-01,03X,566,291,857,0.6604434072345391
6995,2013-10-01,03Y,793,394,1187,0.6680707666385847
6996,2013-10-01,04C,2271,918,3189,0.7121354656632173
6997,2013-10-01,04D,1483,728,2211,0.670737222976029
6998,2013-10-01,04E,1357,650,2007,0.6761335326357748
6999,2013-10-01,04F,1649,1188,2837,0.5812477969686288
7000,2013-10-01,04G,4529,2459,6988,0.6481110475100171
7001,2013-10-01,04H,786,402,1188,0.6616161616161617
7002,2013-10-01,04J,2178,1188,3366,0.6470588235294118
7003,2013-10-01,04K,1904,898,2802,0.6795146324054246
7004,2013-10-01,04L,970,395,1365,0.7106227106227107
7005,2013-10-01,04M,581,238,819,0.7094017094017094
7006,2013-10-01,04N,802,326,1128,0.7109929078014184
7007,2013-10-01,04Q,880,400,1280,0.6875
7008,2013-10-01,04R,2914,1502,4416,0.6598731884057971
7009,2013-10-01,04V,2591,1139,3730,0.6946380697050938
7010,2013-10-01,04X,1470,1181,2651,0.5545077329309694
7011,2013-10-01,04Y,1050,371,1421,0.7389162561576355
7012,2013-10-01,05A,2996,1684,4680,0.6401709401709401
7013,2013-10-01,05C,1285,1878,3163,0.40625987986089157
7014,2013-10-01,05D,991,487,1478,0.6705006765899865
7015,2013-10-01,05F,1416,632,2048,0.69140625
7016,2013-10-01,05G,1754,600,2354,0.7451146983857264
7017,2013-10-01,05H,1285,687,1972,0.6516227180527383
7018,2013-10-01,05J,1507,635,2142,0.7035480859010271
7019,2013-10-01,05L,2876,1422,4298,0.6691484411354118
7020,2013-10-01,05N,2498,854,3352,0.7452267303102625
7021,2013-10-01,05P,1464,901,2365,0.6190274841437632
7022,2013-10-01,05Q,1547,667,2214,0.6987353206865402
7023,2013-10-01,05R,2014,1214,3228,0.6239157372986369
7024,2013-10-01,05T,2366,1163,3529,0.6704448852366109
7025,2013-10-01,05V,1068,456,1524,0.7007874015748031
7026,2013-10-01,05W,1679,740,2419,0.6940884663083919
7027,2013-10-01,05X,1287,456,1743,0.7383820998278829
7028,2013-10-01,05Y,1960,953,2913,0.6728458633710951
7029,2013-10-01,06A,1716,748,2464,0.6964285714285714
7030,2013-10-01,06D,995,408,1403,0.7091945830363506
7031,2013-10-01,06F,1765,2637,4402,0.40095411176737844
7032,2013-10-01,06H,5725,3057,8782,0.6519016169437486
7033,2013-10-01,06K,3459,2535,5994,0.5770770770770771
7034,2013-10-01,06L,2689,1190,3879,0.6932199020366073
7035,2013-10-01,06M,2065,903,2968,0.6957547169811321
7036,2013-10-01,06N,3676,2441,6117,0.6009481772110512
7037,2013-10-01,06P,1014,1024,2038,0.4975466143277723
7038,2013-10-01,06Q,2530,1321,3851,0.6569722150090885
7039,2013-10-01,06T,2456,1279,3735,0.6575635876840696
7040,2013-10-01,06V,1538,605,2143,0.7176854876341577
7041,2013-10-01,06W,1583,477,2060,0.7684466019417475
7042,2013-10-01,06Y,1401,627,2028,0.6908284023668639
7043,2013-10-01,07G,994,366,1360,0.7308823529411764
7044,2013-10-01,07H,1816,1039,2855,0.636077057793345
7045,2013-10-01,07J,765,470,1235,0.6194331983805668
7046,2013-10-01,07K,1628,766,2394,0.6800334168755221
7047,2013-10-01,07L,922,325,1247,0.739374498797113
7048,2013-10-01,07M,1348,801,2149,0.6272684969753374
7049,2013-10-01,07N,1419,722,2141,0.662774404483886
7050,2013-10-01,07P,967,624,1591,0.6077938403519799
7051,2013-10-01,07Q,1703,936,2639,0.645320197044335
7052,2013-10-01,07R,883,593,1476,0.5982384823848238
7053,2013-10-01,07T,781,489,1270,0.6149606299212599
7054,2013-10-01,07V,1931,918,2849,0.6777816777816777
7055,2013-10-01,07W,1284,1016,2300,0.5582608695652174
7056,2013-10-01,07X,1571,627,2198,0.7147406733393995
7057,2013-10-01,07Y,962,623,1585,0.6069400630914826
7058,2013-10-01,08A,1348,656,2004,0.6726546906187625
7059,2013-10-01,08C,717,413,1130,0.6345132743362832
7060,2013-10-01,08D,992,645,1637,0.6059865607819181
7061,2013-10-01,08E,969,501,1470,0.6591836734693878
7062,2013-10-01,08F,1534,776,2310,0.664069264069264
7063,2013-10-01,08G,543,1419,1962,0.27675840978593275
7064,2013-10-01,08H,870,576,1446,0.6016597510373444
7065,2013-10-01,08J,981,433,1414,0.6937765205091938
7066,2013-10-01,08K,1300,560,1860,0.6989247311827957
7067,2013-10-01,08L,776,1300,2076,0.3737957610789981
7068,2013-10-01,08M,1112,446,1558,0.7137355584082157
7069,2013-10-01,08N,1172,557,1729,0.6778484673221515
7070,2013-10-01,08P,1067,574,1641,0.6502132845825715
7071,2013-10-01,08Q,1117,479,1596,0.699874686716792
7072,2013-10-01,08R,972,486,1458,0.6666666666666666
7073,2013-10-01,08T,1063,518,1581,0.67235926628716
7074,2013-10-01,08V,1116,558,1674,0.6666666666666666
7075,2013-10-01,08W,1130,520,1650,0.6848484848484848
7076,2013-10-01,08X,1486,760,2246,0.661620658949243
7077,2013-10-01,08Y,832,561,1393,0.5972720746590093
7078,2013-10-01,09A,596,568,1164,0.5120274914089347
7079,2013-10-01,09C,803,330,1133,0.7087378640776699
7080,2013-10-01,09D,1811,1113,2924,0.6193570451436389
7081,2013-10-01,09E,1650,625,2275,0.7252747252747253
7082,2013-10-01,09F,1436,810,2246,0.6393588601959038
7083,2013-10-01,09G,3868,2001,5869,0.6590560572499574
7084,2013-10-01,09H,685,406,1091,0.6278643446379468
7085,2013-10-01,09J,1817,974,2791,0.6510211393765676
7086,2013-10-01,09L,989,497,1486,0.6655450874831763
7087,2013-10-01,09N,1275,733,2008,0.6349601593625498
7088,2013-10-01,09P,1325,896,2221,0.5965781179648807
7089,2013-10-01,09W,1508,800,2308,0.6533795493934142
7090,2013-10-01,09X,1273,910,2183,0.5831424644983967
7091,2013-10-01,09Y,1787,1198,2985,0.5986599664991625
7092,2013-10-01,10A,1262,735,1997,0.6319479218828242
7093,2013-10-01,10C,533,283,816,0.6531862745098039
7094,2013-10-01,10D,721,256,977,0.7379733879222109
7095,2013-10-01,10E,876,343,1219,0.7186218211648893
7096,2013-10-01,10G,785,393,1178,0.666383701188455
7097,2013-10-01,10H,1985,1290,3275,0.6061068702290077
7098,2013-10-01,10J,1274,995,2269,0.5614808285588365
7099,2013-10-01,10K,1323,718,2041,0.6482116609505144
7100,2013-10-01,10L,1113,377,1490,0.7469798657718121
7101,2013-10-01,10M,651,462,1113,0.5849056603773585
7102,2013-10-01,10N,546,520,1066,0.5121951219512195
7103,2013-10-01,10Q,3403,3072,6475,0.5255598455598456
7104,2013-10-01,10R,1515,628,2143,0.7069528698086794
7105,2013-10-01,10T,602,354,956,0.6297071129707112
7106,2013-10-01,10V,1427,699,2126,0.6712135465663217
7107,2013-10-01,10W,731,418,1149,0.6362053959965187
7108,2013-10-01,10X,1369,738,2107,0.6497389653535833
7109,2013-10-01,10Y,1357,924,2281,0.5949145111793073
7110,2013-10-01,11A,3899,2050,5949,0.6554042696251471
7111,2013-10-01,11C,992,445,1437,0.6903270702853166
7112,2013-10-01,11D,725,667,1392,0.5208333333333334
7113,2013-10-01,11E,1352,993,2345,0.5765458422174841
7114,2013-10-01,11H,2766,1644,4410,0.6272108843537415
7115,2013-10-01,11J,5708,2690,8398,0.6796856394379615
7116,2013-10-01,11M,4184,2057,6241,0.6704053837526037
7117,2013-10-01,11N,4782,1877,6659,0.7181258447214296
7118,2013-10-01,11T,1720,918,2638,0.6520090978013646
7119,2013-10-01,11X,3739,2163,5902,0.6335140630294815
7120,2013-10-01,12A,1643,805,2448,0.6711601307189542
7121,2013-10-01,12D,1240,899,2139,0.5797101449275363
7122,2013-10-01,12F,2749,764,3513,0.7825220609165955
7123,2013-10-01,13P,3627,1745,5372,0.6751675353685778
7124,2013-10-01,13T,3434,1477,4911,0.6992465892893505
7125,2013-10-01,14L,3367,1983,5350,0.6293457943925234
7126,2013-10-01,99A,3098,946,4044,0.7660731948565777
7127,2013-10-01,99C,1656,786,2442,0.6781326781326781
7128,2013-10-01,99D,1181,719,1900,0.621578947368421
7129,2013-10-01,99E,1634,659,2293,0.7126035761011775
7130,2013-10-01,99F,1197,438,1635,0.7321100917431193
7131,2013-10-01,99G,1273,446,1719,0.7405468295520652
7132,2013-10-01,99H,1827,1119,2946,0.620162932790224
7133,2013-10-01,99J,3420,1870,5290,0.6465028355387523
7134,2013-10-01,99K,1099,611,1710,0.6426900584795322
7135,2013-10-01,99M,1188,907,2095,0.5670644391408115
7136,2013-10-01,99N,3092,2640,5732,0.5394277739009072
7137,2013-10-01,99P,7221,2646,9867,0.731833384007297
7138,2013-10-01,99Q,2263,981,3244,0.6975955610357584
7139,2013-11-01,00C,725,326,1051,0.6898192197906755
7140,2013-11-01,00D,2186,1118,3304,0.6616222760290557
7141,2013-11-01,00J,1925,935,2860,0.6730769230769231
7142,2013-11-01,00K,2221,1094,3315,0.6699849170437405
7143,2013-11-01,00L,2323,1339,3662,0.6343528126706718
7144,2013-11-01,00M,2123,1074,3197,0.6640600563027839
7145,2013-11-01,00N,1192,627,1819,0.6553051126992854
7146,2013-11-01,00P,2126,877,3003,0.707958707958708
7147,2013-11-01,00Q,997,463,1460,0.6828767123287671
7148,2013-11-01,00R,1181,493,1674,0.7054958183990442
7149,2013-11-01,00T,1952,1173,3125,0.62464
7150,2013-11-01,00V,1448,802,2250,0.6435555555555555
7151,2013-11-01,00W,45,23,68,0.6617647058823529
7152,2013-11-01,00X,1063,284,1347,0.7891610987379362
7153,2013-11-01,00Y,1874,946,2820,0.6645390070921986
7154,2013-11-01,01A,2429,1246,3675,0.660952380952381
7155,2013-11-01,01C,1350,783,2133,0.6329113924050633
7156,2013-11-01,01D,1594,859,2453,0.6498165511618427
7157,2013-11-01,01E,1151,174,1325,0.8686792452830189
7158,2013-11-01,01F,904,502,1406,0.6429587482219061
7159,2013-11-01,01G,1449,1154,2603,0.5566653860929697
7160,2013-11-01,01H,2449,878,3327,0.7360985873159002
7161,2013-11-01,01J,1091,533,1624,0.6717980295566502
7162,2013-11-01,01K,2112,1136,3248,0.6502463054187192
7163,2013-11-01,01N,19,15,34,0.5588235294117647
7164,2013-11-01,01R,1026,560,1586,0.6469104665825978
7165,2013-11-01,01T,860,412,1272,0.6761006289308176
7166,2013-11-01,01V,860,363,1223,0.7031888798037612
7167,2013-11-01,01W,1992,989,2981,0.6682321368668233
7168,2013-11-01,01X,1456,711,2167,0.6718966312874942
7169,2013-11-01,01Y,1332,837,2169,0.6141078838174274
7170,2013-11-01,02A,1336,692,2028,0.6587771203155819
7171,2013-11-01,02D,485,442,927,0.52319309600863
7172,2013-11-01,02E,1316,529,1845,0.7132791327913279
7173,2013-11-01,02F,1646,657,2303,0.7147199305254016
7174,2013-11-01,02G,717,354,1071,0.6694677871148459
7175,2013-11-01,02H,1799,1380,3179,0.5659012268008807
7176,2013-11-01,02M,1066,407,1473,0.723693143245078
7177,2013-11-01,02N,983,665,1648,0.5964805825242718
7178,2013-11-01,02P,1259,1205,2464,0.5109577922077922
7179,2013-11-01,02Q,587,444,1031,0.5693501454898157
7180,2013-11-01,02R,2170,1165,3335,0.6506746626686657
7181,2013-11-01,02T,1249,772,2021,0.6180108857001484
7182,2013-11-01,02V,1349,669,2018,0.6684836471754212
7183,2013-11-01,02W,601,317,918,0.6546840958605664
7184,2013-11-01,02X,1959,930,2889,0.6780893042575286
7185,2013-11-01,02Y,2039,920,2959,0.6890841500506928
7186,2013-11-01,03A,1308,589,1897,0.6895097522403796
7187,2013-11-01,03C,1900,1220,3120,0.6089743589743589
7188,2013-11-01,03D,849,400,1249,0.6797437950360288
7189,2013-11-01,03E,972,492,1464,0.6639344262295082
7190,2013-11-01,03F,1667,673,2340,0.7123931623931624
7191,2013-11-01,03G,1726,764,2490,0.6931726907630522
7192,2013-11-01,03H,1316,488,1804,0.729490022172949
7193,2013-11-01,03J,1169,501,1670,0.7
7194,2013-11-01,03K,1024,286,1310,0.7816793893129771
7195,2013-11-01,03L,1305,1099,2404,0.5428452579034941
7196,2013-11-01,03M,844,438,1282,0.6583463338533542
7197,2013-11-01,03N,3331,985,4316,0.7717794253938832
7198,2013-11-01,03Q,1978,993,2971,0.6657691013126893
7199,2013-11-01,03R,2411,1165,3576,0.6742170022371364
7200,2013-11-01,03T,1876,804,2680,0.7
7201,2013-11-01,03V,420,219,639,0.6572769953051644
7202,2013-11-01,03W,2306,1033,3339,0.6906259359089548
7203,2013-11-01,03X,528,295,823,0.6415552855407047
7204,2013-11-01,03Y,700,373,1073,0.65237651444548
7205,2013-11-01,04C,2016,908,2924,0.6894664842681258
7206,2013-11-01,04D,1390,717,2107,0.6597057427622212
7207,2013-11-01,04E,1226,647,1873,0.6545648691938067
7208,2013-11-01,04F,1564,1024,2588,0.6043276661514683
7209,2013-11-01,04G,4159,2297,6456,0.6442069392812887
7210,2013-11-01,04H,768,337,1105,0.6950226244343891
7211,2013-11-01,04J,1979,1094,3073,0.643996095021152
7212,2013-11-01,04K,1694,972,2666,0.6354088522130532
7213,2013-11-01,04L,927,344,1271,0.7293469708890638
7214,2013-11-01,04M,493,243,736,0.6698369565217391
7215,2013-11-01,04N,723,290,1013,0.7137216189536032
7216,2013-11-01,04Q,825,340,1165,0.7081545064377682
7217,2013-11-01,04R,2755,1461,4216,0.6534629981024668
7218,2013-11-01,04V,2444,1111,3555,0.6874824191279888
7219,2013-11-01,04X,1394,1068,2462,0.5662063363119415
7220,2013-11-01,04Y,1013,431,1444,0.7015235457063712
7221,2013-11-01,05A,2744,1568,4312,0.6363636363636364
7222,2013-11-01,05C,1221,1767,2988,0.4086345381526104
7223,2013-11-01,05D,952,483,1435,0.6634146341463415
7224,2013-11-01,05F,1238,641,1879,0.658861096327834
7225,2013-11-01,05G,1582,628,2210,0.7158371040723982
7226,2013-11-01,05H,1201,621,1822,0.6591657519209659
7227,2013-11-01,05J,1388,593,1981,0.7006562342251388
7228,2013-11-01,05L,2586,1304,3890,0.6647814910025707
7229,2013-11-01,05N,2357,835,3192,0.7384085213032582
7230,2013-11-01,05P,1390,914,2304,0.6032986111111112
7231,2013-11-01,05Q,1387,657,2044,0.6785714285714286
7232,2013-11-01,05R,1858,1209,3067,0.605803716987284
7233,2013-11-01,05T,2075,1077,3152,0.6583121827411168
7234,2013-11-01,05V,999,447,1446,0.6908713692946058
7235,2013-11-01,05W,1616,701,2317,0.6974536037980147
7236,2013-11-01,05X,1189,407,1596,0.7449874686716792
7237,2013-11-01,05Y,1834,926,2760,0.6644927536231884
7238,2013-11-01,06A,1654,684,2338,0.7074422583404619
7239,2013-11-01,06D,967,444,1411,0.6853295535081503
7240,2013-11-01,06F,1592,2595,4187,0.380224504418438
7241,2013-11-01,06H,5254,2888,8142,0.6452959960697617
7242,2013-11-01,06K,3260,2313,5573,0.5849632155033195
7243,2013-11-01,06L,2521,1182,3703,0.6807993518768566
7244,2013-11-01,06M,1900,886,2786,0.6819813352476669
7245,2013-11-01,06N,3408,2269,5677,0.6003170688744055
7246,2013-11-01,06P,906,933,1839,0.4926590538336052
7247,2013-11-01,06Q,2427,1252,3679,0.6596901331883664
7248,2013-11-01,06T,2341,1256,3597,0.6508201278843481
7249,2013-11-01,06V,1404,558,1962,0.7155963302752294
7250,2013-11-01,06W,1632,520,2152,0.758364312267658
7251,2013-11-01,06Y,1330,554,1884,0.7059447983014862
7252,2013-11-01,07G,927,367,1294,0.7163833075734157
7253,2013-11-01,07H,1723,1011,2734,0.6302121433796635
7254,2013-11-01,07J,758,488,1246,0.608346709470305
7255,2013-11-01,07K,1577,763,2340,0.673931623931624
7256,2013-11-01,07L,785,354,1139,0.6892010535557507
7257,2013-11-01,07M,1332,782,2114,0.630085146641438
7258,2013-11-01,07N,1299,665,1964,0.6614052953156823
7259,2013-11-01,07P,953,562,1515,0.6290429042904291
7260,2013-11-01,07Q,1603,871,2474,0.6479385610347616
7261,2013-11-01,07R,767,568,1335,0.5745318352059925
7262,2013-11-01,07T,680,436,1116,0.6093189964157706
7263,2013-11-01,07V,1819,917,2736,0.6648391812865497
7264,2013-11-01,07W,1146,916,2062,0.5557710960232783
7265,2013-11-01,07X,1402,654,2056,0.6819066147859922
7266,2013-11-01,07Y,868,563,1431,0.6065688329839273
7267,2013-11-01,08A,1204,627,1831,0.6575641725832878
7268,2013-11-01,08C,626,444,1070,0.5850467289719626
7269,2013-11-01,08D,921,597,1518,0.6067193675889329
7270,2013-11-01,08E,864,535,1399,0.6175839885632595
7271,2013-11-01,08F,1438,756,2194,0.6554238833181404
7272,2013-11-01,08G,513,1279,1792,0.28627232142857145
7273,2013-11-01,08H,857,591,1448,0.5918508287292817
7274,2013-11-01,08J,913,419,1332,0.6854354354354354
7275,2013-11-01,08K,1153,550,1703,0.6770405167351732
7276,2013-11-01,08L,809,1259,2068,0.39119922630560927
7277,2013-11-01,08M,1105,443,1548,0.7138242894056848
7278,2013-11-01,08N,1228,542,1770,0.6937853107344633
7279,2013-11-01,08P,954,538,1492,0.6394101876675603
7280,2013-11-01,08Q,1114,427,1541,0.7229072031148605
7281,2013-11-01,08R,900,496,1396,0.6446991404011462
7282,2013-11-01,08T,999,520,1519,0.6576695194206715
7283,2013-11-01,08V,1064,561,1625,0.6547692307692308
7284,2013-11-01,08W,1052,465,1517,0.6934739617666447
7285,2013-11-01,08X,1414,669,2083,0.6788286125780125
7286,2013-11-01,08Y,775,521,1296,0.5979938271604939
7287,2013-11-01,09A,542,641,1183,0.45815722738799664
7288,2013-11-01,09C,797,312,1109,0.7186654643823264
7289,2013-11-01,09D,1593,953,2546,0.6256873527101335
7290,2013-11-01,09E,1585,606,2191,0.7234139662254678
7291,2013-11-01,09F,1383,775,2158,0.6408711770157554
7292,2013-11-01,09G,3522,1978,5500,0.6403636363636364
7293,2013-11-01,09H,636,380,1016,0.6259842519685039
7294,2013-11-01,09J,1711,928,2639,0.6483516483516484
7295,2013-11-01,09L,949,470,1419,0.6687808315715292
7296,2013-11-01,09N,1183,644,1827,0.6475095785440613
7297,2013-11-01,09P,1270,920,2190,0.5799086757990868
7298,2013-11-01,09W,1476,754,2230,0.6618834080717488
7299,2013-11-01,09X,1167,871,2038,0.5726202158979392
7300,2013-11-01,09Y,1693,1107,2800,0.6046428571428571
7301,2013-11-01,10A,1243,733,1976,0.6290485829959515
7302,2013-11-01,10C,531,247,778,0.6825192802056556
7303,2013-11-01,10D,648,263,911,0.7113062568605928
7304,2013-11-01,10E,879,309,1188,0.73989898989899
7305,2013-11-01,10G,674,354,1028,0.6556420233463035
7306,2013-11-01,10H,2029,1259,3288,0.6170924574209246
7307,2013-11-01,10J,1203,888,2091,0.5753228120516499
7308,2013-11-01,10K,1340,740,2080,0.6442307692307693
7309,2013-11-01,10L,1091,420,1511,0.7220383851753805
7310,2013-11-01,10M,600,427,1027,0.5842259006815969
7311,2013-11-01,10N,490,421,911,0.5378704720087816
7312,2013-11-01,10Q,3127,2944,6071,0.51507165211662
7313,2013-11-01,10R,1487,557,2044,0.7274951076320939
7314,2013-11-01,10T,635,310,945,0.671957671957672
7315,2013-11-01,10V,1301,706,2007,0.6482311908320877
7316,2013-11-01,10W,684,408,1092,0.6263736263736264
7317,2013-11-01,10X,1297,764,2061,0.6293061620572538
7318,2013-11-01,10Y,1326,826,2152,0.6161710037174721
7319,2013-11-01,11A,3674,1865,5539,0.6632966239393392
7320,2013-11-01,11C,949,444,1393,0.6812634601579325
7321,2013-11-01,11D,712,616,1328,0.536144578313253
7322,2013-11-01,11E,1209,909,2118,0.5708215297450425
7323,2013-11-01,11H,2592,1583,4175,0.6208383233532934
7324,2013-11-01,11J,5397,2571,7968,0.6773343373493976
7325,2013-11-01,11M,3968,1950,5918,0.6704967894558973
7326,2013-11-01,11N,4409,1785,6194,0.7118178882789796
7327,2013-11-01,11T,1555,897,2452,0.6341761827079935
7328,2013-11-01,11X,3579,2058,5637,0.6349121873336881
7329,2013-11-01,12A,1561,757,2318,0.6734253666954271
7330,2013-11-01,12D,1174,852,2026,0.579466929911155
7331,2013-11-01,12F,2678,696,3374,0.7937166567871962
7332,2013-11-01,13P,3479,1778,5257,0.6617842876165113
7333,2013-11-01,13T,3166,1365,4531,0.6987419995585963
7334,2013-11-01,14L,3258,1814,5072,0.6423501577287066
7335,2013-11-01,99A,2742,866,3608,0.7599778270509978
7336,2013-11-01,99C,1498,755,2253,0.6648912561029738
7337,2013-11-01,99D,1093,754,1847,0.5917704385489984
7338,2013-11-01,99E,1610,615,2225,0.7235955056179775
7339,2013-11-01,99F,1132,388,1520,0.7447368421052631
7340,2013-11-01,99G,1253,388,1641,0.7635588056063376
7341,2013-11-01,99H,1723,995,2718,0.6339220014716703
7342,2013-11-01,99J,3268,1770,5038,0.648670107185391
7343,2013-11-01,99K,1056,647,1703,0.6200822078684675
7344,2013-11-01,99M,1102,797,1899,0.5803054239073197
7345,2013-11-01,99N,2982,2458,5440,0.5481617647058824
7346,2013-11-01,99P,6713,2433,9146,0.7339820686638968
7347,2013-11-01,99Q,2087,834,2921,0.7144813420061623
7348,2013-12-01,00C,775,322,1097,0.7064721969006381
7349,2013-12-01,00D,2231,1152,3383,0.6594738397871711
7350,2013-12-01,00J,1853,800,2653,0.6984545797210705
7351,2013-12-01,00K,2196,1073,3269,0.6717650657693485
7352,2013-12-01,00L,2317,1449,3766,0.6152416356877324
7353,2013-12-01,00M,2182,1064,3246,0.6722119531731362
7354,2013-12-01,00N,1236,585,1821,0.6787479406919276
7355,2013-12-01,00P,2075,903,2978,0.6967763599731364
7356,2013-12-01,00Q,1057,422,1479,0.7146720757268424
7357,2013-12-01,00R,1183,481,1664,0.7109375
7358,2013-12-01,00T,1983,1182,3165,0.6265402843601896
7359,2013-12-01,00V,1466,819,2285,0.6415754923413567
7360,2013-12-01,00W,36,19,55,0.6545454545454545
7361,2013-12-01,00X,1129,263,1392,0.8110632183908046
7362,2013-12-01,00Y,1762,1005,2767,0.6367907481026382
7363,2013-12-01,01A,2406,1264,3670,0.6555858310626703
7364,2013-12-01,01C,1412,779,2191,0.6444545869465997
7365,2013-12-01,01D,1562,855,2417,0.6462556888705007
7366,2013-12-01,01E,1210,199,1409,0.8587650816181689
7367,2013-12-01,01F,904,485,1389,0.6508279337652988
7368,2013-12-01,01G,1418,1163,2581,0.5493994575745835
7369,2013-12-01,01H,2541,898,3439,0.7388775806920617
7370,2013-12-01,01J,1008,509,1517,0.6644693473961767
7371,2013-12-01,01K,2177,1113,3290,0.6617021276595745
7372,2013-12-01,01N,18,23,41,0.43902439024390244
7373,2013-12-01,01R,989,539,1528,0.6472513089005235
7374,2013-12-01,01T,862,423,1285,0.670817120622568
7375,2013-12-01,01V,930,393,1323,0.7029478458049887
7376,2013-12-01,01W,2099,1048,3147,0.6669844296155069
7377,2013-12-01,01X,1420,715,2135,0.6651053864168618
7378,2013-12-01,01Y,1342,802,2144,0.6259328358208955
7379,2013-12-01,02A,1340,665,2005,0.6683291770573566
7380,2013-12-01,02D,552,428,980,0.563265306122449
7381,2013-12-01,02E,1273,554,1827,0.6967706622879036
7382,2013-12-01,02F,1657,603,2260,0.7331858407079646
7383,2013-12-01,02G,655,349,1004,0.6523904382470119
7384,2013-12-01,02H,1706,1380,3086,0.5528191834089436
7385,2013-12-01,02M,1053,431,1484,0.7095687331536388
7386,2013-12-01,02N,1039,674,1713,0.6065382370110917
7387,2013-12-01,02P,1275,1137,2412,0.5286069651741293
7388,2013-12-01,02Q,650,476,1126,0.5772646536412078
7389,2013-12-01,02R,2171,1219,3390,0.6404129793510325
7390,2013-12-01,02T,1177,735,1912,0.6155857740585774
7391,2013-12-01,02V,1396,654,2050,0.6809756097560976
7392,2013-12-01,02W,528,318,846,0.624113475177305
7393,2013-12-01,02X,1987,986,2973,0.6683484695593677
7394,2013-12-01,02Y,2030,884,2914,0.696636925188744
7395,2013-12-01,03A,1397,630,2027,0.689195855944746
7396,2013-12-01,03C,1887,1200,3087,0.6112730806608357
7397,2013-12-01,03D,932,400,1332,0.6996996996996997
7398,2013-12-01,03E,934,540,1474,0.6336499321573948
7399,2013-12-01,03F,1660,653,2313,0.717682663207955
7400,2013-12-01,03G,1745,828,2573,0.6781966575981345
7401,2013-12-01,03H,1329,521,1850,0.7183783783783784
7402,2013-12-01,03J,1079,483,1562,0.6907810499359796
7403,2013-12-01,03K,958,284,1242,0.7713365539452496
7404,2013-12-01,03L,1363,1074,2437,0.5592942141977841
7405,2013-12-01,03M,835,456,1291,0.6467854376452362
7406,2013-12-01,03N,3414,1077,4491,0.760187040748163
7407,2013-12-01,03Q,1954,1053,3007,0.6498170934486199
7408,2013-12-01,03R,2420,1142,3562,0.6793935991016283
7409,2013-12-01,03T,1873,789,2662,0.7036063110443276
7410,2013-12-01,03V,420,256,676,0.621301775147929
7411,2013-12-01,03W,2436,1103,3539,0.6883300367335405
7412,2013-12-01,03X,522,300,822,0.635036496350365
7413,2013-12-01,03Y,719,357,1076,0.6682156133828996
7414,2013-12-01,04C,1887,897,2784,0.677801724137931
7415,2013-12-01,04D,1310,694,2004,0.653692614770459
7416,2013-12-01,04E,1267,658,1925,0.6581818181818182
7417,2013-12-01,04F,1478,1056,2534,0.5832675611681136
7418,2013-12-01,04G,4119,2387,6506,0.6331079003996312
7419,2013-12-01,04H,768,408,1176,0.6530612244897959
7420,2013-12-01,04J,2115,1123,3238,0.6531809759110562
7421,2013-12-01,04K,1552,778,2330,0.6660944206008583
7422,2013-12-01,04L,906,387,1293,0.7006960556844548
7423,2013-12-01,04M,566,213,779,0.7265725288831836
7424,2013-12-01,04N,778,315,1093,0.7118023787740164
7425,2013-12-01,04Q,776,340,1116,0.6953405017921147
7426,2013-12-01,04R,2600,1443,4043,0.6430868167202572
7427,2013-12-01,04V,2347,1152,3499,0.6707630751643326
7428,2013-12-01,04X,1315,1041,2356,0.5581494057724957
7429,2013-12-01,04Y,994,402,1396,0.7120343839541547
7430,2013-12-01,05A,2617,1626,4243,0.6167805797784587
7431,2013-12-01,05C,1282,1706,2988,0.42904953145917
7432,2013-12-01,05D,1012,456,1468,0.6893732970027248
7433,2013-12-01,05F,1233,640,1873,0.6583021890016018
7434,2013-12-01,05G,1542,626,2168,0.7112546125461254
7435,2013-12-01,05H,1134,669,1803,0.6289517470881864
7436,2013-12-01,05J,1510,607,2117,0.7132735002361833
7437,2013-12-01,05L,2585,1382,3967,0.6516259137887572
7438,2013-12-01,05N,2291,890,3181,0.7202137692549513
7439,2013-12-01,05P,1326,851,2177,0.6090950849793294
7440,2013-12-01,05Q,1423,682,2105,0.6760095011876485
7441,2013-12-01,05R,1851,1187,3038,0.6092824226464779
7442,2013-12-01,05T,2084,1040,3124,0.6670934699103713
7443,2013-12-01,05V,1000,473,1473,0.6788866259334692
7444,2013-12-01,05W,1591,628,2219,0.7169896349707076
7445,2013-12-01,05X,1127,394,1521,0.7409598948060486
7446,2013-12-01,05Y,1819,919,2738,0.6643535427319212
7447,2013-12-01,06A,1565,667,2232,0.7011648745519713
7448,2013-12-01,06D,934,398,1332,0.7012012012012012
7449,2013-12-01,06F,1520,2377,3897,0.39004362329997433
7450,2013-12-01,06H,5215,2821,8036,0.6489547038327527
7451,2013-12-01,06K,3313,2359,5672,0.5840973201692524
7452,2013-12-01,06L,2486,1172,3658,0.679606342263532
7453,2013-12-01,06M,1816,887,2703,0.6718460969293377
7454,2013-12-01,06N,3355,2218,5573,0.6020096895747353
7455,2013-12-01,06P,793,928,1721,0.4607786170830912
7456,2013-12-01,06Q,2428,1249,3677,0.6603209137884145
7457,2013-12-01,06T,2235,1242,3477,0.642795513373598
7458,2013-12-01,06V,1450,596,2046,0.7086999022482894
7459,2013-12-01,06W,1493,482,1975,0.7559493670886076
7460,2013-12-01,06Y,1330,588,1918,0.6934306569343066
7461,2013-12-01,07G,921,305,1226,0.7512234910277324
7462,2013-12-01,07H,1766,976,2742,0.6440554339897885
7463,2013-12-01,07J,777,485,1262,0.615689381933439
7464,2013-12-01,07K,1529,767,2296,0.6659407665505227
7465,2013-12-01,07L,779,353,1132,0.6881625441696113
7466,2013-12-01,07M,1268,770,2038,0.6221786064769381
7467,2013-12-01,07N,1193,644,1837,0.6494284158954817
7468,2013-12-01,07P,932,586,1518,0.613965744400527
7469,2013-12-01,07Q,1579,853,2432,0.6492598684210527
7470,2013-12-01,07R,830,539,1369,0.6062819576333089
7471,2013-12-01,07T,675,432,1107,0.6097560975609756
7472,2013-12-01,07V,1741,924,2665,0.6532833020637898
7473,2013-12-01,07W,1190,962,2152,0.5529739776951673
7474,2013-12-01,07X,1363,615,1978,0.6890798786653185
7475,2013-12-01,07Y,861,518,1379,0.6243654822335025
7476,2013-12-01,08A,1187,689,1876,0.6327292110874201
7477,2013-12-01,08C,658,445,1103,0.5965548504079783
7478,2013-12-01,08D,915,559,1474,0.6207598371777476
7479,2013-12-01,08E,842,511,1353,0.6223207686622321
7480,2013-12-01,08F,1443,746,2189,0.6592051164915487
7481,2013-12-01,08G,497,1310,1807,0.2750415052573326
7482,2013-12-01,08H,801,534,1335,0.6
7483,2013-12-01,08J,923,476,1399,0.6597569692637598
7484,2013-12-01,08K,1137,518,1655,0.6870090634441087
7485,2013-12-01,08L,735,1163,1898,0.38724973656480505
7486,2013-12-01,08M,998,464,1462,0.6826265389876881
7487,2013-12-01,08N,1138,577,1715,0.6635568513119533
7488,2013-12-01,08P,940,541,1481,0.6347062795408508
7489,2013-12-01,08Q,1016,454,1470,0.691156462585034
7490,2013-12-01,08R,871,462,1333,0.6534133533383346
7491,2013-12-01,08T,946,481,1427,0.6629292221443588
7492,2013-12-01,08V,972,510,1482,0.6558704453441295
7493,2013-12-01,08W,959,486,1445,0.6636678200692041
7494,2013-12-01,08X,1298,708,2006,0.6470588235294118
7495,2013-12-01,08Y,717,502,1219,0.5881870385561936
7496,2013-12-01,09A,563,526,1089,0.5169880624426079
7497,2013-12-01,09C,761,324,1085,0.7013824884792627
7498,2013-12-01,09D,1558,905,2463,0.63256191636216
7499,2013-12-01,09E,1620,624,2244,0.7219251336898396
7500,2013-12-01,09F,1306,737,2043,0.6392559960841899
7501,2013-12-01,09G,3608,1876,5484,0.6579139314369074
7502,2013-12-01,09H,580,370,950,0.6105263157894737
7503,2013-12-01,09J,1697,908,2605,0.6514395393474088
7504,2013-12-01,09L,916,517,1433,0.639218422889044
7505,2013-12-01,09N,1164,632,1796,0.6481069042316259
7506,2013-12-01,09P,1182,876,2058,0.5743440233236151
7507,2013-12-01,09W,1533,795,2328,0.6585051546391752
7508,2013-12-01,09X,1126,833,1959,0.5747830525778458
7509,2013-12-01,09Y,1666,1157,2823,0.5901523202267092
7510,2013-12-01,10A,1136,721,1857,0.6117393645665051
7511,2013-12-01,10C,510,294,804,0.6343283582089553
7512,2013-12-01,10D,611,273,884,0.6911764705882353
7513,2013-12-01,10E,808,328,1136,0.7112676056338029
7514,2013-12-01,10G,715,384,1099,0.6505914467697907
7515,2013-12-01,10H,1871,1290,3161,0.5919012970578931
7516,2013-12-01,10J,1123,953,2076,0.5409441233140655
7517,2013-12-01,10K,1316,676,1992,0.6606425702811245
7518,2013-12-01,10L,1054,393,1447,0.728403593642018
7519,2013-12-01,10M,583,413,996,0.5853413654618473
7520,2013-12-01,10N,480,447,927,0.517799352750809
7521,2013-12-01,10Q,3292,2949,6241,0.5274795705816375
7522,2013-12-01,10R,1437,542,1979,0.7261243052046488
7523,2013-12-01,10T,580,305,885,0.655367231638418
7524,2013-12-01,10V,1292,673,1965,0.6575063613231552
7525,2013-12-01,10W,627,386,1013,0.6189536031589339
7526,2013-12-01,10X,1193,740,1933,0.6171753750646664
7527,2013-12-01,10Y,1377,862,2239,0.6150066994193837
7528,2013-12-01,11A,3684,1892,5576,0.6606886657101865
7529,2013-12-01,11C,949,447,1396,0.6797994269340975
7530,2013-12-01,11D,625,573,1198,0.5217028380634391
7531,2013-12-01,11E,1216,881,2097,0.5798760133524082
7532,2013-12-01,11H,2599,1615,4214,0.6167536782154722
7533,2013-12-01,11J,5280,2645,7925,0.6662460567823344
7534,2013-12-01,11M,3986,2042,6028,0.6612475116124751
7535,2013-12-01,11N,4380,1802,6182,0.7085085732772566
7536,2013-12-01,11T,1526,920,2446,0.6238757154538022
7537,2013-12-01,11X,3528,1993,5521,0.6390146712552074
7538,2013-12-01,12A,1590,712,2302,0.6907037358818419
7539,2013-12-01,12D,1136,836,1972,0.5760649087221096
7540,2013-12-01,12F,2507,684,3191,0.7856471325603259
7541,2013-12-01,13P,3250,1766,5016,0.64792663476874
7542,2013-12-01,13T,3134,1417,4551,0.6886398593715667
7543,2013-12-01,14L,3098,1811,4909,0.6310857608474231
7544,2013-12-01,99A,2709,929,3638,0.7446399120395822
7545,2013-12-01,99C,1599,758,2357,0.6784047518031396
7546,2013-12-01,99D,1157,772,1929,0.5997926386728875
7547,2013-12-01,99E,1526,599,2125,0.7181176470588235
7548,2013-12-01,99F,1117,363,1480,0.7547297297297297
7549,2013-12-01,99G,1224,415,1639,0.7467968273337401
7550,2013-12-01,99H,1705,997,2702,0.6310140636565507
7551,2013-12-01,99J,3207,1725,4932,0.6502433090024331
7552,2013-12-01,99K,1034,600,1634,0.6328029375764994
7553,2013-12-01,99M,1047,799,1846,0.5671722643553629
7554,2013-12-01,99N,2966,2425,5391,0.5501762196253014
7555,2013-12-01,99P,6877,2482,9359,0.7348007265733518
7556,2013-12-01,99Q,2003,899,2902,0.6902136457615438
7557,2014-01-01,00C,830,338,1168,0.7106164383561644
7558,2014-01-01,00D,2321,1190,3511,0.6610652235830248
7559,2014-01-01,00J,2028,901,2929,0.6923864800273131
7560,2014-01-01,00K,2449,1095,3544,0.6910270880361173
7561,2014-01-01,00L,2424,1517,3941,0.6150723166708957
7562,2014-01-01,00M,2284,1130,3414,0.6690099589923842
7563,2014-01-01,00N,1257,578,1835,0.6850136239782016
7564,2014-01-01,00P,2319,867,3186,0.7278719397363466
7565,2014-01-01,00Q,1044,412,1456,0.717032967032967
7566,2014-01-01,00R,1277,568,1845,0.6921409214092141
7567,2014-01-01,00T,2114,1154,3268,0.6468788249694002
7568,2014-01-01,00V,1437,885,2322,0.6188630490956072
7569,2014-01-01,00W,44,18,62,0.7096774193548387
7570,2014-01-01,00X,1080,243,1323,0.8163265306122449
7571,2014-01-01,00Y,1911,1045,2956,0.6464817320703654
7572,2014-01-01,01A,2628,1339,3967,0.6624653390471389
7573,2014-01-01,01C,1342,784,2126,0.6312323612417686
7574,2014-01-01,01D,1646,886,2532,0.6500789889415481
7575,2014-01-01,01E,1171,170,1341,0.8732289336316182
7576,2014-01-01,01F,960,503,1463,0.6561859193438141
7577,2014-01-01,01G,1536,1274,2810,0.5466192170818506
7578,2014-01-01,01H,2678,920,3598,0.7443023902167871
7579,2014-01-01,01J,1145,526,1671,0.6852184320766008
7580,2014-01-01,01K,2286,1043,3329,0.6866927005106639
7581,2014-01-01,01N,13,21,34,0.38235294117647056
7582,2014-01-01,01R,1028,535,1563,0.6577095329494562
7583,2014-01-01,01T,898,430,1328,0.6762048192771084
7584,2014-01-01,01V,967,391,1358,0.7120765832106039
7585,2014-01-01,01W,2156,1034,3190,0.6758620689655173
7586,2014-01-01,01X,1514,773,2287,0.6620026235242676
7587,2014-01-01,01Y,1398,820,2218,0.630297565374211
7588,2014-01-01,02A,1479,632,2111,0.7006158218853624
7589,2014-01-01,02D,538,435,973,0.5529290853031861
7590,2014-01-01,02E,1353,543,1896,0.7136075949367089
7591,2014-01-01,02F,1855,668,2523,0.7352358303606817
7592,2014-01-01,02G,744,352,1096,0.6788321167883211
7593,2014-01-01,02H,1823,1480,3303,0.5519224947017862
7594,2014-01-01,02M,1154,464,1618,0.7132262051915945
7595,2014-01-01,02N,1085,718,1803,0.6017748197448697
7596,2014-01-01,02P,1336,1249,2585,0.5168278529980658
7597,2014-01-01,02Q,670,490,1160,0.5775862068965517
7598,2014-01-01,02R,2288,1209,3497,0.654275092936803
7599,2014-01-01,02T,1263,761,2024,0.6240118577075099
7600,2014-01-01,02V,1440,679,2119,0.6795658329400661
7601,2014-01-01,02W,621,369,990,0.6272727272727273
7602,2014-01-01,02X,2181,1085,3266,0.6677893447642376
7603,2014-01-01,02Y,2120,926,3046,0.695994747209455
7604,2014-01-01,03A,1400,650,2050,0.6829268292682927
7605,2014-01-01,03C,1982,1239,3221,0.615336851909345
7606,2014-01-01,03D,944,437,1381,0.6835626357711803
7607,2014-01-01,03E,978,542,1520,0.6434210526315789
7608,2014-01-01,03F,1709,718,2427,0.7041615162752369
7609,2014-01-01,03G,1795,889,2684,0.6687779433681073
7610,2014-01-01,03H,1365,561,1926,0.7087227414330218
7611,2014-01-01,03J,1247,543,1790,0.6966480446927374
7612,2014-01-01,03K,1018,298,1316,0.7735562310030395
7613,2014-01-01,03L,1385,1143,2528,0.5478639240506329
7614,2014-01-01,03M,933,462,1395,0.6688172043010753
7615,2014-01-01,03N,3686,1053,4739,0.777801223886896
7616,2014-01-01,03Q,2020,1007,3027,0.6673273868516684
7617,2014-01-01,03R,2592,1198,3790,0.6839050131926121
7618,2014-01-01,03T,1927,836,2763,0.6974303293521534
7619,2014-01-01,03V,447,261,708,0.6313559322033898
7620,2014-01-01,03W,2518,1090,3608,0.6978935698447893
7621,2014-01-01,03X,575,281,856,0.6717289719626168
7622,2014-01-01,03Y,740,407,1147,0.6451612903225806
7623,2014-01-01,04C,2287,888,3175,0.7203149606299213
7624,2014-01-01,04D,1479,797,2276,0.6498242530755711
7625,2014-01-01,04E,1318,660,1978,0.6663296258847321
7626,2014-01-01,04F,1624,1108,2732,0.5944363103953147
7627,2014-01-01,04G,4401,2466,6867,0.6408912188728703
7628,2014-01-01,04H,772,372,1144,0.6748251748251748
7629,2014-01-01,04J,2153,1144,3297,0.6530178950561116
7630,2014-01-01,04K,1805,893,2698,0.6690140845070423
7631,2014-01-01,04L,968,367,1335,0.7250936329588015
7632,2014-01-01,04M,558,263,821,0.679658952496955
7633,2014-01-01,04N,793,353,1146,0.6919720767888308
7634,2014-01-01,04Q,868,425,1293,0.671307037896365
7635,2014-01-01,04R,2838,1460,4298,0.6603071195905073
7636,2014-01-01,04V,2494,1204,3698,0.6744186046511628
7637,2014-01-01,04X,1421,1103,2524,0.5629952456418383
7638,2014-01-01,04Y,1095,403,1498,0.7309746328437917
7639,2014-01-01,05A,2996,1693,4689,0.6389422051610152
7640,2014-01-01,05C,1267,1804,3071,0.41256919570172584
7641,2014-01-01,05D,966,496,1462,0.6607387140902873
7642,2014-01-01,05F,1271,637,1908,0.6661425576519916
7643,2014-01-01,05G,1594,662,2256,0.7065602836879432
7644,2014-01-01,05H,1200,668,1868,0.6423982869379015
7645,2014-01-01,05J,1511,633,2144,0.7047574626865671
7646,2014-01-01,05L,2814,1383,4197,0.6704789135096497
7647,2014-01-01,05N,2426,867,3293,0.7367142423322198
7648,2014-01-01,05P,1392,926,2318,0.6005176876617774
7649,2014-01-01,05Q,1606,646,2252,0.7131438721136767
7650,2014-01-01,05R,1934,1209,3143,0.6153356665606109
7651,2014-01-01,05T,2135,1019,3154,0.6769181991122384
7652,2014-01-01,05V,1086,529,1615,0.6724458204334365
7653,2014-01-01,05W,1767,710,2477,0.7133629390391603
7654,2014-01-01,05X,1267,437,1704,0.7435446009389671
7655,2014-01-01,05Y,1924,933,2857,0.6734336716835841
7656,2014-01-01,06A,1724,664,2388,0.7219430485762144
7657,2014-01-01,06D,968,413,1381,0.7009413468501087
7658,2014-01-01,06F,1701,2622,4323,0.3934767522553782
7659,2014-01-01,06H,5636,3029,8665,0.6504327755337564
7660,2014-01-01,06K,3504,2436,5940,0.5898989898989899
7661,2014-01-01,06L,2678,1150,3828,0.699582027168234
7662,2014-01-01,06M,1973,969,2942,0.6706322229775663
7663,2014-01-01,06N,3693,2380,6073,0.6081014325703935
7664,2014-01-01,06P,1036,1042,2078,0.4985563041385948
7665,2014-01-01,06Q,2587,1290,3877,0.6672685065772505
7666,2014-01-01,06T,2413,1236,3649,0.6612770622088243
7667,2014-01-01,06V,1489,655,2144,0.6944962686567164
7668,2014-01-01,06W,1541,478,2019,0.7632491332342743
7669,2014-01-01,06Y,1385,574,1959,0.7069933639612047
7670,2014-01-01,07G,1019,370,1389,0.7336213102951764
7671,2014-01-01,07H,1834,1092,2926,0.6267942583732058
7672,2014-01-01,07J,796,516,1312,0.6067073170731707
7673,2014-01-01,07K,1698,784,2482,0.6841257050765511
7674,2014-01-01,07L,886,365,1251,0.7082334132693845
7675,2014-01-01,07M,1310,770,2080,0.6298076923076923
7676,2014-01-01,07N,1455,740,2195,0.662870159453303
7677,2014-01-01,07P,1013,561,1574,0.6435832274459975
7678,2014-01-01,07Q,1659,919,2578,0.6435221101629169
7679,2014-01-01,07R,806,574,1380,0.5840579710144927
7680,2014-01-01,07T,761,473,1234,0.6166936790923825
7681,2014-01-01,07V,1831,940,2771,0.6607722843738723
7682,2014-01-01,07W,1256,1017,2273,0.5525736911570611
7683,2014-01-01,07X,1434,670,2104,0.6815589353612167
7684,2014-01-01,07Y,941,586,1527,0.6162409954158481
7685,2014-01-01,08A,1276,738,2014,0.6335650446871897
7686,2014-01-01,08C,690,470,1160,0.5948275862068966
7687,2014-01-01,08D,996,601,1597,0.6236693800876644
7688,2014-01-01,08E,982,494,1476,0.6653116531165312
7689,2014-01-01,08F,1557,746,2303,0.6760746851932262
7690,2014-01-01,08G,529,1438,1967,0.26893746822572445
7691,2014-01-01,08H,828,564,1392,0.5948275862068966
7692,2014-01-01,08J,1001,442,1443,0.6936936936936937
7693,2014-01-01,08K,1289,601,1890,0.682010582010582
7694,2014-01-01,08L,767,1229,1996,0.3842685370741483
7695,2014-01-01,08M,1126,411,1537,0.7325959661678595
7696,2014-01-01,08N,1289,627,1916,0.6727557411273486
7697,2014-01-01,08P,1012,530,1542,0.6562905317769131
7698,2014-01-01,08Q,1135,448,1583,0.7169930511686671
7699,2014-01-01,08R,898,408,1306,0.6875957120980092
7700,2014-01-01,08T,992,488,1480,0.6702702702702703
7701,2014-01-01,08V,1102,543,1645,0.6699088145896657
7702,2014-01-01,08W,1098,505,1603,0.6849656893325016
7703,2014-01-01,08X,1449,718,2167,0.6686663590216889
7704,2014-01-01,08Y,721,595,1316,0.5478723404255319
7705,2014-01-01,09A,579,525,1104,0.5244565217391305
7706,2014-01-01,09C,847,397,1244,0.6808681672025724
7707,2014-01-01,09D,1631,994,2625,0.6213333333333333
7708,2014-01-01,09E,1755,662,2417,0.7261067438973935
7709,2014-01-01,09F,1403,750,2153,0.6516488620529494
7710,2014-01-01,09G,3757,1957,5714,0.6575078753937696
7711,2014-01-01,09H,667,401,1068,0.6245318352059925
7712,2014-01-01,09J,1755,1055,2810,0.6245551601423488
7713,2014-01-01,09L,945,477,1422,0.6645569620253164
7714,2014-01-01,09N,1325,722,2047,0.6472887151929653
7715,2014-01-01,09P,1310,903,2213,0.5919566199728875
7716,2014-01-01,09W,1576,850,2426,0.6496290189612531
7717,2014-01-01,09X,1140,824,1964,0.5804480651731161
7718,2014-01-01,09Y,1682,1231,2913,0.5774116031582561
7719,2014-01-01,10A,1295,749,2044,0.6335616438356164
7720,2014-01-01,10C,543,253,796,0.6821608040201005
7721,2014-01-01,10D,697,257,954,0.7306079664570231
7722,2014-01-01,10E,868,342,1210,0.7173553719008264
7723,2014-01-01,10G,753,392,1145,0.6576419213973799
7724,2014-01-01,10H,1983,1238,3221,0.6156473144986029
7725,2014-01-01,10J,1275,1030,2305,0.5531453362255966
7726,2014-01-01,10K,1422,681,2103,0.6761768901569187
7727,2014-01-01,10L,1072,398,1470,0.7292517006802721
7728,2014-01-01,10M,569,411,980,0.5806122448979592
7729,2014-01-01,10N,507,456,963,0.5264797507788161
7730,2014-01-01,10Q,3529,2995,6524,0.5409258123850399
7731,2014-01-01,10R,1541,592,2133,0.7224566338490389
7732,2014-01-01,10T,622,343,965,0.644559585492228
7733,2014-01-01,10V,1343,717,2060,0.6519417475728155
7734,2014-01-01,10W,679,407,1086,0.6252302025782689
7735,2014-01-01,10X,1266,736,2002,0.6323676323676324
7736,2014-01-01,10Y,1417,908,2325,0.6094623655913979
7737,2014-01-01,11A,3903,1901,5804,0.6724672639558925
7738,2014-01-01,11C,1007,450,1457,0.6911461908030199
7739,2014-01-01,11D,656,622,1278,0.513302034428795
7740,2014-01-01,11E,1300,973,2273,0.5719313682358117
7741,2014-01-01,11H,2791,1496,4287,0.6510380219267553
7742,2014-01-01,11J,5674,2639,8313,0.6825454108023578
7743,2014-01-01,11M,4173,2081,6254,0.6672529581068116
7744,2014-01-01,11N,4525,1763,6288,0.7196246819338422
7745,2014-01-01,11T,1583,1009,2592,0.6107253086419753
7746,2014-01-01,11X,3654,1977,5631,0.648907831646244
7747,2014-01-01,12A,1674,715,2389,0.7007115948095437
7748,2014-01-01,12D,1214,896,2110,0.5753554502369668
7749,2014-01-01,12F,2740,723,3463,0.7912214842622004
7750,2014-01-01,13P,3360,2033,5393,0.6230298535138142
7751,2014-01-01,13T,3358,1544,4902,0.6850265197878417
7752,2014-01-01,14L,3437,1995,5432,0.6327319587628866
7753,2014-01-01,99A,2981,903,3884,0.7675077239958805
7754,2014-01-01,99C,1678,816,2494,0.6728147554129912
7755,2014-01-01,99D,1162,746,1908,0.6090146750524109
7756,2014-01-01,99E,1619,604,2223,0.7282950967161493
7757,2014-01-01,99F,1217,402,1619,0.7516985793699815
7758,2014-01-01,99G,1264,498,1762,0.717366628830874
7759,2014-01-01,99H,1812,1003,2815,0.6436944937833037
7760,2014-01-01,99J,3251,1760,5011,0.6487727000598683
7761,2014-01-01,99K,1134,676,1810,0.6265193370165746
7762,2014-01-01,99M,1104,871,1975,0.5589873417721519
7763,2014-01-01,99N,3250,2549,5799,0.5604414554233489
7764,2014-01-01,99P,7065,2572,9637,0.7331119643042441
7765,2014-01-01,99Q,2129,918,3047,0.6987200525106663
7766,2014-02-01,00C,709,283,992,0.7147177419354839
7767,2014-02-01,00D,2004,1013,3017,0.6642359960225389
7768,2014-02-01,00J,1721,817,2538,0.6780929866036249
7769,2014-02-01,00K,2175,1032,3207,0.6782039289055192
7770,2014-02-01,00L,2081,1273,3354,0.6204531902206321
7771,2014-02-01,00M,2105,1019,3124,0.6738156209987196
7772,2014-02-01,00N,1075,564,1639,0.6558877364246491
7773,2014-02-01,00P,1919,811,2730,0.7029304029304029
7774,2014-02-01,00Q,912,386,1298,0.7026194144838213
7775,2014-02-01,00R,1137,447,1584,0.7178030303030303
7776,2014-02-01,00T,1889,1135,3024,0.6246693121693122
7777,2014-02-01,00V,1310,714,2024,0.6472332015810277
7778,2014-02-01,00W,43,8,51,0.8431372549019608
7779,2014-02-01,00X,958,241,1199,0.798999165971643
7780,2014-02-01,00Y,1705,910,2615,0.6520076481835564
7781,2014-02-01,01A,2299,1224,3523,0.6525688333806415
7782,2014-02-01,01C,1160,661,1821,0.6370126304228446
7783,2014-02-01,01D,1490,841,2331,0.6392106392106393
7784,2014-02-01,01E,971,147,1118,0.868515205724508
7785,2014-02-01,01F,864,437,1301,0.6641045349730976
7786,2014-02-01,01G,1369,1133,2502,0.5471622701838529
7787,2014-02-01,01H,2358,854,3212,0.7341220423412205
7788,2014-02-01,01J,1002,484,1486,0.6742934051144011
7789,2014-02-01,01K,1972,1017,2989,0.659752425560388
7790,2014-02-01,01N,14,13,27,0.5185185185185185
7791,2014-02-01,01R,922,465,1387,0.6647440519105984
7792,2014-02-01,01T,743,364,1107,0.6711833785004516
7793,2014-02-01,01V,808,320,1128,0.7163120567375887
7794,2014-02-01,01W,1943,948,2891,0.6720857834659287
7795,2014-02-01,01X,1267,753,2020,0.6272277227722772
7796,2014-02-01,01Y,1250,802,2052,0.6091617933723197
7797,2014-02-01,02A,1153,565,1718,0.6711292200232829
7798,2014-02-01,02D,436,402,838,0.5202863961813843
7799,2014-02-01,02E,1174,482,1656,0.7089371980676329
7800,2014-02-01,02F,1663,621,2284,0.728108581436077
7801,2014-02-01,02G,664,338,1002,0.6626746506986028
7802,2014-02-01,02H,1464,1341,2805,0.5219251336898396
7803,2014-02-01,02M,1052,388,1440,0.7305555555555555
7804,2014-02-01,02N,962,604,1566,0.6143039591315453
7805,2014-02-01,02P,1078,1179,2257,0.4776251661497563
7806,2014-02-01,02Q,570,449,1019,0.5593719332679097
7807,2014-02-01,02R,2050,1152,3202,0.6402248594628357
7808,2014-02-01,02T,1144,710,1854,0.6170442286947141
7809,2014-02-01,02V,1231,670,1901,0.6475539189900053
7810,2014-02-01,02W,534,309,843,0.6334519572953736
7811,2014-02-01,02X,1873,979,2852,0.6567321178120618
7812,2014-02-01,02Y,1847,863,2710,0.681549815498155
7813,2014-02-01,03A,1264,604,1868,0.6766595289079229
7814,2014-02-01,03C,1735,1156,2891,0.6001383604289173
7815,2014-02-01,03D,834,374,1208,0.6903973509933775
7816,2014-02-01,03E,832,494,1326,0.6274509803921569
7817,2014-02-01,03F,1580,637,2217,0.7126747857465043
7818,2014-02-01,03G,1571,780,2351,0.6682262866865164
7819,2014-02-01,03H,1160,456,1616,0.7178217821782178
7820,2014-02-01,03J,1056,429,1485,0.7111111111111111
7821,2014-02-01,03K,926,236,1162,0.7969018932874354
7822,2014-02-01,03L,1166,988,2154,0.5413184772516249
7823,2014-02-01,03M,873,414,1287,0.6783216783216783
7824,2014-02-01,03N,3078,957,4035,0.762825278810409
7825,2014-02-01,03Q,1778,874,2652,0.6704374057315233
7826,2014-02-01,03R,2207,1134,3341,0.660580664471715
7827,2014-02-01,03T,1720,689,2409,0.7139892071398921
7828,2014-02-01,03V,368,213,581,0.6333907056798623
7829,2014-02-01,03W,2118,1020,3138,0.6749521988527725
7830,2014-02-01,03X,450,261,711,0.6329113924050633
7831,2014-02-01,03Y,634,364,998,0.6352705410821643
7832,2014-02-01,04C,1995,777,2772,0.7196969696969697
7833,2014-02-01,04D,1339,663,2002,0.6688311688311688
7834,2014-02-01,04E,1109,586,1695,0.6542772861356932
7835,2014-02-01,04F,1334,971,2305,0.5787418655097614
7836,2014-02-01,04G,3851,2199,6050,0.6365289256198348
7837,2014-02-01,04H,706,331,1037,0.6808100289296046
7838,2014-02-01,04J,1843,1009,2852,0.6462131837307152
7839,2014-02-01,04K,1578,887,2465,0.6401622718052739
7840,2014-02-01,04L,844,335,1179,0.7158608990670059
7841,2014-02-01,04M,493,226,719,0.6856745479833102
7842,2014-02-01,04N,620,278,898,0.6904231625835189
7843,2014-02-01,04Q,732,323,1055,0.6938388625592417
7844,2014-02-01,04R,2492,1321,3813,0.6535536323105167
7845,2014-02-01,04V,2204,1057,3261,0.675866298681386
7846,2014-02-01,04X,1242,991,2233,0.5562024182713838
7847,2014-02-01,04Y,939,367,1306,0.718989280245023
7848,2014-02-01,05A,2567,1445,4012,0.6398305084745762
7849,2014-02-01,05C,1103,1618,2721,0.4053656743844175
7850,2014-02-01,05D,885,393,1278,0.6924882629107981
7851,2014-02-01,05F,1139,587,1726,0.6599073001158748
7852,2014-02-01,05G,1404,570,1974,0.7112462006079028
7853,2014-02-01,05H,1056,591,1647,0.6411657559198543
7854,2014-02-01,05J,1355,598,1953,0.6938044034818228
7855,2014-02-01,05L,2420,1165,3585,0.6750348675034867
7856,2014-02-01,05N,2089,818,2907,0.718610251117991
7857,2014-02-01,05P,1208,769,1977,0.611026808295397
7858,2014-02-01,05Q,1321,589,1910,0.6916230366492147
7859,2014-02-01,05R,1686,1118,2804,0.6012838801711841
7860,2014-02-01,05T,1860,860,2720,0.6838235294117647
7861,2014-02-01,05V,968,436,1404,0.6894586894586895
7862,2014-02-01,05W,1525,586,2111,0.7224064424443392
7863,2014-02-01,05X,1117,339,1456,0.7671703296703297
7864,2014-02-01,05Y,1642,845,2487,0.6602332127060716
7865,2014-02-01,06A,1531,646,2177,0.7032613688562241
7866,2014-02-01,06D,860,372,1232,0.698051948051948
7867,2014-02-01,06F,1516,2279,3795,0.3994729907773386
7868,2014-02-01,06H,4942,2535,7477,0.6609602781864384
7869,2014-02-01,06K,2982,2285,5267,0.5661666983102336
7870,2014-02-01,06L,2345,999,3344,0.701255980861244
7871,2014-02-01,06M,1710,813,2523,0.6777645659928656
7872,2014-02-01,06N,3081,2112,5193,0.5932986712882726
7873,2014-02-01,06P,885,912,1797,0.49248747913188645
7874,2014-02-01,06Q,2241,1174,3415,0.6562225475841874
7875,2014-02-01,06T,2149,1098,3247,0.6618417000307977
7876,2014-02-01,06V,1704,581,2285,0.7457330415754924
7877,2014-02-01,06W,1385,460,1845,0.7506775067750677
7878,2014-02-01,06Y,1246,492,1738,0.716915995397008
7879,2014-02-01,07G,928,340,1268,0.7318611987381703
7880,2014-02-01,07H,1541,936,2477,0.6221235365361324
7881,2014-02-01,07J,721,454,1175,0.6136170212765958
7882,2014-02-01,07K,1480,637,2117,0.6991025035427492
7883,2014-02-01,07L,749,288,1037,0.7222757955641272
7884,2014-02-01,07M,1151,719,1870,0.6155080213903743
7885,2014-02-01,07N,1174,579,1753,0.6697090701654307
7886,2014-02-01,07P,850,566,1416,0.6002824858757062
7887,2014-02-01,07Q,1550,743,2293,0.6759703445268208
7888,2014-02-01,07R,712,531,1243,0.5728077232502011
7889,2014-02-01,07T,668,493,1161,0.5753660637381568
7890,2014-02-01,07V,1618,776,2394,0.6758563074352548
7891,2014-02-01,07W,1106,914,2020,0.5475247524752476
7892,2014-02-01,07X,1297,554,1851,0.7007023230686116
7893,2014-02-01,07Y,774,509,1283,0.603273577552611
7894,2014-02-01,08A,1089,637,1726,0.6309385863267671
7895,2014-02-01,08C,620,439,1059,0.5854579792256847
7896,2014-02-01,08D,821,507,1328,0.6182228915662651
7897,2014-02-01,08E,842,468,1310,0.6427480916030535
7898,2014-02-01,08F,1296,687,1983,0.653555219364599
7899,2014-02-01,08G,469,1261,1730,0.27109826589595376
7900,2014-02-01,08H,719,535,1254,0.5733652312599681
7901,2014-02-01,08J,831,421,1252,0.6637380191693291
7902,2014-02-01,08K,1090,558,1648,0.6614077669902912
7903,2014-02-01,08L,700,1054,1754,0.3990877993158495
7904,2014-02-01,08M,1035,395,1430,0.7237762237762237
7905,2014-02-01,08N,1078,544,1622,0.6646115906288532
7906,2014-02-01,08P,774,464,1238,0.6252019386106623
7907,2014-02-01,08Q,986,400,1386,0.7113997113997114
7908,2014-02-01,08R,793,369,1162,0.6824440619621343
7909,2014-02-01,08T,931,469,1400,0.665
7910,2014-02-01,08V,959,532,1491,0.6431924882629108
7911,2014-02-01,08W,955,460,1415,0.6749116607773852
7912,2014-02-01,08X,1205,627,1832,0.6577510917030568
7913,2014-02-01,08Y,617,506,1123,0.5494211932324132
7914,2014-02-01,09A,582,522,1104,0.5271739130434783
7915,2014-02-01,09C,721,321,1042,0.6919385796545106
7916,2014-02-01,09D,1425,841,2266,0.6288614298323036
7917,2014-02-01,09E,1413,586,1999,0.7068534267133567
7918,2014-02-01,09F,1270,671,1941,0.6543019062339
7919,2014-02-01,09G,3272,1739,5011,0.6529634803432448
7920,2014-02-01,09H,595,380,975,0.6102564102564103
7921,2014-02-01,09J,1644,900,2544,0.6462264150943396
7922,2014-02-01,09L,809,457,1266,0.6390205371248026
7923,2014-02-01,09N,1074,615,1689,0.6358792184724689
7924,2014-02-01,09P,1081,749,1830,0.5907103825136611
7925,2014-02-01,09W,1324,748,2072,0.638996138996139
7926,2014-02-01,09X,1022,742,1764,0.5793650793650794
7927,2014-02-01,09Y,1539,1044,2583,0.5958188153310104
7928,2014-02-01,10A,1049,646,1695,0.6188790560471976
7929,2014-02-01,10C,468,262,730,0.6410958904109589
7930,2014-02-01,10D,540,269,809,0.6674907292954264
7931,2014-02-01,10E,771,329,1100,0.7009090909090909
7932,2014-02-01,10G,642,332,974,0.6591375770020534
7933,2014-02-01,10H,1795,1148,2943,0.6099218484539586
7934,2014-02-01,10J,1058,812,1870,0.5657754010695187
7935,2014-02-01,10K,1302,608,1910,0.6816753926701571
7936,2014-02-01,10L,968,340,1308,0.7400611620795107
7937,2014-02-01,10M,504,399,903,0.5581395348837209
7938,2014-02-01,10N,451,433,884,0.5101809954751131
7939,2014-02-01,10Q,3102,2715,5817,0.5332645693656524
7940,2014-02-01,10R,1381,470,1851,0.7460831982712047
7941,2014-02-01,10T,511,247,758,0.6741424802110818
7942,2014-02-01,10V,1183,651,1834,0.6450381679389313
7943,2014-02-01,10W,541,339,880,0.6147727272727272
7944,2014-02-01,10X,1062,668,1730,0.6138728323699422
7945,2014-02-01,10Y,1232,809,2041,0.6036256736893679
7946,2014-02-01,11A,3365,1641,5006,0.6721933679584499
7947,2014-02-01,11C,814,408,1222,0.6661211129296236
7948,2014-02-01,11D,583,506,1089,0.5353535353535354
7949,2014-02-01,11E,1062,821,1883,0.5639936271906533
7950,2014-02-01,11H,2432,1381,3813,0.6378179910831366
7951,2014-02-01,11J,4826,2299,7125,0.6773333333333333
7952,2014-02-01,11M,3584,1747,5331,0.6722941286812981
7953,2014-02-01,11N,3944,1637,5581,0.7066833900734636
7954,2014-02-01,11T,1365,864,2229,0.6123822341857336
7955,2014-02-01,11X,3028,1782,4810,0.6295218295218296
7956,2014-02-01,12A,1386,646,2032,0.6820866141732284
7957,2014-02-01,12D,1122,811,1933,0.5804449042938438
7958,2014-02-01,12F,2418,699,3117,0.7757459095283927
7959,2014-02-01,13P,2845,1825,4670,0.6092077087794433
7960,2014-02-01,13T,3015,1417,4432,0.6802797833935018
7961,2014-02-01,14L,2854,1824,4678,0.6100897819581017
7962,2014-02-01,99A,2669,853,3522,0.7578080636002271
7963,2014-02-01,99C,1437,706,2143,0.6705552963135791
7964,2014-02-01,99D,1088,711,1799,0.6047804335742079
7965,2014-02-01,99E,1377,583,1960,0.7025510204081633
7966,2014-02-01,99F,1055,377,1432,0.736731843575419
7967,2014-02-01,99G,1132,382,1514,0.7476882430647291
7968,2014-02-01,99H,1537,903,2440,0.6299180327868853
7969,2014-02-01,99J,2855,1491,4346,0.6569259088817303
7970,2014-02-01,99K,936,581,1517,0.6170072511535926
7971,2014-02-01,99M,967,736,1703,0.5678214914856137
7972,2014-02-01,99N,2812,2149,4961,0.5668212054021367
7973,2014-02-01,99P,6163,2274,8437,0.7304729169135948
7974,2014-02-01,99Q,1820,789,2609,0.697585281717133
7975,2014-03-01,00C,759,345,1104,0.6875
7976,2014-03-01,00D,2218,1069,3287,0.6747794341344692
7977,2014-03-01,00J,1809,828,2637,0.6860068259385665
7978,2014-03-01,00K,2315,1102,3417,0.6774948785484343
7979,2014-03-01,00L,2191,1340,3531,0.6205041064854149
7980,2014-03-01,00M,2231,1139,3370,0.6620178041543027
7981,2014-03-01,00N,1196,589,1785,0.6700280112044817
7982,2014-03-01,00P,2126,891,3017,0.7046735167384819
7983,2014-03-01,00Q,952,407,1359,0.7005150846210448
7984,2014-03-01,00R,1213,561,1774,0.6837655016910936
7985,2014-03-01,00T,1929,1194,3123,0.6176753121998079
7986,2014-03-01,00V,1362,764,2126,0.6406396989651929
7987,2014-03-01,00W,43,19,62,0.6935483870967742
7988,2014-03-01,00X,1062,256,1318,0.8057663125948407
7989,2014-03-01,00Y,1834,1005,2839,0.6460021134202184
7990,2014-03-01,01A,2428,1293,3721,0.6525127653856491
7991,2014-03-01,01C,1148,641,1789,0.6416992733370598
7992,2014-03-01,01D,1447,793,2240,0.6459821428571428
7993,2014-03-01,01E,1095,178,1273,0.8601728201099764
7994,2014-03-01,01F,986,517,1503,0.6560212907518297
7995,2014-03-01,01G,1501,1156,2657,0.5649228453142642
7996,2014-03-01,01H,2441,844,3285,0.7430745814307458
7997,2014-03-01,01J,1074,515,1589,0.6758967904342353
7998,2014-03-01,01K,2125,1167,3292,0.6455042527339003
7999,2014-03-01,01N,19,14,33,0.5757575757575758
8000,2014-03-01,01R,1023,520,1543,0.6629941672067401
8001,2014-03-01,01T,826,391,1217,0.6787181594083813
8002,2014-03-01,01V,866,399,1265,0.6845849802371542
8003,2014-03-01,01W,2091,995,3086,0.6775761503564485
8004,2014-03-01,01X,1334,708,2042,0.653281096963761
8005,2014-03-01,01Y,1327,820,2147,0.6180717279925477
8006,2014-03-01,02A,1282,589,1871,0.6851950828433993
8007,2014-03-01,02D,458,430,888,0.5157657657657657
8008,2014-03-01,02E,1247,532,1779,0.700955593029792
8009,2014-03-01,02F,1713,630,2343,0.7311139564660691
8010,2014-03-01,02G,690,349,1039,0.6641000962463908
8011,2014-03-01,02H,1592,1334,2926,0.5440874914559125
8012,2014-03-01,02M,1103,424,1527,0.722331368696791
8013,2014-03-01,02N,1080,733,1813,0.5956977385548814
8014,2014-03-01,02P,1210,1206,2416,0.5008278145695364
8015,2014-03-01,02Q,555,436,991,0.5600403632694249
8016,2014-03-01,02R,2119,1119,3238,0.6544163063619518
8017,2014-03-01,02T,1235,732,1967,0.6278596847991865
8018,2014-03-01,02V,1338,696,2034,0.6578171091445427
8019,2014-03-01,02W,535,357,892,0.5997757847533632
8020,2014-03-01,02X,2012,1000,3012,0.6679946879150066
8021,2014-03-01,02Y,1952,923,2875,0.6789565217391305
8022,2014-03-01,03A,1235,654,1889,0.6537850714663843
8023,2014-03-01,03C,1867,1284,3151,0.5925103141859727
8024,2014-03-01,03D,953,410,1363,0.6991929567131328
8025,2014-03-01,03E,940,499,1439,0.6532314107018763
8026,2014-03-01,03F,1722,663,2385,0.7220125786163522
8027,2014-03-01,03G,1611,843,2454,0.656479217603912
8028,2014-03-01,03H,1365,520,1885,0.7241379310344828
8029,2014-03-01,03J,1151,517,1668,0.6900479616306955
8030,2014-03-01,03K,987,282,1269,0.7777777777777778
8031,2014-03-01,03L,1232,1180,2412,0.5107794361525705
8032,2014-03-01,03M,825,430,1255,0.6573705179282868
8033,2014-03-01,03N,3319,1008,4327,0.7670441414374856
8034,2014-03-01,03Q,1892,956,2848,0.6643258426966292
8035,2014-03-01,03R,2374,1195,3569,0.6651723171756795
8036,2014-03-01,03T,1723,784,2507,0.6872756282409254
8037,2014-03-01,03V,429,238,667,0.6431784107946027
8038,2014-03-01,03W,2324,1054,3378,0.6879810538780343
8039,2014-03-01,03X,483,246,729,0.6625514403292181
8040,2014-03-01,03Y,706,387,1093,0.645928636779506
8041,2014-03-01,04C,2141,912,3053,0.7012774320340649
8042,2014-03-01,04D,1342,702,2044,0.6565557729941291
8043,2014-03-01,04E,1302,669,1971,0.6605783866057838
8044,2014-03-01,04F,1489,981,2470,0.602834008097166
8045,2014-03-01,04G,4053,2224,6277,0.645690616536562
8046,2014-03-01,04H,750,338,1088,0.6893382352941176
8047,2014-03-01,04J,2065,1124,3189,0.6475384132957039
8048,2014-03-01,04K,1734,896,2630,0.6593155893536121
8049,2014-03-01,04L,921,397,1318,0.6987860394537178
8050,2014-03-01,04M,467,231,698,0.669054441260745
8051,2014-03-01,04N,694,307,1001,0.6933066933066933
8052,2014-03-01,04Q,809,357,1166,0.6938250428816467
8053,2014-03-01,04R,2616,1381,3997,0.6544908681511133
8054,2014-03-01,04V,2310,1125,3435,0.6724890829694323
8055,2014-03-01,04X,1330,1050,2380,0.5588235294117647
8056,2014-03-01,04Y,1049,383,1432,0.7325418994413407
8057,2014-03-01,05A,2711,1474,4185,0.6477897252090801
8058,2014-03-01,05C,1191,1602,2793,0.4264232008592911
8059,2014-03-01,05D,915,453,1368,0.668859649122807
8060,2014-03-01,05F,1267,609,1876,0.6753731343283582
8061,2014-03-01,05G,1504,608,2112,0.7121212121212122
8062,2014-03-01,05H,1105,677,1782,0.6200897867564534
8063,2014-03-01,05J,1386,621,2007,0.6905829596412556
8064,2014-03-01,05L,2724,1287,4011,0.6791323859386686
8065,2014-03-01,05N,2232,866,3098,0.7204648160103292
8066,2014-03-01,05P,1269,760,2029,0.6254312469196649
8067,2014-03-01,05Q,1409,648,2057,0.6849781234807972
8068,2014-03-01,05R,1777,1127,2904,0.6119146005509641
8069,2014-03-01,05T,1973,935,2908,0.6784731774415406
8070,2014-03-01,05V,989,518,1507,0.6562707365627074
8071,2014-03-01,05W,1678,638,2316,0.7245250431778929
8072,2014-03-01,05X,1223,430,1653,0.7398669086509377
8073,2014-03-01,05Y,1879,929,2808,0.6691595441595442
8074,2014-03-01,06A,1649,699,2348,0.7022998296422487
8075,2014-03-01,06D,814,399,1213,0.6710634789777411
8076,2014-03-01,06F,1615,2374,3989,0.404863374279268
8077,2014-03-01,06H,5239,2880,8119,0.6452765118857002
8078,2014-03-01,06K,3253,2311,5564,0.5846513299784328
8079,2014-03-01,06L,2402,1109,3511,0.6841355739105668
8080,2014-03-01,06M,1781,877,2658,0.6700526711813394
8081,2014-03-01,06N,3283,2210,5493,0.597669761514655
8082,2014-03-01,06P,877,988,1865,0.47024128686327077
8083,2014-03-01,06Q,2455,1224,3679,0.6673008969828758
8084,2014-03-01,06T,2212,1235,3447,0.6417174354511169
8085,2014-03-01,06V,1413,582,1995,0.7082706766917293
8086,2014-03-01,06W,1512,472,1984,0.7620967741935484
8087,2014-03-01,06Y,1332,525,1857,0.7172859450726979
8088,2014-03-01,07G,1011,340,1351,0.7483345669874167
8089,2014-03-01,07H,1725,946,2671,0.6458255335080494
8090,2014-03-01,07J,731,468,1199,0.609674728940784
8091,2014-03-01,07K,1506,669,2175,0.6924137931034483
8092,2014-03-01,07L,769,315,1084,0.709409594095941
8093,2014-03-01,07M,1209,740,1949,0.620318111852232
8094,2014-03-01,07N,1313,638,1951,0.6729882111737571
8095,2014-03-01,07P,866,582,1448,0.5980662983425414
8096,2014-03-01,07Q,1629,807,2436,0.6687192118226601
8097,2014-03-01,07R,774,548,1322,0.5854765506807866
8098,2014-03-01,07T,660,406,1066,0.6191369606003753
8099,2014-03-01,07V,1722,818,2540,0.6779527559055119
8100,2014-03-01,07W,1214,1004,2218,0.5473399458972047
8101,2014-03-01,07X,1338,601,1939,0.6900464156781846
8102,2014-03-01,07Y,813,552,1365,0.5956043956043956
8103,2014-03-01,08A,1232,692,1924,0.6403326403326404
8104,2014-03-01,08C,645,406,1051,0.6137012369172217
8105,2014-03-01,08D,879,503,1382,0.6360347322720694
8106,2014-03-01,08E,872,564,1436,0.6072423398328691
8107,2014-03-01,08F,1427,718,2145,0.6652680652680653
8108,2014-03-01,08G,476,1360,1836,0.25925925925925924
8109,2014-03-01,08H,804,550,1354,0.5937961595273265
8110,2014-03-01,08J,843,432,1275,0.6611764705882353
8111,2014-03-01,08K,1226,575,1801,0.6807329261521377
8112,2014-03-01,08L,667,1149,1816,0.3672907488986784
8113,2014-03-01,08M,1110,478,1588,0.698992443324937
8114,2014-03-01,08N,1123,534,1657,0.6777308388654194
8115,2014-03-01,08P,924,509,1433,0.64480111653873
8116,2014-03-01,08Q,980,496,1476,0.6639566395663956
8117,2014-03-01,08R,835,391,1226,0.6810766721044046
8118,2014-03-01,08T,942,483,1425,0.6610526315789473
8119,2014-03-01,08V,1002,553,1555,0.6443729903536978
8120,2014-03-01,08W,1069,526,1595,0.6702194357366771
8121,2014-03-01,08X,1263,651,1914,0.6598746081504702
8122,2014-03-01,08Y,674,533,1207,0.5584092792046396
8123,2014-03-01,09A,502,497,999,0.5025025025025025
8124,2014-03-01,09C,799,344,1143,0.6990376202974629
8125,2014-03-01,09D,1516,927,2443,0.6205485059353254
8126,2014-03-01,09E,1547,567,2114,0.7317880794701986
8127,2014-03-01,09F,1266,688,1954,0.6479017400204709
8128,2014-03-01,09G,3428,1760,5188,0.6607555898226677
8129,2014-03-01,09H,598,371,969,0.6171310629514963
8130,2014-03-01,09J,1746,962,2708,0.6447562776957164
8131,2014-03-01,09L,863,474,1337,0.6454749439042633
8132,2014-03-01,09N,1118,624,1742,0.6417910447761194
8133,2014-03-01,09P,1147,907,2054,0.5584225900681596
8134,2014-03-01,09W,1465,832,2297,0.6377884196778406
8135,2014-03-01,09X,1091,731,1822,0.5987925356750823
8136,2014-03-01,09Y,1520,1065,2585,0.5880077369439072
8137,2014-03-01,10A,1184,684,1868,0.6338329764453962
8138,2014-03-01,10C,490,240,730,0.6712328767123288
8139,2014-03-01,10D,599,280,879,0.6814562002275313
8140,2014-03-01,10E,769,352,1121,0.6859946476360392
8141,2014-03-01,10G,671,374,1045,0.6421052631578947
8142,2014-03-01,10H,1918,1185,3103,0.618111504995166
8143,2014-03-01,10J,1063,894,1957,0.543178334184977
8144,2014-03-01,10K,1340,672,2012,0.6660039761431411
8145,2014-03-01,10L,1063,349,1412,0.7528328611898017
8146,2014-03-01,10M,490,455,945,0.5185185185185185
8147,2014-03-01,10N,435,425,860,0.5058139534883721
8148,2014-03-01,10Q,3190,2928,6118,0.5214122262177182
8149,2014-03-01,10R,1443,556,1999,0.7218609304652326
8150,2014-03-01,10T,573,352,925,0.6194594594594595
8151,2014-03-01,10V,1339,655,1994,0.6715145436308927
8152,2014-03-01,10W,566,368,934,0.6059957173447538
8153,2014-03-01,10X,1147,636,1783,0.6432978126752664
8154,2014-03-01,10Y,1268,796,2064,0.6143410852713178
8155,2014-03-01,11A,3504,1680,5184,0.6759259259259259
8156,2014-03-01,11C,929,433,1362,0.6820851688693098
8157,2014-03-01,11D,626,568,1194,0.52428810720268
8158,2014-03-01,11E,1156,953,2109,0.5481270744428639
8159,2014-03-01,11H,2575,1548,4123,0.6245452340528741
8160,2014-03-01,11J,5128,2460,7588,0.6758039008961518
8161,2014-03-01,11M,3822,1904,5726,0.6674816625916871
8162,2014-03-01,11N,4260,1842,6102,0.6981317600786627
8163,2014-03-01,11T,1550,944,2494,0.6214915797914996
8164,2014-03-01,11X,3342,1888,5230,0.6390057361376673
8165,2014-03-01,12A,1559,712,2271,0.686481726111845
8166,2014-03-01,12D,1220,857,2077,0.587385652383245
8167,2014-03-01,12F,2558,743,3301,0.774916691911542
8168,2014-03-01,13P,3147,1938,5085,0.6188790560471976
8169,2014-03-01,13T,3109,1397,4506,0.6899689303151354
8170,2014-03-01,14L,3080,1824,4904,0.6280587275693311
8171,2014-03-01,99A,2872,885,3757,0.7644397125365984
8172,2014-03-01,99C,1508,782,2290,0.6585152838427948
8173,2014-03-01,99D,1140,737,1877,0.607352157698455
8174,2014-03-01,99E,1499,613,2112,0.7097537878787878
8175,2014-03-01,99F,1061,374,1435,0.7393728222996516
8176,2014-03-01,99G,1261,369,1630,0.7736196319018405
8177,2014-03-01,99H,1639,923,2562,0.6397345823575332
8178,2014-03-01,99J,3113,1647,4760,0.6539915966386555
8179,2014-03-01,99K,1050,631,1681,0.6246281975014872
8180,2014-03-01,99M,1078,777,1855,0.5811320754716981
8181,2014-03-01,99N,2910,2345,5255,0.5537583254043768
8182,2014-03-01,99P,6399,2454,8853,0.7228058285327008
8183,2014-03-01,99Q,1987,861,2848,0.6976825842696629
8184,2014-04-01,00C,704,264,968,0.7272727272727273
8185,2014-04-01,00D,2098,998,3096,0.6776485788113695
8186,2014-04-01,00J,1748,806,2554,0.6844166014095536
8187,2014-04-01,00K,2162,1024,3186,0.6785938480853735
8188,2014-04-01,00L,2252,1285,3537,0.6366977664687589
8189,2014-04-01,00M,2130,1018,3148,0.6766200762388819
8190,2014-04-01,00N,1149,534,1683,0.6827094474153298
8191,2014-04-01,00P,2036,856,2892,0.7040110650069157
8192,2014-04-01,00Q,967,391,1358,0.7120765832106039
8193,2014-04-01,00R,1260,566,1826,0.6900328587075575
8194,2014-04-01,00T,1885,1147,3032,0.6217018469656992
8195,2014-04-01,00V,1270,769,2039,0.622854340362923
8196,2014-04-01,00W,31,20,51,0.6078431372549019
8197,2014-04-01,00X,1027,245,1272,0.8073899371069182
8198,2014-04-01,00Y,1702,926,2628,0.647640791476408
8199,2014-04-01,01A,2379,1297,3676,0.647170837867247
8200,2014-04-01,01C,1193,637,1830,0.651912568306011
8201,2014-04-01,01D,1447,770,2217,0.6526838069463239
8202,2014-04-01,01E,1059,190,1249,0.8478783026421137
8203,2014-04-01,01F,907,477,1384,0.6553468208092486
8204,2014-04-01,01G,1445,1084,2529,0.5713720838275999
8205,2014-04-01,01H,2431,849,3280,0.7411585365853659
8206,2014-04-01,01J,995,475,1470,0.6768707482993197
8207,2014-04-01,01K,1978,1048,3026,0.6536682088565764
8208,2014-04-01,01N,17,16,33,0.5151515151515151
8209,2014-04-01,01R,921,486,1407,0.6545842217484008
8210,2014-04-01,01T,715,368,1083,0.6602031394275162
8211,2014-04-01,01V,832,342,1174,0.7086882453151618
8212,2014-04-01,01W,1958,923,2881,0.6796251301631377
8213,2014-04-01,01X,1333,713,2046,0.6515151515151515
8214,2014-04-01,01Y,1239,748,1987,0.6235530951182687
8215,2014-04-01,02A,1210,607,1817,0.6659328563566318
8216,2014-04-01,02D,510,419,929,0.5489773950484392
8217,2014-04-01,02E,1230,483,1713,0.7180385288966725
8218,2014-04-01,02F,1682,608,2290,0.7344978165938865
8219,2014-04-01,02G,639,361,1000,0.639
8220,2014-04-01,02H,1563,1287,2850,0.5484210526315789
8221,2014-04-01,02M,1060,411,1471,0.7205982324949014
8222,2014-04-01,02N,1043,657,1700,0.6135294117647059
8223,2014-04-01,02P,1138,1180,2318,0.4909404659188956
8224,2014-04-01,02Q,611,440,1051,0.5813510941960038
8225,2014-04-01,02R,2129,1083,3212,0.662826899128269
8226,2014-04-01,02T,1159,766,1925,0.6020779220779221
8227,2014-04-01,02V,1322,691,2013,0.6567312468951814
8228,2014-04-01,02W,511,313,824,0.6201456310679612
8229,2014-04-01,02X,1998,957,2955,0.6761421319796954
8230,2014-04-01,02Y,1938,760,2698,0.7183098591549296
8231,2014-04-01,03A,1267,614,1881,0.6735778841041999
8232,2014-04-01,03C,1770,1138,2908,0.6086657496561211
8233,2014-04-01,03D,925,360,1285,0.7198443579766537
8234,2014-04-01,03E,873,499,1372,0.6362973760932945
8235,2014-04-01,03F,1723,736,2459,0.7006913379422529
8236,2014-04-01,03G,1649,787,2436,0.6769293924466339
8237,2014-04-01,03H,1226,467,1693,0.7241582988777319
8238,2014-04-01,03J,1191,516,1707,0.6977152899824253
8239,2014-04-01,03K,885,277,1162,0.7616179001721171
8240,2014-04-01,03L,1178,1099,2277,0.5173473869126043
8241,2014-04-01,03M,821,395,1216,0.6751644736842105
8242,2014-04-01,03N,3204,932,4136,0.7746615087040619
8243,2014-04-01,03Q,1847,834,2681,0.6889220440134278
8244,2014-04-01,03R,2298,1094,3392,0.6774764150943396
8245,2014-04-01,03T,1694,742,2436,0.6954022988505747
8246,2014-04-01,03V,387,213,600,0.645
8247,2014-04-01,03W,2258,1018,3276,0.6892551892551892
8248,2014-04-01,03X,457,227,684,0.6681286549707602
8249,2014-04-01,03Y,730,395,1125,0.6488888888888888
8250,2014-04-01,04C,2050,876,2926,0.7006151742993848
8251,2014-04-01,04D,1268,671,1939,0.6539453326456937
8252,2014-04-01,04E,1188,625,1813,0.6552675124103695
8253,2014-04-01,04F,1423,991,2414,0.5894780447390223
8254,2014-04-01,04G,3910,2179,6089,0.6421415667597307
8255,2014-04-01,04H,714,351,1065,0.6704225352112676
8256,2014-04-01,04J,1975,1121,3096,0.6379198966408268
8257,2014-04-01,04K,1620,804,2424,0.6683168316831684
8258,2014-04-01,04L,849,376,1225,0.6930612244897959
8259,2014-04-01,04M,461,242,703,0.6557610241820768
8260,2014-04-01,04N,614,315,929,0.6609257265877287
8261,2014-04-01,04Q,822,334,1156,0.7110726643598616
8262,2014-04-01,04R,2545,1327,3872,0.6572830578512396
8263,2014-04-01,04V,2187,1109,3296,0.6635315533980582
8264,2014-04-01,04X,1298,923,2221,0.5844214317874831
8265,2014-04-01,04Y,1022,403,1425,0.7171929824561404
8266,2014-04-01,05A,2642,1498,4140,0.6381642512077295
8267,2014-04-01,05C,1192,1563,2755,0.4326678765880218
8268,2014-04-01,05D,879,399,1278,0.687793427230047
8269,2014-04-01,05F,1166,574,1740,0.6701149425287356
8270,2014-04-01,05G,1424,619,2043,0.6970141948115517
8271,2014-04-01,05H,1052,594,1646,0.6391251518833536
8272,2014-04-01,05J,1385,522,1907,0.7262716308337703
8273,2014-04-01,05L,2516,1258,3774,0.6666666666666666
8274,2014-04-01,05N,2179,863,3042,0.7163050624589086
8275,2014-04-01,05P,1297,743,2040,0.6357843137254902
8276,2014-04-01,05Q,1344,636,1980,0.6787878787878788
8277,2014-04-01,05R,1790,1098,2888,0.6198060941828255
8278,2014-04-01,05T,1855,929,2784,0.6663074712643678
8279,2014-04-01,05V,1016,484,1500,0.6773333333333333
8280,2014-04-01,05W,1646,645,2291,0.7184635530336098
8281,2014-04-01,05X,1061,360,1421,0.7466572836030964
8282,2014-04-01,05Y,1873,939,2812,0.6660739687055477
8283,2014-04-01,06A,1536,624,2160,0.7111111111111111
8284,2014-04-01,06D,831,348,1179,0.7048346055979644
8285,2014-04-01,06F,1548,2356,3904,0.39651639344262296
8286,2014-04-01,06H,5047,2632,7679,0.6572470373746582
8287,2014-04-01,06K,2986,2232,5218,0.5722499041778459
8288,2014-04-01,06L,2339,1084,3423,0.6833187262635115
8289,2014-04-01,06M,1779,883,2662,0.6682945154019534
8290,2014-04-01,06N,3107,2039,5146,0.6037699183832103
8291,2014-04-01,06P,830,964,1794,0.46265328874024525
8292,2014-04-01,06Q,2284,1221,3505,0.6516405135520684
8293,2014-04-01,06T,2256,1167,3423,0.6590709903593339
8294,2014-04-01,06V,1447,583,2030,0.712807881773399
8295,2014-04-01,06W,1452,482,1934,0.750775594622544
8296,2014-04-01,06Y,1240,508,1748,0.7093821510297483
8297,2014-04-01,07G,907,292,1199,0.7564637197664721
8298,2014-04-01,07H,1647,944,2591,0.6356619065997684
8299,2014-04-01,07J,689,412,1101,0.6257947320617621
8300,2014-04-01,07K,1473,689,2162,0.681313598519889
8301,2014-04-01,07L,723,343,1066,0.6782363977485929
8302,2014-04-01,07M,1207,704,1911,0.6316064887493459
8303,2014-04-01,07N,1164,581,1745,0.6670487106017192
8304,2014-04-01,07P,819,522,1341,0.610738255033557
8305,2014-04-01,07Q,1536,755,2291,0.6704495853339153
8306,2014-04-01,07R,680,488,1168,0.5821917808219178
8307,2014-04-01,07T,668,456,1124,0.594306049822064
8308,2014-04-01,07V,1735,782,2517,0.6893126738180373
8309,2014-04-01,07W,1108,958,2066,0.5363020329138432
8310,2014-04-01,07X,1276,568,1844,0.6919739696312365
8311,2014-04-01,07Y,925,501,1426,0.6486676016830295
8312,2014-04-01,08A,1122,611,1733,0.6474321984997115
8313,2014-04-01,08C,622,413,1035,0.6009661835748792
8314,2014-04-01,08D,801,525,1326,0.6040723981900452
8315,2014-04-01,08E,842,514,1356,0.6209439528023599
8316,2014-04-01,08F,1346,679,2025,0.6646913580246914
8317,2014-04-01,08G,487,1250,1737,0.28036845135290733
8318,2014-04-01,08H,770,497,1267,0.6077348066298343
8319,2014-04-01,08J,799,402,1201,0.6652789342214821
8320,2014-04-01,08K,1150,484,1634,0.7037943696450428
8321,2014-04-01,08L,627,1098,1725,0.3634782608695652
8322,2014-04-01,08M,930,427,1357,0.6853352984524687
8323,2014-04-01,08N,1169,513,1682,0.6950059453032105
8324,2014-04-01,08P,903,526,1429,0.6319104268719384
8325,2014-04-01,08Q,987,390,1377,0.7167755991285403
8326,2014-04-01,08R,856,403,1259,0.6799046862589356
8327,2014-04-01,08T,930,416,1346,0.6909361069836553
8328,2014-04-01,08V,979,544,1523,0.6428102429415627
8329,2014-04-01,08W,986,417,1403,0.7027797576621525
8330,2014-04-01,08X,1262,627,1889,0.668078348332451
8331,2014-04-01,08Y,641,507,1148,0.5583623693379791
8332,2014-04-01,09A,515,501,1016,0.5068897637795275
8333,2014-04-01,09C,734,371,1105,0.6642533936651583
8334,2014-04-01,09D,1419,835,2254,0.629547471162378
8335,2014-04-01,09E,1512,581,2093,0.7224080267558528
8336,2014-04-01,09F,1316,643,1959,0.6717713118938233
8337,2014-04-01,09G,3279,1653,4932,0.6648418491484185
8338,2014-04-01,09H,576,353,929,0.620021528525296
8339,2014-04-01,09J,1651,869,2520,0.6551587301587302
8340,2014-04-01,09L,789,491,1280,0.61640625
8341,2014-04-01,09N,1054,594,1648,0.6395631067961165
8342,2014-04-01,09P,1186,852,2038,0.5819430814524044
8343,2014-04-01,09W,1335,743,2078,0.6424446583253128
8344,2014-04-01,09X,1065,659,1724,0.6177494199535963
8345,2014-04-01,09Y,1642,1141,2783,0.5900107797340999
8346,2014-04-01,10A,1131,705,1836,0.6160130718954249
8347,2014-04-01,10C,471,253,724,0.6505524861878453
8348,2014-04-01,10D,595,245,840,0.7083333333333334
8349,2014-04-01,10E,804,336,1140,0.7052631578947368
8350,2014-04-01,10G,691,332,1023,0.6754643206256109
8351,2014-04-01,10H,1933,1088,3021,0.6398543528632903
8352,2014-04-01,10J,1099,892,1991,0.5519839276745354
8353,2014-04-01,10K,1158,577,1735,0.667435158501441
8354,2014-04-01,10L,957,363,1320,0.725
8355,2014-04-01,10M,504,354,858,0.5874125874125874
8356,2014-04-01,10N,473,395,868,0.5449308755760369
8357,2014-04-01,10Q,3090,2722,5812,0.5316586373021335
8358,2014-04-01,10R,1318,451,1769,0.7450537026568683
8359,2014-04-01,10T,592,304,896,0.6607142857142857
8360,2014-04-01,10V,1245,682,1927,0.6460819927348209
8361,2014-04-01,10W,533,332,865,0.6161849710982659
8362,2014-04-01,10X,1157,604,1761,0.6570130607609312
8363,2014-04-01,10Y,1206,763,1969,0.6124936515997969
8364,2014-04-01,11A,3468,1629,5097,0.6804002354326074
8365,2014-04-01,11C,872,358,1230,0.7089430894308943
8366,2014-04-01,11D,574,493,1067,0.5379568884723523
8367,2014-04-01,11E,1043,835,1878,0.5553780617678381
8368,2014-04-01,11H,2436,1362,3798,0.641390205371248
8369,2014-04-01,11J,4991,2338,7329,0.6809933142311366
8370,2014-04-01,11M,3645,1681,5326,0.6843785204656403
8371,2014-04-01,11N,4137,1582,5719,0.7233782129742962
8372,2014-04-01,11T,1496,879,2375,0.6298947368421053
8373,2014-04-01,11X,3232,1867,5099,0.6338497744655814
8374,2014-04-01,12A,1469,689,2158,0.6807228915662651
8375,2014-04-01,12D,1067,799,1866,0.5718113612004287
8376,2014-04-01,12F,2339,685,3024,0.7734788359788359
8377,2014-04-01,13P,2998,1799,4797,0.6249739420471128
8378,2014-04-01,13T,3047,1298,4345,0.7012658227848101
8379,2014-04-01,14L,2964,1648,4612,0.6426712922810061
8380,2014-04-01,99A,2515,879,3394,0.7410135533294049
8381,2014-04-01,99C,1529,746,2275,0.6720879120879121
8382,2014-04-01,99D,1054,671,1725,0.6110144927536232
8383,2014-04-01,99E,1439,554,1993,0.7220270948319117
8384,2014-04-01,99F,1105,355,1460,0.7568493150684932
8385,2014-04-01,99G,1110,389,1499,0.7404936624416277
8386,2014-04-01,99H,1606,952,2558,0.6278342455043002
8387,2014-04-01,99J,2823,1451,4274,0.6605053813757604
8388,2014-04-01,99K,1018,568,1586,0.6418663303909206
8389,2014-04-01,99M,1064,782,1846,0.5763813651137595
8390,2014-04-01,99N,2871,2168,5039,0.5697559039491963
8391,2014-04-01,99P,6500,2267,8767,0.7414166761720087
8392,2014-04-01,99Q,1941,830,2771,0.7004691447131
8393,2014-05-01,00C,713,292,1005,0.709452736318408
8394,2014-05-01,00D,2255,1134,3389,0.6653880200649159
8395,2014-05-01,00J,1852,808,2660,0.6962406015037594
8396,2014-05-01,00K,2099,999,3098,0.6775338928340865
8397,2014-05-01,00L,2326,1418,3744,0.6212606837606838
8398,2014-05-01,00M,2172,1048,3220,0.6745341614906832
8399,2014-05-01,00N,1140,562,1702,0.6698002350176263
8400,2014-05-01,00P,2151,866,3017,0.7129598939343719
8401,2014-05-01,00Q,970,386,1356,0.7153392330383481
8402,2014-05-01,00R,1204,577,1781,0.6760247052217855
8403,2014-05-01,00T,1924,1216,3140,0.6127388535031847
8404,2014-05-01,00V,1336,817,2153,0.6205294937296795
8405,2014-05-01,00W,48,19,67,0.7164179104477612
8406,2014-05-01,00X,1045,272,1317,0.7934700075930144
8407,2014-05-01,00Y,1835,986,2821,0.6504785537043601
8408,2014-05-01,01A,2420,1361,3781,0.6400423168473949
8409,2014-05-01,01C,1229,702,1931,0.6364577938891766
8410,2014-05-01,01D,1403,810,2213,0.6339810212381383
8411,2014-05-01,01E,1061,200,1261,0.8413957176843775
8412,2014-05-01,01F,980,490,1470,0.6666666666666666
8413,2014-05-01,01G,1435,1098,2533,0.566521910777734
8414,2014-05-01,01H,2508,891,3399,0.7378640776699029
8415,2014-05-01,01J,1048,478,1526,0.6867627785058977
8416,2014-05-01,01K,2138,1153,3291,0.6496505621391674
8417,2014-05-01,01N,13,24,37,0.35135135135135137
8418,2014-05-01,01R,1034,538,1572,0.6577608142493638
8419,2014-05-01,01T,743,374,1117,0.6651745747538048
8420,2014-05-01,01V,818,361,1179,0.6938083121289228
8421,2014-05-01,01W,2108,1033,3141,0.6711238459089462
8422,2014-05-01,01X,1381,735,2116,0.6526465028355387
8423,2014-05-01,01Y,1159,821,1980,0.5853535353535354
8424,2014-05-01,02A,1260,630,1890,0.6666666666666666
8425,2014-05-01,02D,494,430,924,0.5346320346320347
8426,2014-05-01,02E,1248,549,1797,0.6944908180300501
8427,2014-05-01,02F,1673,642,2315,0.7226781857451404
8428,2014-05-01,02G,567,325,892,0.6356502242152466
8429,2014-05-01,02H,1611,1297,2908,0.5539889958734525
8430,2014-05-01,02M,1091,400,1491,0.7317236753856472
8431,2014-05-01,02N,1020,673,1693,0.6024808033077378
8432,2014-05-01,02P,1140,1250,2390,0.4769874476987448
8433,2014-05-01,02Q,640,478,1118,0.5724508050089445
8434,2014-05-01,02R,2295,1264,3559,0.6448440573194718
8435,2014-05-01,02T,1176,699,1875,0.6272
8436,2014-05-01,02V,1439,724,2163,0.6652797041146555
8437,2014-05-01,02W,570,333,903,0.6312292358803987
8438,2014-05-01,02X,2019,932,2951,0.6841748559810233
8439,2014-05-01,02Y,2096,875,2971,0.7054863682261865
8440,2014-05-01,03A,1415,636,2051,0.6899073622623111
8441,2014-05-01,03C,1725,1186,2911,0.5925798694606664
8442,2014-05-01,03D,898,400,1298,0.6918335901386748
8443,2014-05-01,03E,936,521,1457,0.6424159231297186
8444,2014-05-01,03F,1690,679,2369,0.7133811734909244
8445,2014-05-01,03G,1660,850,2510,0.6613545816733067
8446,2014-05-01,03H,1261,550,1811,0.6963003865267808
8447,2014-05-01,03J,1214,498,1712,0.7091121495327103
8448,2014-05-01,03K,966,281,1247,0.7746591820368885
8449,2014-05-01,03L,1172,1117,2289,0.5120139799038882
8450,2014-05-01,03M,814,430,1244,0.6543408360128617
8451,2014-05-01,03N,3342,1039,4381,0.7628395343528874
8452,2014-05-01,03Q,1801,1006,2807,0.6416102600641254
8453,2014-05-01,03R,2286,1236,3522,0.6490630323679727
8454,2014-05-01,03T,1749,727,2476,0.7063812600969306
8455,2014-05-01,03V,438,224,662,0.6616314199395771
8456,2014-05-01,03W,2265,1066,3331,0.6799759831882317
8457,2014-05-01,03X,492,281,773,0.6364812419146184
8458,2014-05-01,03Y,705,376,1081,0.6521739130434783
8459,2014-05-01,04C,2064,769,2833,0.7285563007412637
8460,2014-05-01,04D,1316,739,2055,0.6403892944038929
8461,2014-05-01,04E,1294,702,1996,0.6482965931863728
8462,2014-05-01,04F,1611,1013,2624,0.6139481707317073
8463,2014-05-01,04G,4404,1975,6379,0.6903903433139991
8464,2014-05-01,04H,699,378,1077,0.649025069637883
8465,2014-05-01,04J,2116,1158,3274,0.6463042150274894
8466,2014-05-01,04K,1765,879,2644,0.6675491679273827
8467,2014-05-01,04L,852,331,1183,0.7202028740490279
8468,2014-05-01,04M,468,252,720,0.65
8469,2014-05-01,04N,714,325,1039,0.687199230028874
8470,2014-05-01,04Q,855,298,1153,0.7415437987857763
8471,2014-05-01,04R,2625,1357,3982,0.6592164741336012
8472,2014-05-01,04V,2360,1024,3384,0.6973995271867612
8473,2014-05-01,04X,1452,995,2447,0.593379648549244
8474,2014-05-01,04Y,1082,413,1495,0.7237458193979933
8475,2014-05-01,05A,2716,1461,4177,0.6502274359588222
8476,2014-05-01,05C,1348,1498,2846,0.4736472241742797
8477,2014-05-01,05D,971,455,1426,0.6809256661991585
8478,2014-05-01,05F,1202,694,1896,0.6339662447257384
8479,2014-05-01,05G,1551,630,2181,0.7111416781292985
8480,2014-05-01,05H,1066,601,1667,0.6394721055788842
8481,2014-05-01,05J,1473,685,2158,0.6825764596848934
8482,2014-05-01,05L,2599,1415,4014,0.6474838066766317
8483,2014-05-01,05N,2380,860,3240,0.7345679012345679
8484,2014-05-01,05P,1314,801,2115,0.6212765957446809
8485,2014-05-01,05Q,1351,643,1994,0.6775325977933802
8486,2014-05-01,05R,1855,1132,2987,0.6210244392366924
8487,2014-05-01,05T,1991,1032,3023,0.658617267614952
8488,2014-05-01,05V,1044,459,1503,0.6946107784431138
8489,2014-05-01,05W,1692,721,2413,0.7012018234562785
8490,2014-05-01,05X,1180,413,1593,0.7407407407407407
8491,2014-05-01,05Y,1937,896,2833,0.6837274973526297
8492,2014-05-01,06A,1564,679,2243,0.6972804279982167
8493,2014-05-01,06D,863,405,1268,0.6805993690851735
8494,2014-05-01,06F,1619,2157,3776,0.428760593220339
8495,2014-05-01,06H,5266,2738,8004,0.6579210394802598
8496,2014-05-01,06K,3281,2238,5519,0.5944917557528537
8497,2014-05-01,06L,2479,1051,3530,0.7022662889518414
8498,2014-05-01,06M,1968,924,2892,0.6804979253112033
8499,2014-05-01,06N,3319,2155,5474,0.6063207891852394
8500,2014-05-01,06P,886,936,1822,0.4862788144895719
8501,2014-05-01,06Q,2438,1138,3576,0.6817673378076062
8502,2014-05-01,06T,2380,1196,3576,0.6655480984340044
8503,2014-05-01,06V,1459,529,1988,0.7339034205231388
8504,2014-05-01,06W,1457,489,1946,0.7487153134635149
8505,2014-05-01,06Y,1286,555,1841,0.6985334057577404
8506,2014-05-01,07G,914,325,1239,0.7376916868442293
8507,2014-05-01,07H,1739,937,2676,0.6498505231689088
8508,2014-05-01,07J,758,485,1243,0.6098149637972646
8509,2014-05-01,07K,1490,739,2229,0.6684611933602512
8510,2014-05-01,07L,810,336,1146,0.7068062827225131
8511,2014-05-01,07M,1326,759,2085,0.6359712230215827
8512,2014-05-01,07N,1269,592,1861,0.6818914562063407
8513,2014-05-01,07P,861,608,1469,0.5861130020422056
8514,2014-05-01,07Q,1596,849,2445,0.652760736196319
8515,2014-05-01,07R,724,600,1324,0.5468277945619335
8516,2014-05-01,07T,673,468,1141,0.5898334794040315
8517,2014-05-01,07V,1817,834,2651,0.6854017351942663
8518,2014-05-01,07W,1210,971,2181,0.5547913801008711
8519,2014-05-01,07X,1320,548,1868,0.7066381156316917
8520,2014-05-01,07Y,886,475,1361,0.6509919177075679
8521,2014-05-01,08A,1254,670,1924,0.6517671517671517
8522,2014-05-01,08C,629,432,1061,0.592836946277097
8523,2014-05-01,08D,889,487,1376,0.6460755813953488
8524,2014-05-01,08E,875,498,1373,0.6372906045156591
8525,2014-05-01,08F,1371,651,2022,0.6780415430267063
8526,2014-05-01,08G,518,1266,1784,0.29035874439461884
8527,2014-05-01,08H,806,523,1329,0.6064710308502633
8528,2014-05-01,08J,816,419,1235,0.6607287449392713
8529,2014-05-01,08K,1165,516,1681,0.6930398572278406
8530,2014-05-01,08L,713,1107,1820,0.39175824175824175
8531,2014-05-01,08M,1092,420,1512,0.7222222222222222
8532,2014-05-01,08N,1131,585,1716,0.6590909090909091
8533,2014-05-01,08P,976,557,1533,0.6366601435094585
8534,2014-05-01,08Q,1021,479,1500,0.6806666666666666
8535,2014-05-01,08R,847,417,1264,0.6700949367088608
8536,2014-05-01,08T,954,492,1446,0.6597510373443983
8537,2014-05-01,08V,979,500,1479,0.6619337390128465
8538,2014-05-01,08W,1016,522,1538,0.6605981794538361
8539,2014-05-01,08X,1308,621,1929,0.6780715396578538
8540,2014-05-01,08Y,695,506,1201,0.578684429641965
8541,2014-05-01,09A,548,556,1104,0.4963768115942029
8542,2014-05-01,09C,792,363,1155,0.6857142857142857
8543,2014-05-01,09D,1449,851,2300,0.63
8544,2014-05-01,09E,1665,650,2315,0.7192224622030238
8545,2014-05-01,09F,1359,679,2038,0.6668302257114819
8546,2014-05-01,09G,3473,1798,5271,0.6588882564978182
8547,2014-05-01,09H,553,414,967,0.5718717683557394
8548,2014-05-01,09J,1728,958,2686,0.6433358153387937
8549,2014-05-01,09L,876,445,1321,0.6631339894019682
8550,2014-05-01,09N,1246,643,1889,0.6596082583377448
8551,2014-05-01,09P,1190,792,1982,0.6004036326942482
8552,2014-05-01,09W,1413,748,2161,0.6538639518741324
8553,2014-05-01,09X,1112,720,1832,0.6069868995633187
8554,2014-05-01,09Y,1714,1086,2800,0.6121428571428571
8555,2014-05-01,10A,1247,670,1917,0.6504955659885238
8556,2014-05-01,10C,447,264,711,0.6286919831223629
8557,2014-05-01,10D,601,247,848,0.7087264150943396
8558,2014-05-01,10E,900,324,1224,0.7352941176470589
8559,2014-05-01,10G,709,366,1075,0.6595348837209303
8560,2014-05-01,10H,1981,1256,3237,0.61198640716713
8561,2014-05-01,10J,1152,822,1974,0.5835866261398176
8562,2014-05-01,10K,1346,583,1929,0.6977708657335407
8563,2014-05-01,10L,954,370,1324,0.7205438066465257
8564,2014-05-01,10M,503,395,898,0.5601336302895323
8565,2014-05-01,10N,495,376,871,0.5683122847301951
8566,2014-05-01,10Q,3447,2799,6246,0.5518731988472623
8567,2014-05-01,10R,1444,470,1914,0.754440961337513
8568,2014-05-01,10T,570,311,881,0.6469920544835415
8569,2014-05-01,10V,1283,671,1954,0.6566018423746162
8570,2014-05-01,10W,633,414,1047,0.6045845272206304
8571,2014-05-01,10X,1178,664,1842,0.6395222584147665
8572,2014-05-01,10Y,1248,820,2068,0.6034816247582205
8573,2014-05-01,11A,3701,1739,5440,0.6803308823529411
8574,2014-05-01,11C,958,457,1415,0.6770318021201414
8575,2014-05-01,11D,661,548,1209,0.5467328370554178
8576,2014-05-01,11E,1105,856,1961,0.563488016318205
8577,2014-05-01,11H,2521,1439,3960,0.6366161616161616
8578,2014-05-01,11J,5067,2423,7490,0.676502002670227
8579,2014-05-01,11M,3853,2030,5883,0.6549379568247493
8580,2014-05-01,11N,4243,1726,5969,0.7108393365722901
8581,2014-05-01,11T,1524,904,2428,0.627677100494234
8582,2014-05-01,11X,3434,1785,5219,0.6579804560260586
8583,2014-05-01,12A,1540,702,2242,0.6868867082961642
8584,2014-05-01,12D,1142,808,1950,0.5856410256410256
8585,2014-05-01,12F,2486,747,3233,0.7689452520878441
8586,2014-05-01,13P,3104,1921,5025,0.6177114427860696
8587,2014-05-01,13T,3113,1427,4540,0.6856828193832599
8588,2014-05-01,14L,3105,1754,4859,0.6390203745626672
8589,2014-05-01,99A,2737,924,3661,0.7476099426386233
8590,2014-05-01,99C,1546,789,2335,0.6620985010706638
8591,2014-05-01,99D,1151,703,1854,0.6208198489751888
8592,2014-05-01,99E,1478,554,2032,0.7273622047244095
8593,2014-05-01,99F,1096,369,1465,0.7481228668941979
8594,2014-05-01,99G,1260,400,1660,0.7590361445783133
8595,2014-05-01,99H,1731,994,2725,0.6352293577981651
8596,2014-05-01,99J,3036,1620,4656,0.6520618556701031
8597,2014-05-01,99K,1059,616,1675,0.6322388059701493
8598,2014-05-01,99M,1097,801,1898,0.5779768177028451
8599,2014-05-01,99N,3083,2070,5153,0.5982922569377062
8600,2014-05-01,99P,6554,2392,8946,0.7326179298010284
8601,2014-05-01,99Q,2190,849,3039,0.7206317867719645
8602,2014-06-01,00C,674,273,947,0.7117212249208026
8603,2014-06-01,00D,2233,1080,3313,0.6740114699667975
8604,2014-06-01,00J,1736,807,2543,0.6826582776248525
8605,2014-06-01,00K,2196,1003,3199,0.6864645201625508
8606,2014-06-01,00L,2201,1369,3570,0.6165266106442577
8607,2014-06-01,00M,2241,1051,3292,0.6807411907654921
8608,2014-06-01,00N,1212,570,1782,0.6801346801346801
8609,2014-06-01,00P,2161,862,3023,0.71485279523652
8610,2014-06-01,00Q,945,373,1318,0.7169954476479514
8611,2014-06-01,00R,1134,545,1679,0.6754020250148898
8612,2014-06-01,00T,1962,1164,3126,0.6276391554702495
8613,2014-06-01,00V,1273,792,2065,0.6164648910411622
8614,2014-06-01,00W,45,20,65,0.6923076923076923
8615,2014-06-01,00X,945,249,1194,0.7914572864321608
8616,2014-06-01,00Y,1793,970,2763,0.6489323199420919
8617,2014-06-01,01A,2477,1263,3740,0.6622994652406418
8618,2014-06-01,01C,1205,661,1866,0.6457663451232583
8619,2014-06-01,01D,1601,763,2364,0.6772419627749577
8620,2014-06-01,01E,996,170,1166,0.8542024013722127
8621,2014-06-01,01F,898,523,1421,0.6319493314567206
8622,2014-06-01,01G,1439,1242,2681,0.5367400223797091
8623,2014-06-01,01H,2455,875,3330,0.7372372372372372
8624,2014-06-01,01J,1046,480,1526,0.6854521625163827
8625,2014-06-01,01K,2051,1152,3203,0.6403371838901031
8626,2014-06-01,01N,20,19,39,0.5128205128205128
8627,2014-06-01,01R,1008,534,1542,0.6536964980544747
8628,2014-06-01,01T,776,387,1163,0.6672398968185727
8629,2014-06-01,01V,858,359,1217,0.705012325390304
8630,2014-06-01,01W,2082,967,3049,0.682846835027878
8631,2014-06-01,01X,1313,674,1987,0.6607951685958732
8632,2014-06-01,01Y,1040,711,1751,0.5939463163906339
8633,2014-06-01,02A,1272,601,1873,0.6791243993593166
8634,2014-06-01,02D,501,418,919,0.545157780195865
8635,2014-06-01,02E,1182,506,1688,0.7002369668246445
8636,2014-06-01,02F,1677,673,2350,0.7136170212765958
8637,2014-06-01,02G,576,317,893,0.64501679731243
8638,2014-06-01,02H,1571,1451,3022,0.5198544010589013
8639,2014-06-01,02M,1024,388,1412,0.7252124645892352
8640,2014-06-01,02N,1032,663,1695,0.6088495575221239
8641,2014-06-01,02P,1152,1318,2470,0.46639676113360323
8642,2014-06-01,02Q,660,456,1116,0.5913978494623656
8643,2014-06-01,02R,2203,1207,3410,0.646041055718475
8644,2014-06-01,02T,1179,762,1941,0.60741885625966
8645,2014-06-01,02V,1379,644,2023,0.6816608996539792
8646,2014-06-01,02W,543,306,849,0.6395759717314488
8647,2014-06-01,02X,1978,923,2901,0.681833850396415
8648,2014-06-01,02Y,2005,875,2880,0.6961805555555556
8649,2014-06-01,03A,1348,633,1981,0.6804644119131752
8650,2014-06-01,03C,1875,1192,3067,0.6113465927616564
8651,2014-06-01,03D,953,379,1332,0.7154654654654654
8652,2014-06-01,03E,932,505,1437,0.6485734168406402
8653,2014-06-01,03F,1669,644,2313,0.7215737137916126
8654,2014-06-01,03G,1669,912,2581,0.6466485858194498
8655,2014-06-01,03H,1268,479,1747,0.7258156840297653
8656,2014-06-01,03J,1138,498,1636,0.69559902200489
8657,2014-06-01,03K,982,306,1288,0.7624223602484472
8658,2014-06-01,03L,1179,1138,2317,0.5088476478204574
8659,2014-06-01,03M,838,413,1251,0.6698641087130296
8660,2014-06-01,03N,3331,1104,4435,0.7510710259301014
8661,2014-06-01,03Q,1918,987,2905,0.6602409638554216
8662,2014-06-01,03R,2335,1209,3544,0.6588600451467269
8663,2014-06-01,03T,1846,778,2624,0.7035060975609756
8664,2014-06-01,03V,436,248,684,0.6374269005847953
8665,2014-06-01,03W,2218,1063,3281,0.6760134105455654
8666,2014-06-01,03X,483,240,723,0.6680497925311203
8667,2014-06-01,03Y,695,374,1069,0.6501403180542563
8668,2014-06-01,04C,2012,824,2836,0.7094499294781382
8669,2014-06-01,04D,1369,734,2103,0.6509747979077508
8670,2014-06-01,04E,1206,713,1919,0.6284523189161021
8671,2014-06-01,04F,1520,1010,2530,0.6007905138339921
8672,2014-06-01,04G,4183,2026,6209,0.6736994685134482
8673,2014-06-01,04H,760,374,1134,0.6701940035273368
8674,2014-06-01,04J,2046,1131,3177,0.6440037771482531
8675,2014-06-01,04K,1626,824,2450,0.6636734693877551
8676,2014-06-01,04L,897,367,1264,0.7096518987341772
8677,2014-06-01,04M,532,248,780,0.6820512820512821
8678,2014-06-01,04N,656,336,992,0.6612903225806451
8679,2014-06-01,04Q,807,351,1158,0.6968911917098446
8680,2014-06-01,04R,2634,1349,3983,0.6613105699221692
8681,2014-06-01,04V,2321,1020,3341,0.6947021849745585
8682,2014-06-01,04X,1391,1034,2425,0.5736082474226805
8683,2014-06-01,04Y,1023,397,1420,0.7204225352112676
8684,2014-06-01,05A,2628,1461,4089,0.6426999266324285
8685,2014-06-01,05C,1182,1579,2761,0.42810575878304963
8686,2014-06-01,05D,957,437,1394,0.6865136298421808
8687,2014-06-01,05F,1222,615,1837,0.6652150244964616
8688,2014-06-01,05G,1493,561,2054,0.7268743914313535
8689,2014-06-01,05H,1091,587,1678,0.6501787842669845
8690,2014-06-01,05J,1241,642,1883,0.6590546999468933
8691,2014-06-01,05L,2463,1374,3837,0.6419077404222049
8692,2014-06-01,05N,2262,878,3140,0.7203821656050955
8693,2014-06-01,05P,1358,761,2119,0.6408683341198679
8694,2014-06-01,05Q,1335,649,1984,0.672883064516129
8695,2014-06-01,05R,1762,1161,2923,0.6028053369825521
8696,2014-06-01,05T,1990,990,2980,0.6677852348993288
8697,2014-06-01,05V,1037,500,1537,0.6746909564085881
8698,2014-06-01,05W,1728,726,2454,0.7041564792176039
8699,2014-06-01,05X,1195,437,1632,0.7322303921568627
8700,2014-06-01,05Y,1908,920,2828,0.6746817538896747
8701,2014-06-01,06A,1665,674,2339,0.711842667806755
8702,2014-06-01,06D,834,408,1242,0.6714975845410628
8703,2014-06-01,06F,1619,2475,4094,0.39545676599902296
8704,2014-06-01,06H,5095,2869,7964,0.6397538925163234
8705,2014-06-01,06K,3290,2209,5499,0.5982905982905983
8706,2014-06-01,06L,2375,1105,3480,0.6824712643678161
8707,2014-06-01,06M,1846,883,2729,0.6764382557713449
8708,2014-06-01,06N,3273,2139,5412,0.6047671840354767
8709,2014-06-01,06P,880,936,1816,0.4845814977973568
8710,2014-06-01,06Q,2407,1170,3577,0.6729102599944087
8711,2014-06-01,06T,2322,1117,3439,0.6751962779877871
8712,2014-06-01,06V,1434,521,1955,0.7335038363171356
8713,2014-06-01,06W,1300,486,1786,0.7278835386338186
8714,2014-06-01,06Y,1227,509,1736,0.7067972350230415
8715,2014-06-01,07G,907,313,1220,0.7434426229508196
8716,2014-06-01,07H,1740,952,2692,0.6463595839524517
8717,2014-06-01,07J,796,449,1245,0.6393574297188755
8718,2014-06-01,07K,1441,693,2134,0.6752577319587629
8719,2014-06-01,07L,794,307,1101,0.7211625794732062
8720,2014-06-01,07M,1255,805,2060,0.6092233009708737
8721,2014-06-01,07N,1308,603,1911,0.6844583987441131
8722,2014-06-01,07P,917,558,1475,0.6216949152542373
8723,2014-06-01,07Q,1546,868,2414,0.6404308202154101
8724,2014-06-01,07R,685,517,1202,0.569883527454243
8725,2014-06-01,07T,669,482,1151,0.58123370981755
8726,2014-06-01,07V,1727,912,2639,0.6544145509662751
8727,2014-06-01,07W,1100,948,2048,0.537109375
8728,2014-06-01,07X,1284,642,1926,0.6666666666666666
8729,2014-06-01,07Y,894,559,1453,0.6152787336545079
8730,2014-06-01,08A,1113,643,1756,0.6338268792710706
8731,2014-06-01,08C,637,442,1079,0.5903614457831325
8732,2014-06-01,08D,917,535,1452,0.6315426997245179
8733,2014-06-01,08E,889,541,1430,0.6216783216783217
8734,2014-06-01,08F,1480,691,2171,0.6817134960847536
8735,2014-06-01,08G,544,1340,1884,0.28874734607218683
8736,2014-06-01,08H,720,545,1265,0.5691699604743083
8737,2014-06-01,08J,860,475,1335,0.6441947565543071
8738,2014-06-01,08K,1215,545,1760,0.6903409090909091
8739,2014-06-01,08L,666,1227,1893,0.3518225039619651
8740,2014-06-01,08M,1025,462,1487,0.6893073301950235
8741,2014-06-01,08N,1170,504,1674,0.6989247311827957
8742,2014-06-01,08P,902,537,1439,0.6268241834607367
8743,2014-06-01,08Q,959,427,1386,0.6919191919191919
8744,2014-06-01,08R,867,441,1308,0.6628440366972477
8745,2014-06-01,08T,921,444,1365,0.6747252747252748
8746,2014-06-01,08V,999,537,1536,0.650390625
8747,2014-06-01,08W,1053,520,1573,0.6694214876033058
8748,2014-06-01,08X,1344,626,1970,0.682233502538071
8749,2014-06-01,08Y,664,551,1215,0.5465020576131687
8750,2014-06-01,09A,532,524,1056,0.5037878787878788
8751,2014-06-01,09C,749,386,1135,0.6599118942731278
8752,2014-06-01,09D,1429,781,2210,0.646606334841629
8753,2014-06-01,09E,1451,576,2027,0.715836211149482
8754,2014-06-01,09F,1258,603,1861,0.6759806555615261
8755,2014-06-01,09G,3339,1720,5059,0.6600118600513936
8756,2014-06-01,09H,562,375,937,0.5997865528281751
8757,2014-06-01,09J,1722,1005,2727,0.6314631463146315
8758,2014-06-01,09L,859,460,1319,0.6512509476876421
8759,2014-06-01,09N,1107,649,1756,0.6304100227790432
8760,2014-06-01,09P,1183,799,1982,0.5968718466195762
8761,2014-06-01,09W,1348,825,2173,0.6203405430280718
8762,2014-06-01,09X,1064,750,1814,0.5865490628445424
8763,2014-06-01,09Y,1686,1129,2815,0.5989342806394317
8764,2014-06-01,10A,1164,735,1899,0.6129541864139021
8765,2014-06-01,10C,488,251,739,0.6603518267929634
8766,2014-06-01,10D,578,256,834,0.6930455635491607
8767,2014-06-01,10E,828,348,1176,0.7040816326530612
8768,2014-06-01,10G,650,351,1001,0.6493506493506493
8769,2014-06-01,10H,1954,1207,3161,0.6181588105030054
8770,2014-06-01,10J,1161,778,1939,0.5987622485817432
8771,2014-06-01,10K,1253,643,1896,0.6608649789029536
8772,2014-06-01,10L,964,413,1377,0.7000726216412491
8773,2014-06-01,10M,537,438,975,0.5507692307692308
8774,2014-06-01,10N,444,411,855,0.519298245614035
8775,2014-06-01,10Q,3253,2809,6062,0.5366215770372814
8776,2014-06-01,10R,1299,468,1767,0.735144312393888
8777,2014-06-01,10T,568,313,881,0.64472190692395
8778,2014-06-01,10V,1241,698,1939,0.6400206291903043
8779,2014-06-01,10W,617,367,984,0.6270325203252033
8780,2014-06-01,10X,1174,588,1762,0.6662883087400681
8781,2014-06-01,10Y,1296,773,2069,0.626389560173997
8782,2014-06-01,11A,3411,1574,4985,0.6842527582748245
8783,2014-06-01,11C,919,389,1308,0.7025993883792049
8784,2014-06-01,11D,655,524,1179,0.5555555555555556
8785,2014-06-01,11E,1045,794,1839,0.5682436106579662
8786,2014-06-01,11H,2507,1336,3843,0.6523549310434557
8787,2014-06-01,11J,5050,2367,7417,0.6808682755831199
8788,2014-06-01,11M,3767,1933,5700,0.6608771929824562
8789,2014-06-01,11N,4262,1648,5910,0.7211505922165821
8790,2014-06-01,11T,1506,849,2355,0.6394904458598726
8791,2014-06-01,11X,3309,1724,5033,0.6574607589906616
8792,2014-06-01,12A,1518,690,2208,0.6875
8793,2014-06-01,12D,1061,740,1801,0.5891171571349251
8794,2014-06-01,12F,2414,714,3128,0.7717391304347826
8795,2014-06-01,13P,3200,1951,5151,0.62123859444768
8796,2014-06-01,13T,3161,1414,4575,0.6909289617486338
8797,2014-06-01,14L,3016,1751,4767,0.6326830291588
8798,2014-06-01,99A,2681,1018,3699,0.7247904839145715
8799,2014-06-01,99C,1531,806,2337,0.6551133932391956
8800,2014-06-01,99D,1068,722,1790,0.5966480446927375
8801,2014-06-01,99E,1548,597,2145,0.7216783216783217
8802,2014-06-01,99F,1064,360,1424,0.7471910112359551
8803,2014-06-01,99G,1267,400,1667,0.7600479904019196
8804,2014-06-01,99H,1664,948,2612,0.6370597243491577
8805,2014-06-01,99J,2992,1468,4460,0.6708520179372197
8806,2014-06-01,99K,1017,593,1610,0.6316770186335404
8807,2014-06-01,99M,1131,788,1919,0.5893694632621157
8808,2014-06-01,99N,3015,2220,5235,0.5759312320916905
8809,2014-06-01,99P,6422,2317,8739,0.7348666895525804
8810,2014-06-01,99Q,1964,794,2758,0.7121102248005802
8811,2014-07-01,00C,740,303,1043,0.7094918504314478
8812,2014-07-01,00D,2391,1137,3528,0.6777210884353742
8813,2014-07-01,00J,1843,828,2671,0.6900037439161363
8814,2014-07-01,00K,2391,1145,3536,0.6761877828054299
8815,2014-07-01,00L,2452,1391,3843,0.6380431954202446
8816,2014-07-01,00M,2406,1163,3569,0.6741384141216027
8817,2014-07-01,00N,1310,698,2008,0.6523904382470119
8818,2014-07-01,00P,2190,851,3041,0.7201578428148635
8819,2014-07-01,00Q,1001,459,1460,0.6856164383561644
8820,2014-07-01,00R,1259,561,1820,0.6917582417582417
8821,2014-07-01,00T,2060,1235,3295,0.6251896813353566
8822,2014-07-01,00V,1403,805,2208,0.6354166666666666
8823,2014-07-01,00W,38,25,63,0.6031746031746031
8824,2014-07-01,00X,1101,282,1383,0.7960954446854663
8825,2014-07-01,00Y,1761,1056,2817,0.625133120340788
8826,2014-07-01,01A,2648,1331,3979,0.6654938426740387
8827,2014-07-01,01C,1237,677,1914,0.6462904911180773
8828,2014-07-01,01D,1522,839,2361,0.6446421008047437
8829,2014-07-01,01E,1131,217,1348,0.8390207715133531
8830,2014-07-01,01F,1002,526,1528,0.6557591623036649
8831,2014-07-01,01G,1454,1168,2622,0.5545385202135774
8832,2014-07-01,01H,2565,925,3490,0.7349570200573066
8833,2014-07-01,01J,1129,516,1645,0.686322188449848
8834,2014-07-01,01K,2220,1225,3445,0.6444121915820029
8835,2014-07-01,01N,19,10,29,0.6551724137931034
8836,2014-07-01,01R,1048,604,1652,0.6343825665859564
8837,2014-07-01,01T,795,459,1254,0.6339712918660287
8838,2014-07-01,01V,924,419,1343,0.68801191362621
8839,2014-07-01,01W,2233,1080,3313,0.6740114699667975
8840,2014-07-01,01X,1391,799,2190,0.6351598173515982
8841,2014-07-01,01Y,1243,756,1999,0.6218109054527263
8842,2014-07-01,02A,1251,703,1954,0.6402251791197543
8843,2014-07-01,02D,520,435,955,0.5445026178010471
8844,2014-07-01,02E,1346,591,1937,0.6948890036138359
8845,2014-07-01,02F,1688,692,2380,0.7092436974789916
8846,2014-07-01,02G,604,380,984,0.6138211382113821
8847,2014-07-01,02H,1680,1485,3165,0.5308056872037915
8848,2014-07-01,02M,1084,368,1452,0.7465564738292011
8849,2014-07-01,02N,1081,711,1792,0.6032366071428571
8850,2014-07-01,02P,1256,1468,2724,0.461086637298091
8851,2014-07-01,02Q,681,471,1152,0.5911458333333334
8852,2014-07-01,02R,2280,1235,3515,0.6486486486486487
8853,2014-07-01,02T,1301,819,2120,0.6136792452830189
8854,2014-07-01,02V,1442,787,2229,0.6469268730372364
8855,2014-07-01,02W,599,301,900,0.6655555555555556
8856,2014-07-01,02X,2189,1048,3237,0.6762434352795799
8857,2014-07-01,02Y,2045,877,2922,0.6998631074606434
8858,2014-07-01,03A,1432,747,2179,0.6571821936668196
8859,2014-07-01,03C,1908,1234,3142,0.6072565245066837
8860,2014-07-01,03D,1014,436,1450,0.6993103448275862
8861,2014-07-01,03E,989,566,1555,0.6360128617363344
8862,2014-07-01,03F,1712,648,2360,0.7254237288135593
8863,2014-07-01,03G,1804,934,2738,0.6588750913075238
8864,2014-07-01,03H,1300,496,1796,0.7238307349665924
8865,2014-07-01,03J,1146,505,1651,0.6941247728649304
8866,2014-07-01,03K,1053,314,1367,0.7702999268471105
8867,2014-07-01,03L,1144,1254,2398,0.47706422018348627
8868,2014-07-01,03M,841,471,1312,0.6410060975609756
8869,2014-07-01,03N,3447,1164,4611,0.7475601821730644
8870,2014-07-01,03Q,1976,990,2966,0.6662171274443696
8871,2014-07-01,03R,2503,1341,3844,0.6511446409989594
8872,2014-07-01,03T,1950,785,2735,0.7129798903107861
8873,2014-07-01,03V,450,248,698,0.6446991404011462
8874,2014-07-01,03W,2397,1119,3516,0.681740614334471
8875,2014-07-01,03X,541,273,814,0.6646191646191646
8876,2014-07-01,03Y,799,423,1222,0.6538461538461539
8877,2014-07-01,04C,2053,803,2856,0.7188375350140056
8878,2014-07-01,04D,1487,728,2215,0.6713318284424379
8879,2014-07-01,04E,1230,693,1923,0.6396255850234009
8880,2014-07-01,04F,1574,1032,2606,0.6039907904834996
8881,2014-07-01,04G,4476,2242,6718,0.6662697231318845
8882,2014-07-01,04H,768,392,1160,0.6620689655172414
8883,2014-07-01,04J,2051,1176,3227,0.6355748373101953
8884,2014-07-01,04K,1616,796,2412,0.6699834162520729
8885,2014-07-01,04L,881,422,1303,0.6761320030698388
8886,2014-07-01,04M,491,274,765,0.6418300653594772
8887,2014-07-01,04N,661,341,1002,0.6596806387225549
8888,2014-07-01,04Q,943,379,1322,0.7133131618759455
8889,2014-07-01,04R,2747,1448,4195,0.6548271752085817
8890,2014-07-01,04V,2401,1116,3517,0.6826841057719647
8891,2014-07-01,04X,1370,1074,2444,0.560556464811784
8892,2014-07-01,04Y,1078,433,1511,0.71343481138319
8893,2014-07-01,05A,2638,1505,4143,0.6367366642529568
8894,2014-07-01,05C,1351,1707,3058,0.44179202092871156
8895,2014-07-01,05D,980,420,1400,0.7
8896,2014-07-01,05F,1324,663,1987,0.6663311524911928
8897,2014-07-01,05G,1565,671,2236,0.6999105545617174
8898,2014-07-01,05H,1165,677,1842,0.6324647122692725
8899,2014-07-01,05J,1403,646,2049,0.6847242557345047
8900,2014-07-01,05L,2604,1502,4106,0.634193862640039
8901,2014-07-01,05N,2471,868,3339,0.740041928721174
8902,2014-07-01,05P,1381,832,2213,0.6240397650248531
8903,2014-07-01,05Q,1465,695,2160,0.6782407407407407
8904,2014-07-01,05R,1923,1187,3110,0.6183279742765273
8905,2014-07-01,05T,2146,1093,3239,0.6625501698054955
8906,2014-07-01,05V,1096,518,1614,0.6790582403965304
8907,2014-07-01,05W,1881,756,2637,0.7133105802047781
8908,2014-07-01,05X,1253,428,1681,0.7453896490184414
8909,2014-07-01,05Y,1896,971,2867,0.6613184513428672
8910,2014-07-01,06A,1691,702,2393,0.7066443794400334
8911,2014-07-01,06D,920,392,1312,0.7012195121951219
8912,2014-07-01,06F,1636,2650,4286,0.38170788614092394
8913,2014-07-01,06H,5565,3006,8571,0.6492824641232061
8914,2014-07-01,06K,3308,2392,5700,0.5803508771929825
8915,2014-07-01,06L,2604,1077,3681,0.7074164629176855
8916,2014-07-01,06M,1896,955,2851,0.6650298141003157
8917,2014-07-01,06N,3367,2200,5567,0.6048140829890426
8918,2014-07-01,06P,910,950,1860,0.489247311827957
8919,2014-07-01,06Q,2531,1262,3793,0.6672818349591353
8920,2014-07-01,06T,2445,1265,3710,0.6590296495956873
8921,2014-07-01,06V,1538,559,2097,0.7334287076776347
8922,2014-07-01,06W,1522,529,2051,0.7420770355923939
8923,2014-07-01,06Y,1355,571,1926,0.7035306334371755
8924,2014-07-01,07G,1035,368,1403,0.7377049180327869
8925,2014-07-01,07H,1758,1027,2785,0.6312387791741472
8926,2014-07-01,07J,866,501,1367,0.6335040234089246
8927,2014-07-01,07K,1566,773,2339,0.6695168875587858
8928,2014-07-01,07L,782,351,1133,0.6902030008826125
8929,2014-07-01,07M,1334,850,2184,0.6108058608058609
8930,2014-07-01,07N,1436,693,2129,0.6744950681070925
8931,2014-07-01,07P,949,651,1600,0.593125
8932,2014-07-01,07Q,1745,880,2625,0.6647619047619048
8933,2014-07-01,07R,737,600,1337,0.5512341062079282
8934,2014-07-01,07T,696,560,1256,0.554140127388535
8935,2014-07-01,07V,1775,907,2682,0.6618195376584638
8936,2014-07-01,07W,1249,945,2194,0.5692798541476755
8937,2014-07-01,07X,1239,706,1945,0.6370179948586119
8938,2014-07-01,07Y,915,490,1405,0.6512455516014235
8939,2014-07-01,08A,1233,657,1890,0.6523809523809524
8940,2014-07-01,08C,592,442,1034,0.5725338491295938
8941,2014-07-01,08D,985,578,1563,0.6301983365323096
8942,2014-07-01,08E,858,624,1482,0.5789473684210527
8943,2014-07-01,08F,1500,708,2208,0.6793478260869565
8944,2014-07-01,08G,561,1350,1911,0.29356357927786497
8945,2014-07-01,08H,799,587,1386,0.5764790764790765
8946,2014-07-01,08J,841,413,1254,0.6706539074960127
8947,2014-07-01,08K,1262,635,1897,0.665260938323669
8948,2014-07-01,08L,680,1285,1965,0.3460559796437659
8949,2014-07-01,08M,1068,457,1525,0.700327868852459
8950,2014-07-01,08N,1225,554,1779,0.6885890949971895
8951,2014-07-01,08P,951,525,1476,0.6443089430894309
8952,2014-07-01,08Q,986,455,1441,0.6842470506592644
8953,2014-07-01,08R,865,462,1327,0.651846269781462
8954,2014-07-01,08T,983,520,1503,0.6540252827677977
8955,2014-07-01,08V,962,571,1533,0.6275277234181343
8956,2014-07-01,08W,988,498,1486,0.6648721399730821
8957,2014-07-01,08X,1433,691,2124,0.6746704331450094
8958,2014-07-01,08Y,768,621,1389,0.5529157667386609
8959,2014-07-01,09A,556,517,1073,0.5181733457595527
8960,2014-07-01,09C,830,402,1232,0.6737012987012987
8961,2014-07-01,09D,1554,882,2436,0.6379310344827587
8962,2014-07-01,09E,1595,663,2258,0.7063773250664305
8963,2014-07-01,09F,1429,719,2148,0.6652700186219739
8964,2014-07-01,09G,3766,1899,5665,0.664783759929391
8965,2014-07-01,09H,618,374,992,0.6229838709677419
8966,2014-07-01,09J,1827,1117,2944,0.6205842391304348
8967,2014-07-01,09L,903,494,1397,0.6463851109520401
8968,2014-07-01,09N,1223,660,1883,0.6494954859267127
8969,2014-07-01,09P,1251,823,2074,0.603182256509161
8970,2014-07-01,09W,1405,913,2318,0.6061259706643658
8971,2014-07-01,09X,1133,739,1872,0.6052350427350427
8972,2014-07-01,09Y,1669,1193,2862,0.5831586303284416
8973,2014-07-01,10A,1256,781,2037,0.616593028964163
8974,2014-07-01,10C,554,326,880,0.6295454545454545
8975,2014-07-01,10D,687,282,969,0.7089783281733746
8976,2014-07-01,10E,804,383,1187,0.6773378264532435
8977,2014-07-01,10G,702,359,1061,0.6616399622997172
8978,2014-07-01,10H,2072,1237,3309,0.6261710486551828
8979,2014-07-01,10J,1264,865,2129,0.5937059652418976
8980,2014-07-01,10K,1414,656,2070,0.6830917874396135
8981,2014-07-01,10L,1028,414,1442,0.7128987517337032
8982,2014-07-01,10M,553,456,1009,0.5480673934588701
8983,2014-07-01,10N,485,430,915,0.5300546448087432
8984,2014-07-01,10Q,3496,3107,6603,0.5294563077389065
8985,2014-07-01,10R,1385,457,1842,0.751900108577633
8986,2014-07-01,10T,649,304,953,0.6810073452256034
8987,2014-07-01,10V,1373,735,2108,0.6513282732447818
8988,2014-07-01,10W,616,410,1026,0.6003898635477583
8989,2014-07-01,10X,1232,657,1889,0.652196929592377
8990,2014-07-01,10Y,1351,901,2252,0.599911190053286
8991,2014-07-01,11A,3717,1713,5430,0.6845303867403315
8992,2014-07-01,11C,913,436,1349,0.6767976278724982
8993,2014-07-01,11D,703,575,1278,0.5500782472613458
8994,2014-07-01,11E,1158,829,1987,0.5827881227981883
8995,2014-07-01,11H,2743,1517,4260,0.6438967136150234
8996,2014-07-01,11J,5476,2419,7895,0.6936035465484484
8997,2014-07-01,11M,3919,2009,5928,0.6610998650472335
8998,2014-07-01,11N,4580,1867,6447,0.7104079416783
8999,2014-07-01,11T,1553,894,2447,0.6346546791990192
9000,2014-07-01,11X,3602,1893,5495,0.6555050045495905
9001,2014-07-01,12A,1628,791,2419,0.6730053741215378
9002,2014-07-01,12D,1135,880,2015,0.5632754342431762
9003,2014-07-01,12F,2634,789,3423,0.7695004382120947
9004,2014-07-01,13P,3361,1947,5308,0.6331951770911831
9005,2014-07-01,13T,3400,1599,4999,0.6801360272054411
9006,2014-07-01,14L,3083,1740,4823,0.6392286958324694
9007,2014-07-01,99A,2846,1088,3934,0.7234367056431114
9008,2014-07-01,99C,1791,818,2609,0.6864699118436183
9009,2014-07-01,99D,1101,701,1802,0.6109877913429522
9010,2014-07-01,99E,1600,638,2238,0.7149240393208222
9011,2014-07-01,99F,1124,413,1537,0.7312947299934938
9012,2014-07-01,99G,1222,407,1629,0.7501534683855126
9013,2014-07-01,99H,1759,936,2695,0.6526901669758812
9014,2014-07-01,99J,3149,1742,4891,0.6438356164383562
9015,2014-07-01,99K,1113,700,1813,0.6138996138996139
9016,2014-07-01,99M,1187,867,2054,0.5778967867575463
9017,2014-07-01,99N,3234,2418,5652,0.5721868365180467
9018,2014-07-01,99P,6885,2553,9438,0.7294977749523204
9019,2014-07-01,99Q,2166,941,3107,0.6971355004827808
9020,2014-08-01,00C,703,272,975,0.721025641025641
9021,2014-08-01,00D,2197,1035,3232,0.6797648514851485
9022,2014-08-01,00J,1723,765,2488,0.692524115755627
9023,2014-08-01,00K,2042,1010,3052,0.6690694626474443
9024,2014-08-01,00L,2232,1360,3592,0.621380846325167
9025,2014-08-01,00M,2225,1131,3356,0.6629916567342073
9026,2014-08-01,00N,1093,539,1632,0.6697303921568627
9027,2014-08-01,00P,2101,830,2931,0.716820197884681
9028,2014-08-01,00Q,951,432,1383,0.6876355748373102
9029,2014-08-01,00R,1149,491,1640,0.7006097560975609
9030,2014-08-01,00T,2006,1182,3188,0.6292346298619824
9031,2014-08-01,00V,1340,814,2154,0.6220984215413184
9032,2014-08-01,00W,38,23,61,0.6229508196721312
9033,2014-08-01,00X,1089,303,1392,0.7823275862068966
9034,2014-08-01,00Y,1868,1012,2880,0.6486111111111111
9035,2014-08-01,01A,2388,1417,3805,0.6275952693823916
9036,2014-08-01,01C,1266,672,1938,0.653250773993808
9037,2014-08-01,01D,1431,840,2271,0.6301188903566711
9038,2014-08-01,01E,1038,197,1235,0.8404858299595142
9039,2014-08-01,01F,957,514,1471,0.6505778382053025
9040,2014-08-01,01G,1367,1193,2560,0.533984375
9041,2014-08-01,01H,2549,960,3509,0.7264177828441152
9042,2014-08-01,01J,1044,521,1565,0.6670926517571885
9043,2014-08-01,01K,2106,1245,3351,0.6284691136974038
9044,2014-08-01,01N,11,10,21,0.5238095238095238
9045,2014-08-01,01R,1033,524,1557,0.6634553628773282
9046,2014-08-01,01T,809,411,1220,0.6631147540983606
9047,2014-08-01,01V,878,388,1266,0.693522906793049
9048,2014-08-01,01W,2015,1064,3079,0.654433257551153
9049,2014-08-01,01X,1457,835,2292,0.6356893542757417
9050,2014-08-01,01Y,1085,775,1860,0.5833333333333334
9051,2014-08-01,02A,1261,643,1904,0.6622899159663865
9052,2014-08-01,02D,476,411,887,0.5366403607666291
9053,2014-08-01,02E,1204,534,1738,0.6927502876869965
9054,2014-08-01,02F,1626,622,2248,0.7233096085409253
9055,2014-08-01,02G,638,402,1040,0.6134615384615385
9056,2014-08-01,02H,1469,1409,2878,0.5104239054899236
9057,2014-08-01,02M,1015,391,1406,0.7219061166429588
9058,2014-08-01,02N,998,666,1664,0.5997596153846154
9059,2014-08-01,02P,1125,1317,2442,0.4606879606879607
9060,2014-08-01,02Q,602,479,1081,0.5568917668825162
9061,2014-08-01,02R,2228,1167,3395,0.656259204712813
9062,2014-08-01,02T,1197,745,1942,0.6163748712667353
9063,2014-08-01,02V,1326,746,2072,0.63996138996139
9064,2014-08-01,02W,565,319,884,0.6391402714932126
9065,2014-08-01,02X,1990,940,2930,0.6791808873720137
9066,2014-08-01,02Y,1965,882,2847,0.690200210748156
9067,2014-08-01,03A,1374,724,2098,0.6549094375595805
9068,2014-08-01,03C,1778,1105,2883,0.616718695802983
9069,2014-08-01,03D,908,416,1324,0.6858006042296072
9070,2014-08-01,03E,903,546,1449,0.6231884057971014
9071,2014-08-01,03F,1633,649,2282,0.7156003505696757
9072,2014-08-01,03G,1667,861,2528,0.6594145569620253
9073,2014-08-01,03H,1247,455,1702,0.7326674500587544
9074,2014-08-01,03J,1172,623,1795,0.6529247910863509
9075,2014-08-01,03K,933,304,1237,0.7542441390460792
9076,2014-08-01,03L,1028,1335,2363,0.43504020313161235
9077,2014-08-01,03M,820,424,1244,0.6591639871382636
9078,2014-08-01,03N,3310,1097,4407,0.7510778307238484
9079,2014-08-01,03Q,1869,949,2818,0.663236337828247
9080,2014-08-01,03R,2319,1276,3595,0.6450625869262865
9081,2014-08-01,03T,1799,775,2574,0.6989121989121989
9082,2014-08-01,03V,420,267,687,0.611353711790393
9083,2014-08-01,03W,2312,1069,3381,0.683821354628808
9084,2014-08-01,03X,481,294,775,0.6206451612903225
9085,2014-08-01,03Y,720,374,1094,0.6581352833638026
9086,2014-08-01,04C,2059,782,2841,0.7247448081661387
9087,2014-08-01,04D,1297,705,2002,0.6478521478521478
9088,2014-08-01,04E,1199,744,1943,0.6170869788986104
9089,2014-08-01,04F,1540,955,2495,0.6172344689378757
9090,2014-08-01,04G,4168,2097,6265,0.6652833200319234
9091,2014-08-01,04H,764,368,1132,0.6749116607773852
9092,2014-08-01,04J,1976,1170,3146,0.628099173553719
9093,2014-08-01,04K,1564,784,2348,0.666098807495741
9094,2014-08-01,04L,823,384,1207,0.6818558409279205
9095,2014-08-01,04M,510,310,820,0.6219512195121951
9096,2014-08-01,04N,614,353,967,0.6349534643226473
9097,2014-08-01,04Q,755,351,1106,0.6826401446654611
9098,2014-08-01,04R,2567,1465,4032,0.636656746031746
9099,2014-08-01,04V,2350,1146,3496,0.6721967963386728
9100,2014-08-01,04X,1373,1081,2454,0.5594947025264874
9101,2014-08-01,04Y,1068,404,1472,0.7255434782608695
9102,2014-08-01,05A,2495,1502,3997,0.6242181636227171
9103,2014-08-01,05C,1203,1715,2918,0.41226867717614807
9104,2014-08-01,05D,949,433,1382,0.6866859623733719
9105,2014-08-01,05F,1215,652,1867,0.6507766470273165
9106,2014-08-01,05G,1499,548,2047,0.7322911577918906
9107,2014-08-01,05H,1069,615,1684,0.6347980997624703
9108,2014-08-01,05J,1406,627,2033,0.6915887850467289
9109,2014-08-01,05L,2556,1434,3990,0.6406015037593985
9110,2014-08-01,05N,2303,914,3217,0.7158843643145788
9111,2014-08-01,05P,1279,885,2164,0.5910351201478743
9112,2014-08-01,05Q,1400,683,2083,0.672107537205953
9113,2014-08-01,05R,1759,1179,2938,0.5987066031313819
9114,2014-08-01,05T,2046,1086,3132,0.6532567049808429
9115,2014-08-01,05V,1050,573,1623,0.6469500924214417
9116,2014-08-01,05W,1740,718,2458,0.7078925956061839
9117,2014-08-01,05X,1188,432,1620,0.7333333333333333
9118,2014-08-01,05Y,1788,937,2725,0.6561467889908257
9119,2014-08-01,06A,1605,715,2320,0.6918103448275862
9120,2014-08-01,06D,861,428,1289,0.6679596586501164
9121,2014-08-01,06F,1613,2477,4090,0.3943765281173594
9122,2014-08-01,06H,5288,2822,8110,0.6520345252774352
9123,2014-08-01,06K,3237,2336,5573,0.5808361744123453
9124,2014-08-01,06L,2395,1076,3471,0.690002881014117
9125,2014-08-01,06M,1817,950,2767,0.6566678713408023
9126,2014-08-01,06N,3252,2184,5436,0.5982339955849889
9127,2014-08-01,06P,876,897,1773,0.494077834179357
9128,2014-08-01,06Q,2482,1229,3711,0.6688224198329291
9129,2014-08-01,06T,2290,1203,3493,0.6555969081019182
9130,2014-08-01,06V,1385,572,1957,0.7077158916709249
9131,2014-08-01,06W,1311,481,1792,0.7315848214285714
9132,2014-08-01,06Y,1249,558,1807,0.6912008854454897
9133,2014-08-01,07G,968,358,1326,0.7300150829562594
9134,2014-08-01,07H,1707,1016,2723,0.626882115313992
9135,2014-08-01,07J,806,527,1333,0.6046511627906976
9136,2014-08-01,07K,1479,717,2196,0.6734972677595629
9137,2014-08-01,07L,764,290,1054,0.7248576850094877
9138,2014-08-01,07M,1165,790,1955,0.5959079283887468
9139,2014-08-01,07N,1345,719,2064,0.6516472868217055
9140,2014-08-01,07P,860,569,1429,0.6018194541637508
9141,2014-08-01,07Q,1616,810,2426,0.6661170651277823
9142,2014-08-01,07R,736,515,1251,0.5883293365307753
9143,2014-08-01,07T,630,534,1164,0.5412371134020618
9144,2014-08-01,07V,1611,876,2487,0.6477683956574186
9145,2014-08-01,07W,1116,855,1971,0.5662100456621004
9146,2014-08-01,07X,1171,622,1793,0.6530953708867819
9147,2014-08-01,07Y,855,529,1384,0.6177745664739884
9148,2014-08-01,08A,1022,612,1634,0.6254589963280294
9149,2014-08-01,08C,610,462,1072,0.5690298507462687
9150,2014-08-01,08D,826,497,1323,0.6243386243386243
9151,2014-08-01,08E,825,590,1415,0.5830388692579506
9152,2014-08-01,08F,1476,657,2133,0.6919831223628692
9153,2014-08-01,08G,507,1301,1808,0.28042035398230086
9154,2014-08-01,08H,722,513,1235,0.5846153846153846
9155,2014-08-01,08J,814,413,1227,0.6634066829665851
9156,2014-08-01,08K,1188,568,1756,0.6765375854214123
9157,2014-08-01,08L,642,1279,1921,0.33420093701197295
9158,2014-08-01,08M,1030,469,1499,0.6871247498332221
9159,2014-08-01,08N,1118,518,1636,0.6833740831295844
9160,2014-08-01,08P,866,543,1409,0.6146202980837473
9161,2014-08-01,08Q,903,453,1356,0.665929203539823
9162,2014-08-01,08R,815,420,1235,0.659919028340081
9163,2014-08-01,08T,920,493,1413,0.6510969568294409
9164,2014-08-01,08V,953,557,1510,0.6311258278145695
9165,2014-08-01,08W,938,460,1398,0.670958512160229
9166,2014-08-01,08X,1335,693,2028,0.658284023668639
9167,2014-08-01,08Y,692,554,1246,0.5553772070626003
9168,2014-08-01,09A,558,460,1018,0.5481335952848723
9169,2014-08-01,09C,802,404,1206,0.6650082918739635
9170,2014-08-01,09D,1435,880,2315,0.6198704103671706
9171,2014-08-01,09E,1648,727,2375,0.6938947368421052
9172,2014-08-01,09F,1338,704,2042,0.6552399608227228
9173,2014-08-01,09G,3379,1905,5284,0.6394776684330054
9174,2014-08-01,09H,592,326,918,0.644880174291939
9175,2014-08-01,09J,1705,1035,2740,0.6222627737226277
9176,2014-08-01,09L,895,501,1396,0.6411174785100286
9177,2014-08-01,09N,1194,594,1788,0.6677852348993288
9178,2014-08-01,09P,1257,795,2052,0.6125730994152047
9179,2014-08-01,09W,1389,866,2255,0.6159645232815965
9180,2014-08-01,09X,1097,787,1884,0.582271762208068
9181,2014-08-01,09Y,1654,1157,2811,0.5884027036641765
9182,2014-08-01,10A,1157,798,1955,0.5918158567774936
9183,2014-08-01,10C,515,292,807,0.6381660470879802
9184,2014-08-01,10D,671,256,927,0.7238403451995685
9185,2014-08-01,10E,824,351,1175,0.7012765957446808
9186,2014-08-01,10G,679,372,1051,0.6460513796384396
9187,2014-08-01,10H,1917,1201,3118,0.6148171905067351
9188,2014-08-01,10J,1144,839,1983,0.5769036812909732
9189,2014-08-01,10K,1283,642,1925,0.6664935064935065
9190,2014-08-01,10L,1006,399,1405,0.7160142348754448
9191,2014-08-01,10M,472,440,912,0.5175438596491229
9192,2014-08-01,10N,454,405,859,0.5285215366705471
9193,2014-08-01,10Q,3365,3026,6391,0.5265216710999844
9194,2014-08-01,10R,1292,524,1816,0.711453744493392
9195,2014-08-01,10T,640,340,980,0.6530612244897959
9196,2014-08-01,10V,1292,720,2012,0.6421471172962226
9197,2014-08-01,10W,628,438,1066,0.5891181988742964
9198,2014-08-01,10X,1127,638,1765,0.6385269121813031
9199,2014-08-01,10Y,1331,772,2103,0.6329053732762719
9200,2014-08-01,11A,3582,1679,5261,0.6808591522524234
9201,2014-08-01,11C,833,429,1262,0.6600633914421553
9202,2014-08-01,11D,693,614,1307,0.5302218821729151
9203,2014-08-01,11E,1194,848,2042,0.584720861900098
9204,2014-08-01,11H,2625,1389,4014,0.6539611360239163
9205,2014-08-01,11J,5156,2419,7575,0.6806600660066007
9206,2014-08-01,11M,3809,1984,5793,0.6575176937683411
9207,2014-08-01,11N,4381,1815,6196,0.7070690768237573
9208,2014-08-01,11T,1522,849,2371,0.6419232391396036
9209,2014-08-01,11X,3365,1917,5282,0.6370692919348732
9210,2014-08-01,12A,1534,673,2207,0.6950611690077028
9211,2014-08-01,12D,1091,889,1980,0.5510101010101011
9212,2014-08-01,12F,2322,699,3021,0.7686196623634558
9213,2014-08-01,13P,3118,1995,5113,0.6098181106982202
9214,2014-08-01,13T,3068,1424,4492,0.6829919857524488
9215,2014-08-01,14L,2957,1714,4671,0.6330550203382573
9216,2014-08-01,99A,2598,1074,3672,0.7075163398692811
9217,2014-08-01,99C,1614,834,2448,0.6593137254901961
9218,2014-08-01,99D,1104,742,1846,0.5980498374864572
9219,2014-08-01,99E,1539,605,2144,0.7178171641791045
9220,2014-08-01,99F,1175,436,1611,0.7293606455617628
9221,2014-08-01,99G,1231,400,1631,0.7547516860821581
9222,2014-08-01,99H,1684,917,2601,0.647443291041907
9223,2014-08-01,99J,2870,1678,4548,0.6310466138962181
9224,2014-08-01,99K,1092,602,1694,0.6446280991735537
9225,2014-08-01,99M,1093,820,1913,0.571353894406691
9226,2014-08-01,99N,2913,2311,5224,0.5576186830015314
9227,2014-08-01,99P,6545,2495,9040,0.724004424778761
9228,2014-08-01,99Q,2047,856,2903,0.7051326214261109
9229,2014-09-01,00C,782,336,1118,0.6994633273703041
9230,2014-09-01,00D,2468,1065,3533,0.6985564675912822
9231,2014-09-01,00J,1845,785,2630,0.7015209125475285
9232,2014-09-01,00K,2275,984,3259,0.6980668916845658
9233,2014-09-01,00L,2426,1418,3844,0.6311134235171696
9234,2014-09-01,00M,2551,1132,3683,0.6926418680423567
9235,2014-09-01,00N,1300,559,1859,0.6993006993006993
9236,2014-09-01,00P,2199,749,2948,0.7459294436906377
9237,2014-09-01,00Q,1008,436,1444,0.6980609418282548
9238,2014-09-01,00R,1161,533,1694,0.6853600944510035
9239,2014-09-01,00T,2065,1213,3278,0.6299572910311165
9240,2014-09-01,00V,1418,866,2284,0.6208406304728546
9241,2014-09-01,00W,37,22,59,0.6271186440677966
9242,2014-09-01,00X,1076,333,1409,0.7636621717530163
9243,2014-09-01,00Y,1874,1053,2927,0.640245985650837
9244,2014-09-01,01A,2620,1371,3991,0.6564770734151841
9245,2014-09-01,01C,1240,640,1880,0.6595744680851063
9246,2014-09-01,01D,1568,915,2483,0.6314941602899719
9247,2014-09-01,01E,1075,177,1252,0.8586261980830671
9248,2014-09-01,01F,1089,487,1576,0.690989847715736
9249,2014-09-01,01G,1417,1273,2690,0.5267657992565056
9250,2014-09-01,01H,2595,964,3559,0.7291373981455465
9251,2014-09-01,01J,1100,581,1681,0.6543723973825104
9252,2014-09-01,01K,2156,1244,3400,0.6341176470588236
9253,2014-09-01,01N,22,14,36,0.6111111111111112
9254,2014-09-01,01R,1073,588,1661,0.645996387718242
9255,2014-09-01,01T,855,436,1291,0.6622773044151821
9256,2014-09-01,01V,928,382,1310,0.7083969465648855
9257,2014-09-01,01W,2224,1076,3300,0.673939393939394
9258,2014-09-01,01X,1474,744,2218,0.6645626690712354
9259,2014-09-01,01Y,1095,840,1935,0.5658914728682171
9260,2014-09-01,02A,1252,638,1890,0.6624338624338625
9261,2014-09-01,02D,582,411,993,0.5861027190332326
9262,2014-09-01,02E,1400,569,1969,0.7110208227526663
9263,2014-09-01,02F,1712,658,2370,0.7223628691983123
9264,2014-09-01,02G,642,416,1058,0.6068052930056711
9265,2014-09-01,02H,1673,1546,3219,0.519726623174899
9266,2014-09-01,02M,1119,402,1521,0.7357001972386588
9267,2014-09-01,02N,1118,741,1859,0.6013986013986014
9268,2014-09-01,02P,1177,1442,2619,0.44940817105765557
9269,2014-09-01,02Q,667,483,1150,0.58
9270,2014-09-01,02R,2437,1190,3627,0.6719051557761235
9271,2014-09-01,02T,1323,775,2098,0.6306005719733079
9272,2014-09-01,02V,1351,775,2126,0.6354656632173095
9273,2014-09-01,02W,693,380,1073,0.6458527493010252
9274,2014-09-01,02X,2052,944,2996,0.684913217623498
9275,2014-09-01,02Y,2230,929,3159,0.7059195948084837
9276,2014-09-01,03A,1482,750,2232,0.6639784946236559
9277,2014-09-01,03C,2110,1243,3353,0.6292872054876231
9278,2014-09-01,03D,974,467,1441,0.6759195003469812
9279,2014-09-01,03E,1031,541,1572,0.655852417302799
9280,2014-09-01,03F,1798,695,2493,0.7212194143602085
9281,2014-09-01,03G,1722,937,2659,0.6476118841669801
9282,2014-09-01,03H,1300,486,1786,0.7278835386338186
9283,2014-09-01,03J,1294,551,1845,0.7013550135501355
9284,2014-09-01,03K,1086,327,1413,0.7685774946921444
9285,2014-09-01,03L,1189,1268,2457,0.48392348392348394
9286,2014-09-01,03M,944,457,1401,0.6738044254104212
9287,2014-09-01,03N,3527,1117,4644,0.7594745908699397
9288,2014-09-01,03Q,2065,994,3059,0.6750572082379863
9289,2014-09-01,03R,2471,1373,3844,0.6428199791883454
9290,2014-09-01,03T,1797,801,2598,0.6916859122401847
9291,2014-09-01,03V,462,267,729,0.6337448559670782
9292,2014-09-01,03W,2476,1116,3592,0.6893095768374164
9293,2014-09-01,03X,542,292,834,0.6498800959232613
9294,2014-09-01,03Y,758,380,1138,0.6660808435852372
9295,2014-09-01,04C,2252,851,3103,0.7257492748952626
9296,2014-09-01,04D,1407,782,2189,0.6427592507994518
9297,2014-09-01,04E,1290,656,1946,0.6628982528263104
9298,2014-09-01,04F,1688,1031,2719,0.6208164766458256
9299,2014-09-01,04G,4492,2246,6738,0.6666666666666666
9300,2014-09-01,04H,765,386,1151,0.6646394439617723
9301,2014-09-01,04J,2106,1195,3301,0.6379884883368676
9302,2014-09-01,04K,1633,898,2531,0.6451995258790991
9303,2014-09-01,04L,949,436,1385,0.6851985559566787
9304,2014-09-01,04M,496,297,793,0.6254728877679697
9305,2014-09-01,04N,727,358,1085,0.6700460829493088
9306,2014-09-01,04Q,871,354,1225,0.7110204081632653
9307,2014-09-01,04R,2743,1585,4328,0.6337800369685767
9308,2014-09-01,04V,2447,1157,3604,0.6789678135405105
9309,2014-09-01,04X,1428,1071,2499,0.5714285714285714
9310,2014-09-01,04Y,1099,443,1542,0.7127107652399481
9311,2014-09-01,05A,2807,1590,4397,0.6383898112349329
9312,2014-09-01,05C,1358,1853,3211,0.4229212083463096
9313,2014-09-01,05D,1078,494,1572,0.6857506361323156
9314,2014-09-01,05F,1330,677,2007,0.6626806178375685
9315,2014-09-01,05G,1575,628,2203,0.7149341806627326
9316,2014-09-01,05H,1188,645,1833,0.6481178396072013
9317,2014-09-01,05J,1513,637,2150,0.7037209302325581
9318,2014-09-01,05L,2661,1520,4181,0.6364506099019374
9319,2014-09-01,05N,2419,949,3368,0.7182304038004751
9320,2014-09-01,05P,1290,905,2195,0.5876993166287016
9321,2014-09-01,05Q,1557,679,2236,0.6963327370304114
9322,2014-09-01,05R,1923,1256,3179,0.6049072035231204
9323,2014-09-01,05T,2184,1150,3334,0.6550689862027594
9324,2014-09-01,05V,1086,548,1634,0.6646266829865362
9325,2014-09-01,05W,1828,742,2570,0.711284046692607
9326,2014-09-01,05X,1244,446,1690,0.736094674556213
9327,2014-09-01,05Y,2043,1078,3121,0.6545978852931753
9328,2014-09-01,06A,1732,750,2482,0.6978243352135375
9329,2014-09-01,06D,926,414,1340,0.691044776119403
9330,2014-09-01,06F,1672,2530,4202,0.39790575916230364
9331,2014-09-01,06H,5450,3028,8478,0.6428402925218212
9332,2014-09-01,06K,3652,2484,6136,0.5951760104302477
9333,2014-09-01,06L,2683,1084,3767,0.7122378550570746
9334,2014-09-01,06M,2057,945,3002,0.6852098600932711
9335,2014-09-01,06N,3499,2264,5763,0.6071490543119903
9336,2014-09-01,06P,988,1079,2067,0.4779874213836478
9337,2014-09-01,06Q,2693,1308,4001,0.6730817295676081
9338,2014-09-01,06T,2391,1249,3640,0.6568681318681319
9339,2014-09-01,06V,1497,615,2112,0.7088068181818182
9340,2014-09-01,06W,1479,593,2072,0.7138030888030888
9341,2014-09-01,06Y,1372,608,1980,0.692929292929293
9342,2014-09-01,07G,1038,336,1374,0.7554585152838428
9343,2014-09-01,07H,1813,1062,2875,0.6306086956521739
9344,2014-09-01,07J,838,567,1405,0.59644128113879
9345,2014-09-01,07K,1574,728,2302,0.68375325803649
9346,2014-09-01,07L,860,354,1214,0.7084019769357496
9347,2014-09-01,07M,1290,884,2174,0.593376264949402
9348,2014-09-01,07N,1448,733,2181,0.6639156350298029
9349,2014-09-01,07P,968,687,1655,0.5848942598187311
9350,2014-09-01,07Q,1782,948,2730,0.6527472527472528
9351,2014-09-01,07R,833,651,1484,0.5613207547169812
9352,2014-09-01,07T,734,591,1325,0.5539622641509434
9353,2014-09-01,07V,1887,892,2779,0.6790212306585103
9354,2014-09-01,07W,1370,948,2318,0.5910267471958585
9355,2014-09-01,07X,1349,676,2025,0.6661728395061728
9356,2014-09-01,07Y,952,553,1505,0.6325581395348837
9357,2014-09-01,08A,1232,702,1934,0.6370217166494312
9358,2014-09-01,08C,692,490,1182,0.5854483925549916
9359,2014-09-01,08D,999,587,1586,0.6298865069356873
9360,2014-09-01,08E,936,545,1481,0.6320054017555705
9361,2014-09-01,08F,1631,760,2391,0.6821413634462568
9362,2014-09-01,08G,545,1399,1944,0.2803497942386831
9363,2014-09-01,08H,851,573,1424,0.5976123595505618
9364,2014-09-01,08J,907,444,1351,0.6713545521835678
9365,2014-09-01,08K,1284,598,1882,0.6822529224229543
9366,2014-09-01,08L,648,1350,1998,0.32432432432432434
9367,2014-09-01,08M,1157,493,1650,0.7012121212121212
9368,2014-09-01,08N,1358,575,1933,0.702534919813761
9369,2014-09-01,08P,967,624,1591,0.6077938403519799
9370,2014-09-01,08Q,1091,467,1558,0.7002567394094994
9371,2014-09-01,08R,917,430,1347,0.6807720861172977
9372,2014-09-01,08T,1087,531,1618,0.6718170580964153
9373,2014-09-01,08V,1056,630,1686,0.6263345195729537
9374,2014-09-01,08W,1109,539,1648,0.6729368932038835
9375,2014-09-01,08X,1378,706,2084,0.6612284069097889
9376,2014-09-01,08Y,702,602,1304,0.5383435582822086
9377,2014-09-01,09A,602,540,1142,0.5271453590192644
9378,2014-09-01,09C,820,444,1264,0.6487341772151899
9379,2014-09-01,09D,1580,890,2470,0.6396761133603239
9380,2014-09-01,09E,1618,645,2263,0.7149801148917366
9381,2014-09-01,09F,1428,670,2098,0.680648236415634
9382,2014-09-01,09G,3767,1969,5736,0.6567294281729428
9383,2014-09-01,09H,620,351,971,0.6385169927909372
9384,2014-09-01,09J,1707,995,2702,0.6317542561065878
9385,2014-09-01,09L,902,545,1447,0.6233586731167934
9386,2014-09-01,09N,1207,686,1893,0.6376122556788167
9387,2014-09-01,09P,1254,840,2094,0.5988538681948424
9388,2014-09-01,09W,1470,857,2327,0.6317146540610228
9389,2014-09-01,09X,1156,770,1926,0.6002076843198338
9390,2014-09-01,09Y,1707,1133,2840,0.601056338028169
9391,2014-09-01,10A,1220,816,2036,0.5992141453831041
9392,2014-09-01,10C,515,289,804,0.6405472636815921
9393,2014-09-01,10D,687,279,966,0.7111801242236024
9394,2014-09-01,10E,910,446,1356,0.6710914454277286
9395,2014-09-01,10G,674,421,1095,0.6155251141552511
9396,2014-09-01,10H,2008,1284,3292,0.6099635479951397
9397,2014-09-01,10J,1178,979,2157,0.5461288827074641
9398,2014-09-01,10K,1435,693,2128,0.6743421052631579
9399,2014-09-01,10L,1064,381,1445,0.7363321799307958
9400,2014-09-01,10M,579,457,1036,0.5588803088803089
9401,2014-09-01,10N,469,458,927,0.505933117583603
9402,2014-09-01,10Q,3581,3138,6719,0.5329662152105968
9403,2014-09-01,10R,1422,539,1961,0.7251402345741969
9404,2014-09-01,10T,649,347,996,0.6516064257028112
9405,2014-09-01,10V,1432,703,2135,0.6707259953161593
9406,2014-09-01,10W,602,406,1008,0.5972222222222222
9407,2014-09-01,10X,1222,648,1870,0.653475935828877
9408,2014-09-01,10Y,1451,892,2343,0.6192915066154503
9409,2014-09-01,11A,3750,1822,5572,0.673007896625987
9410,2014-09-01,11C,936,420,1356,0.6902654867256637
9411,2014-09-01,11D,692,616,1308,0.5290519877675841
9412,2014-09-01,11E,1195,915,2110,0.566350710900474
9413,2014-09-01,11H,2789,1474,4263,0.6542341074360779
9414,2014-09-01,11J,5635,2586,8221,0.6854397275270648
9415,2014-09-01,11M,3964,2118,6082,0.6517592897073331
9416,2014-09-01,11N,4568,1906,6474,0.7055915971578622
9417,2014-09-01,11T,1563,949,2512,0.6222133757961783
9418,2014-09-01,11X,3737,1977,5714,0.6540077003850192
9419,2014-09-01,12A,1657,832,2489,0.6657292085174769
9420,2014-09-01,12D,1249,995,2244,0.5565953654188949
9421,2014-09-01,12F,2608,804,3412,0.7643610785463072
9422,2014-09-01,13P,3391,2183,5574,0.6083602439899534
9423,2014-09-01,13T,3370,1620,4990,0.6753507014028056
9424,2014-09-01,14L,3371,1909,5280,0.6384469696969697
9425,2014-09-01,99A,3052,1137,4189,0.7285748388636906
9426,2014-09-01,99C,1665,840,2505,0.6646706586826348
9427,2014-09-01,99D,1092,724,1816,0.6013215859030837
9428,2014-09-01,99E,1614,664,2278,0.7085162423178226
9429,2014-09-01,99F,1242,386,1628,0.7628992628992629
9430,2014-09-01,99G,1214,397,1611,0.7535692116697703
9431,2014-09-01,99H,1785,988,2773,0.6437071763433105
9432,2014-09-01,99J,3159,1758,4917,0.6424649176327029
9433,2014-09-01,99K,1091,667,1758,0.6205915813424346
9434,2014-09-01,99M,1198,796,1994,0.600802407221665
9435,2014-09-01,99N,3201,2496,5697,0.5618746708794102
9436,2014-09-01,99P,6810,2530,9340,0.7291220556745182
9437,2014-09-01,99Q,2105,885,2990,0.7040133779264214
9438,2014-10-01,00C,793,298,1091,0.7268560953253895
9439,2014-10-01,00D,2548,1132,3680,0.6923913043478261
9440,2014-10-01,00J,1912,860,2772,0.6897546897546898
9441,2014-10-01,00K,2429,1099,3528,0.6884920634920635
9442,2014-10-01,00L,2504,1464,3968,0.6310483870967742
9443,2014-10-01,00M,2599,1102,3701,0.7022426371251014
9444,2014-10-01,00N,1310,617,1927,0.6798131811105345
9445,2014-10-01,00P,2298,904,3202,0.7176764522173642
9446,2014-10-01,00Q,1022,442,1464,0.6980874316939891
9447,2014-10-01,00R,1198,665,1863,0.6430488459473966
9448,2014-10-01,00T,2112,1222,3334,0.6334733053389322
9449,2014-10-01,00V,1443,934,2377,0.6070677324358436
9450,2014-10-01,00W,19,14,33,0.5757575757575758
9451,2014-10-01,00X,1163,336,1499,0.7758505670446965
9452,2014-10-01,00Y,1894,1087,2981,0.6353572626635358
9453,2014-10-01,01A,2718,1535,4253,0.6390782976722313
9454,2014-10-01,01C,1303,682,1985,0.6564231738035264
9455,2014-10-01,01D,1680,978,2658,0.6320541760722348
9456,2014-10-01,01E,1110,183,1293,0.8584686774941995
9457,2014-10-01,01F,1074,499,1573,0.6827717736808646
9458,2014-10-01,01G,1430,1330,2760,0.5181159420289855
9459,2014-10-01,01H,2708,976,3684,0.7350705754614549
9460,2014-10-01,01J,1161,491,1652,0.7027845036319612
9461,2014-10-01,01K,2225,1282,3507,0.6344453949244369
9462,2014-10-01,01N,19,17,36,0.5277777777777778
9463,2014-10-01,01R,1122,612,1734,0.6470588235294118
9464,2014-10-01,01T,878,432,1310,0.6702290076335878
9465,2014-10-01,01V,986,444,1430,0.6895104895104895
9466,2014-10-01,01W,2362,1092,3454,0.6838448176027794
9467,2014-10-01,01X,1502,808,2310,0.6502164502164502
9468,2014-10-01,01Y,1130,782,1912,0.5910041841004184
9469,2014-10-01,02A,1292,723,2015,0.6411910669975186
9470,2014-10-01,02D,499,461,960,0.5197916666666667
9471,2014-10-01,02E,1352,509,1861,0.7264911337990327
9472,2014-10-01,02F,1826,640,2466,0.740470397404704
9473,2014-10-01,02G,750,391,1141,0.6573181419807187
9474,2014-10-01,02H,1727,1681,3408,0.5067488262910798
9475,2014-10-01,02M,1172,448,1620,0.7234567901234568
9476,2014-10-01,02N,1115,719,1834,0.6079607415485279
9477,2014-10-01,02P,1171,1463,2634,0.4445709946848899
9478,2014-10-01,02Q,667,466,1133,0.588702559576346
9479,2014-10-01,02R,2354,1377,3731,0.6309300455641919
9480,2014-10-01,02T,1424,826,2250,0.6328888888888888
9481,2014-10-01,02V,1381,718,2099,0.6579323487374941
9482,2014-10-01,02W,581,360,941,0.6174282678002125
9483,2014-10-01,02X,2166,960,3126,0.6928982725527831
9484,2014-10-01,02Y,2140,928,3068,0.6975228161668839
9485,2014-10-01,03A,1519,753,2272,0.6685739436619719
9486,2014-10-01,03C,2114,1391,3505,0.6031383737517831
9487,2014-10-01,03D,984,403,1387,0.7094448449891853
9488,2014-10-01,03E,1007,551,1558,0.6463414634146342
9489,2014-10-01,03F,1880,663,2543,0.739284309870232
9490,2014-10-01,03G,1792,1043,2835,0.6320987654320988
9491,2014-10-01,03H,1405,503,1908,0.7363731656184487
9492,2014-10-01,03J,1264,586,1850,0.6832432432432433
9493,2014-10-01,03K,1061,379,1440,0.7368055555555556
9494,2014-10-01,03L,1140,1294,2434,0.4683648315529992
9495,2014-10-01,03M,920,441,1361,0.6759735488611315
9496,2014-10-01,03N,3528,1217,4745,0.7435194942044258
9497,2014-10-01,03Q,2205,1017,3222,0.6843575418994413
9498,2014-10-01,03R,2584,1357,3941,0.6556711494544532
9499,2014-10-01,03T,1946,860,2806,0.6935138987883107
9500,2014-10-01,03V,499,258,757,0.6591809775429326
9501,2014-10-01,03W,2413,1138,3551,0.6795268938327231
9502,2014-10-01,03X,524,315,839,0.6245530393325387
9503,2014-10-01,03Y,817,413,1230,0.6642276422764227
9504,2014-10-01,04C,2372,789,3161,0.750395444479595
9505,2014-10-01,04D,1536,834,2370,0.6481012658227848
9506,2014-10-01,04E,1309,750,2059,0.6357455075279261
9507,2014-10-01,04F,1683,1047,2730,0.6164835164835165
9508,2014-10-01,04G,4560,2383,6943,0.6567766095347832
9509,2014-10-01,04H,807,409,1216,0.6636513157894737
9510,2014-10-01,04J,2145,1261,3406,0.6297709923664122
9511,2014-10-01,04K,1744,1004,2748,0.6346433770014556
9512,2014-10-01,04L,953,443,1396,0.6826647564469914
9513,2014-10-01,04M,515,322,837,0.6152927120669056
9514,2014-10-01,04N,690,332,1022,0.675146771037182
9515,2014-10-01,04Q,980,408,1388,0.7060518731988472
9516,2014-10-01,04R,2851,1700,4551,0.6264557240166996
9517,2014-10-01,04V,2658,1181,3839,0.6923678041156551
9518,2014-10-01,04X,1531,1169,2700,0.567037037037037
9519,2014-10-01,04Y,1104,438,1542,0.7159533073929961
9520,2014-10-01,05A,2945,1603,4548,0.6475373790677221
9521,2014-10-01,05C,1402,1938,3340,0.41976047904191616
9522,2014-10-01,05D,1091,458,1549,0.7043253712072305
9523,2014-10-01,05F,1343,679,2022,0.6641938674579624
9524,2014-10-01,05G,1667,686,2353,0.7084572885677858
9525,2014-10-01,05H,1233,665,1898,0.6496311907270811
9526,2014-10-01,05J,1538,728,2266,0.678729037952339
9527,2014-10-01,05L,2730,1518,4248,0.6426553672316384
9528,2014-10-01,05N,2355,968,3323,0.7086969605777912
9529,2014-10-01,05P,1474,912,2386,0.6177703269069572
9530,2014-10-01,05Q,1440,730,2170,0.663594470046083
9531,2014-10-01,05R,1919,1252,3171,0.6051718700725324
9532,2014-10-01,05T,2131,1163,3294,0.6469338190649666
9533,2014-10-01,05V,1201,533,1734,0.6926182237600923
9534,2014-10-01,05W,1979,837,2816,0.7027698863636364
9535,2014-10-01,05X,1255,473,1728,0.7262731481481481
9536,2014-10-01,05Y,2064,1094,3158,0.6535782140595313
9537,2014-10-01,06A,1760,754,2514,0.700079554494829
9538,2014-10-01,06D,988,476,1464,0.674863387978142
9539,2014-10-01,06F,1767,2599,4366,0.4047182775996335
9540,2014-10-01,06H,5730,3074,8804,0.6508405270331667
9541,2014-10-01,06K,3676,2565,6241,0.589008171767345
9542,2014-10-01,06L,2746,1099,3845,0.7141742522756827
9543,2014-10-01,06M,2127,997,3124,0.6808578745198464
9544,2014-10-01,06N,3599,2372,5971,0.6027466086082733
9545,2014-10-01,06P,915,1115,2030,0.45073891625615764
9546,2014-10-01,06Q,2686,1321,4007,0.6703269278762166
9547,2014-10-01,06T,2483,1337,3820,0.65
9548,2014-10-01,06V,1545,625,2170,0.7119815668202765
9549,2014-10-01,06W,1500,534,2034,0.7374631268436578
9550,2014-10-01,06Y,1436,653,2089,0.6874102441359502
9551,2014-10-01,07G,1002,366,1368,0.7324561403508771
9552,2014-10-01,07H,1752,1099,2851,0.6145212206243423
9553,2014-10-01,07J,915,582,1497,0.6112224448897795
9554,2014-10-01,07K,1709,740,2449,0.6978358513679053
9555,2014-10-01,07L,877,347,1224,0.7165032679738562
9556,2014-10-01,07M,1433,933,2366,0.6056635672020287
9557,2014-10-01,07N,1445,706,2151,0.6717805671780567
9558,2014-10-01,07P,981,673,1654,0.5931076178960096
9559,2014-10-01,07Q,1838,909,2747,0.6690935566072078
9560,2014-10-01,07R,822,649,1471,0.5588035350101972
9561,2014-10-01,07T,776,637,1413,0.5491861288039632
9562,2014-10-01,07V,1835,923,2758,0.6653372008701958
9563,2014-10-01,07W,1264,894,2158,0.5857275254865616
9564,2014-10-01,07X,1431,775,2206,0.6486854034451496
9565,2014-10-01,07Y,983,600,1583,0.6209728363866077
9566,2014-10-01,08A,1236,746,1982,0.6236125126135217
9567,2014-10-01,08C,679,510,1189,0.5710681244743482
9568,2014-10-01,08D,1018,614,1632,0.6237745098039216
9569,2014-10-01,08E,938,598,1536,0.6106770833333334
9570,2014-10-01,08F,1582,728,2310,0.6848484848484848
9571,2014-10-01,08G,564,1388,1952,0.2889344262295082
9572,2014-10-01,08H,839,592,1431,0.5863032844164919
9573,2014-10-01,08J,947,446,1393,0.6798277099784638
9574,2014-10-01,08K,1380,617,1997,0.6910365548322484
9575,2014-10-01,08L,741,1334,2075,0.3571084337349398
9576,2014-10-01,08M,1182,518,1700,0.6952941176470588
9577,2014-10-01,08N,1324,563,1887,0.7016428192898782
9578,2014-10-01,08P,987,612,1599,0.6172607879924953
9579,2014-10-01,08Q,1051,471,1522,0.69053876478318
9580,2014-10-01,08R,907,407,1314,0.6902587519025876
9581,2014-10-01,08T,1104,546,1650,0.6690909090909091
9582,2014-10-01,08V,1132,593,1725,0.6562318840579711
9583,2014-10-01,08W,1137,502,1639,0.6937156802928615
9584,2014-10-01,08X,1498,737,2235,0.6702460850111857
9585,2014-10-01,08Y,761,653,1414,0.5381895332390382
9586,2014-10-01,09A,665,606,1271,0.5232100708103855
9587,2014-10-01,09C,824,493,1317,0.6256643887623387
9588,2014-10-01,09D,1582,1042,2624,0.6028963414634146
9589,2014-10-01,09E,1752,762,2514,0.6968973747016707
9590,2014-10-01,09F,1494,761,2255,0.6625277161862527
9591,2014-10-01,09G,3992,2101,6093,0.6551780731987527
9592,2014-10-01,09H,735,348,1083,0.6786703601108033
9593,2014-10-01,09J,1822,1115,2937,0.620360912495744
9594,2014-10-01,09L,945,547,1492,0.6333780160857909
9595,2014-10-01,09N,1208,703,1911,0.6321297749869178
9596,2014-10-01,09P,1317,855,2172,0.606353591160221
9597,2014-10-01,09W,1431,932,2363,0.6055861193398223
9598,2014-10-01,09X,1177,847,2024,0.5815217391304348
9599,2014-10-01,09Y,1775,1169,2944,0.602921195652174
9600,2014-10-01,10A,1236,821,2057,0.6008750607681089
9601,2014-10-01,10C,590,304,894,0.6599552572706935
9602,2014-10-01,10D,731,318,1049,0.6968541468064824
9603,2014-10-01,10E,941,404,1345,0.6996282527881041
9604,2014-10-01,10G,827,430,1257,0.6579156722354813
9605,2014-10-01,10H,2150,1353,3503,0.6137596345989152
9606,2014-10-01,10J,1239,951,2190,0.5657534246575342
9607,2014-10-01,10K,1440,672,2112,0.6818181818181818
9608,2014-10-01,10L,1082,417,1499,0.7218145430286858
9609,2014-10-01,10M,578,491,1069,0.5406922357343311
9610,2014-10-01,10N,512,442,954,0.5366876310272537
9611,2014-10-01,10Q,3655,3273,6928,0.5275692840646651
9612,2014-10-01,10R,1523,548,2071,0.7353935296957992
9613,2014-10-01,10T,652,361,1013,0.6436327739387957
9614,2014-10-01,10V,1467,779,2246,0.6531611754229741
9615,2014-10-01,10W,671,458,1129,0.5943312666076174
9616,2014-10-01,10X,1323,728,2051,0.6450511945392492
9617,2014-10-01,10Y,1443,1000,2443,0.5906672124437168
9618,2014-10-01,11A,3847,1905,5752,0.6688108484005564
9619,2014-10-01,11C,990,436,1426,0.6942496493688639
9620,2014-10-01,11D,717,645,1362,0.526431718061674
9621,2014-10-01,11E,1191,944,2135,0.5578454332552694
9622,2014-10-01,11H,2939,1547,4486,0.6551493535443602
9623,2014-10-01,11J,5958,2590,8548,0.6970051474029013
9624,2014-10-01,11M,4337,2154,6491,0.6681559081805577
9625,2014-10-01,11N,4600,1907,6507,0.7069309973874289
9626,2014-10-01,11T,1636,944,2580,0.6341085271317829
9627,2014-10-01,11X,3646,2028,5674,0.6425801903419105
9628,2014-10-01,12A,1749,799,2548,0.6864207221350078
9629,2014-10-01,12D,1302,996,2298,0.566579634464752
9630,2014-10-01,12F,2623,771,3394,0.7728344136711844
9631,2014-10-01,13P,3460,2214,5674,0.6097990835389496
9632,2014-10-01,13T,3503,1693,5196,0.6741724403387221
9633,2014-10-01,14L,3513,1794,5307,0.6619559072922555
9634,2014-10-01,99A,3070,1206,4276,0.7179607109448082
9635,2014-10-01,99C,1706,872,2578,0.6617532971295578
9636,2014-10-01,99D,1130,836,1966,0.5747711088504578
9637,2014-10-01,99E,1817,671,2488,0.7303054662379421
9638,2014-10-01,99F,1240,463,1703,0.728126834997064
9639,2014-10-01,99G,1267,410,1677,0.75551580202743
9640,2014-10-01,99H,1830,1022,2852,0.6416549789621319
9641,2014-10-01,99J,3190,1775,4965,0.6424974823766365
9642,2014-10-01,99K,1161,716,1877,0.6185402237613212
9643,2014-10-01,99M,1177,857,2034,0.5786627335299902
9644,2014-10-01,99N,3310,2417,5727,0.5779640300331762
9645,2014-10-01,99P,7236,2675,9911,0.730097871052366
9646,2014-10-01,99Q,2146,964,3110,0.690032154340836
9647,2014-11-01,00C,713,291,1004,0.7101593625498008
9648,2014-11-01,00D,2309,1056,3365,0.6861812778603269
9649,2014-11-01,00J,1754,765,2519,0.6963080587534736
9650,2014-11-01,00K,2123,998,3121,0.6802306952899712
9651,2014-11-01,00L,2216,1274,3490,0.6349570200573066
9652,2014-11-01,00M,2274,1059,3333,0.6822682268226823
9653,2014-11-01,00N,1088,548,1636,0.6650366748166259
9654,2014-11-01,00P,2048,779,2827,0.7244428723027945
9655,2014-11-01,00Q,931,389,1320,0.7053030303030303
9656,2014-11-01,00R,1100,608,1708,0.6440281030444965
9657,2014-11-01,00T,1959,1064,3023,0.6480317565332451
9658,2014-11-01,00V,1378,818,2196,0.6275045537340619
9659,2014-11-01,00W,17,10,27,0.6296296296296297
9660,2014-11-01,00X,1033,257,1290,0.8007751937984496
9661,2014-11-01,00Y,1700,965,2665,0.6378986866791745
9662,2014-11-01,01A,2387,1325,3712,0.6430495689655172
9663,2014-11-01,01C,1099,577,1676,0.655727923627685
9664,2014-11-01,01D,1543,783,2326,0.6633705932932072
9665,2014-11-01,01E,1014,224,1238,0.8190630048465266
9666,2014-11-01,01F,968,414,1382,0.7004341534008683
9667,2014-11-01,01G,1187,1242,2429,0.48867846850555785
9668,2014-11-01,01H,2376,895,3271,0.7263833690003058
9669,2014-11-01,01J,1040,480,1520,0.6842105263157895
9670,2014-11-01,01K,2028,1125,3153,0.6431969552806851
9671,2014-11-01,01N,21,13,34,0.6176470588235294
9672,2014-11-01,01R,965,543,1508,0.639920424403183
9673,2014-11-01,01T,816,398,1214,0.6721581548599671
9674,2014-11-01,01V,865,431,1296,0.6674382716049383
9675,2014-11-01,01W,2083,1039,3122,0.6672005124919923
9676,2014-11-01,01X,1555,706,2261,0.6877487837240159
9677,2014-11-01,01Y,1079,769,1848,0.5838744588744589
9678,2014-11-01,02A,1233,574,1807,0.6823464305478694
9679,2014-11-01,02D,500,417,917,0.5452562704471101
9680,2014-11-01,02E,1178,557,1735,0.6789625360230548
9681,2014-11-01,02F,1514,569,2083,0.7268362938070091
9682,2014-11-01,02G,655,332,987,0.6636271529888551
9683,2014-11-01,02H,1536,1429,2965,0.518043844856661
9684,2014-11-01,02M,1050,411,1461,0.7186858316221766
9685,2014-11-01,02N,1053,674,1727,0.6097278517660684
9686,2014-11-01,02P,1092,1320,2412,0.4527363184079602
9687,2014-11-01,02Q,546,409,955,0.5717277486910994
9688,2014-11-01,02R,2141,1190,3331,0.6427499249474632
9689,2014-11-01,02T,1274,716,1990,0.6402010050251257
9690,2014-11-01,02V,1306,669,1975,0.6612658227848102
9691,2014-11-01,02W,537,342,879,0.6109215017064846
9692,2014-11-01,02X,1937,911,2848,0.680126404494382
9693,2014-11-01,02Y,1980,847,2827,0.7003891050583657
9694,2014-11-01,03A,1302,728,2030,0.6413793103448275
9695,2014-11-01,03C,1740,1216,2956,0.5886332882273342
9696,2014-11-01,03D,923,424,1347,0.6852264291017075
9697,2014-11-01,03E,910,539,1449,0.6280193236714976
9698,2014-11-01,03F,1711,623,2334,0.733076263924593
9699,2014-11-01,03G,1625,923,2548,0.6377551020408163
9700,2014-11-01,03H,1228,435,1663,0.7384245339747444
9701,2014-11-01,03J,1162,441,1603,0.7248908296943232
9702,2014-11-01,03K,941,349,1290,0.7294573643410853
9703,2014-11-01,03L,1033,1193,2226,0.4640610961365678
9704,2014-11-01,03M,759,413,1172,0.6476109215017065
9705,2014-11-01,03N,3397,1090,4487,0.7570759973256073
9706,2014-11-01,03Q,1919,898,2817,0.681221157259496
9707,2014-11-01,03R,2380,1220,3600,0.6611111111111111
9708,2014-11-01,03T,1825,790,2615,0.6978967495219885
9709,2014-11-01,03V,466,227,693,0.6724386724386724
9710,2014-11-01,03W,2227,1147,3374,0.6600474214582098
9711,2014-11-01,03X,476,324,800,0.595
9712,2014-11-01,03Y,644,358,1002,0.6427145708582834
9713,2014-11-01,04C,2136,814,2950,0.7240677966101695
9714,2014-11-01,04D,1288,706,1994,0.645937813440321
9715,2014-11-01,04E,1215,682,1897,0.6404849762783342
9716,2014-11-01,04F,1537,981,2518,0.6104050833995235
9717,2014-11-01,04G,4181,2192,6373,0.6560489565353836
9718,2014-11-01,04H,711,408,1119,0.6353887399463807
9719,2014-11-01,04J,1986,1174,3160,0.6284810126582279
9720,2014-11-01,04K,1689,912,2601,0.649365628604383
9721,2014-11-01,04L,808,373,1181,0.6841659610499576
9722,2014-11-01,04M,433,310,743,0.5827725437415882
9723,2014-11-01,04N,659,340,999,0.6596596596596597
9724,2014-11-01,04Q,851,416,1267,0.6716653512233622
9725,2014-11-01,04R,2456,1488,3944,0.6227180527383367
9726,2014-11-01,04V,2433,1112,3545,0.6863187588152327
9727,2014-11-01,04X,1368,1189,2557,0.5350019554165037
9728,2014-11-01,04Y,1030,393,1423,0.7238229093464511
9729,2014-11-01,05A,2708,1443,4151,0.6523729221874247
9730,2014-11-01,05C,1241,1615,2856,0.43452380952380953
9731,2014-11-01,05D,1033,425,1458,0.7085048010973937
9732,2014-11-01,05F,1212,587,1799,0.6737076153418566
9733,2014-11-01,05G,1506,627,2133,0.7060478199718706
9734,2014-11-01,05H,1103,631,1734,0.6361014994232987
9735,2014-11-01,05J,1399,637,2036,0.68713163064833
9736,2014-11-01,05L,2460,1415,3875,0.6348387096774194
9737,2014-11-01,05N,2225,897,3122,0.7126841768097374
9738,2014-11-01,05P,1297,772,2069,0.6268728854519091
9739,2014-11-01,05Q,1340,720,2060,0.6504854368932039
9740,2014-11-01,05R,1816,1117,2933,0.6191612683259461
9741,2014-11-01,05T,2012,1065,3077,0.6538836529086773
9742,2014-11-01,05V,1039,479,1518,0.6844532279314888
9743,2014-11-01,05W,1783,718,2501,0.7129148340663735
9744,2014-11-01,05X,1109,408,1517,0.7310481212920237
9745,2014-11-01,05Y,1877,927,2804,0.6694008559201141
9746,2014-11-01,06A,1548,715,2263,0.6840477242598321
9747,2014-11-01,06D,879,412,1291,0.6808675445391169
9748,2014-11-01,06F,1657,2468,4125,0.4016969696969697
9749,2014-11-01,06H,5173,2759,7932,0.6521684316691881
9750,2014-11-01,06K,3457,2363,5820,0.5939862542955326
9751,2014-11-01,06L,2497,989,3486,0.7162937464142284
9752,2014-11-01,06M,1865,845,2710,0.6881918819188192
9753,2014-11-01,06N,3339,2191,5530,0.6037974683544304
9754,2014-11-01,06P,881,1018,1899,0.46392838335966297
9755,2014-11-01,06Q,2449,1182,3631,0.6744698430184523
9756,2014-11-01,06T,2375,1159,3534,0.6720430107526881
9757,2014-11-01,06V,1361,621,1982,0.6866801210898082
9758,2014-11-01,06W,1514,533,2047,0.73961895456766
9759,2014-11-01,06Y,1282,575,1857,0.6903607969843835
9760,2014-11-01,07G,962,357,1319,0.7293404094010614
9761,2014-11-01,07H,1687,953,2640,0.6390151515151515
9762,2014-11-01,07J,849,505,1354,0.6270310192023634
9763,2014-11-01,07K,1538,645,2183,0.7045350435180944
9764,2014-11-01,07L,766,315,1081,0.7086031452358927
9765,2014-11-01,07M,1236,871,2107,0.5866160417655434
9766,2014-11-01,07N,1362,628,1990,0.6844221105527638
9767,2014-11-01,07P,889,567,1456,0.6105769230769231
9768,2014-11-01,07Q,1613,809,2422,0.6659785301403799
9769,2014-11-01,07R,778,624,1402,0.5549215406562055
9770,2014-11-01,07T,662,587,1249,0.5300240192153723
9771,2014-11-01,07V,1844,765,2609,0.7067842085090073
9772,2014-11-01,07W,1092,889,1981,0.5512367491166078
9773,2014-11-01,07X,1306,708,2014,0.6484607745779544
9774,2014-11-01,07Y,921,507,1428,0.6449579831932774
9775,2014-11-01,08A,1097,633,1730,0.6341040462427746
9776,2014-11-01,08C,643,526,1169,0.5500427715996579
9777,2014-11-01,08D,855,562,1417,0.6033874382498235
9778,2014-11-01,08E,812,556,1368,0.5935672514619883
9779,2014-11-01,08F,1513,696,2209,0.6849253055681304
9780,2014-11-01,08G,453,1302,1755,0.25811965811965815
9781,2014-11-01,08H,783,588,1371,0.5711159737417943
9782,2014-11-01,08J,813,429,1242,0.6545893719806763
9783,2014-11-01,08K,1221,583,1804,0.676829268292683
9784,2014-11-01,08L,634,1268,1902,0.3333333333333333
9785,2014-11-01,08M,1120,554,1674,0.6690561529271206
9786,2014-11-01,08N,1196,568,1764,0.6780045351473923
9787,2014-11-01,08P,920,530,1450,0.6344827586206897
9788,2014-11-01,08Q,1014,435,1449,0.6997929606625258
9789,2014-11-01,08R,845,407,1252,0.6749201277955271
9790,2014-11-01,08T,977,493,1470,0.6646258503401361
9791,2014-11-01,08V,974,513,1487,0.6550100874243443
9792,2014-11-01,08W,1015,480,1495,0.6789297658862876
9793,2014-11-01,08X,1355,675,2030,0.6674876847290641
9794,2014-11-01,08Y,653,555,1208,0.5405629139072847
9795,2014-11-01,09A,553,539,1092,0.5064102564102564
9796,2014-11-01,09C,725,500,1225,0.5918367346938775
9797,2014-11-01,09D,1487,894,2381,0.6245275094498111
9798,2014-11-01,09E,1626,637,2263,0.7185152452496686
9799,2014-11-01,09F,1288,631,1919,0.6711829077644607
9800,2014-11-01,09G,3436,1786,5222,0.6579854461891995
9801,2014-11-01,09H,548,374,922,0.5943600867678959
9802,2014-11-01,09J,1899,1065,2964,0.6406882591093117
9803,2014-11-01,09L,944,488,1432,0.659217877094972
9804,2014-11-01,09N,1165,651,1816,0.6415198237885462
9805,2014-11-01,09P,1212,785,1997,0.6069103655483225
9806,2014-11-01,09W,1443,860,2303,0.6265740338688667
9807,2014-11-01,09X,1047,756,1803,0.5806988352745425
9808,2014-11-01,09Y,1513,1162,2675,0.565607476635514
9809,2014-11-01,10A,1182,840,2022,0.5845697329376854
9810,2014-11-01,10C,494,277,771,0.6407263294422828
9811,2014-11-01,10D,635,287,922,0.6887201735357917
9812,2014-11-01,10E,850,371,1221,0.6961506961506961
9813,2014-11-01,10G,632,332,964,0.6556016597510373
9814,2014-11-01,10H,1883,1208,3091,0.6091879650598512
9815,2014-11-01,10J,1138,797,1935,0.5881136950904393
9816,2014-11-01,10K,1387,628,2015,0.6883374689826303
9817,2014-11-01,10L,986,421,1407,0.7007818052594172
9818,2014-11-01,10M,514,419,933,0.5509110396570204
9819,2014-11-01,10N,465,426,891,0.5218855218855218
9820,2014-11-01,10Q,3343,2975,6318,0.5291231402342513
9821,2014-11-01,10R,1394,501,1895,0.7356200527704485
9822,2014-11-01,10T,580,347,927,0.6256742179072277
9823,2014-11-01,10V,1332,646,1978,0.673407482305359
9824,2014-11-01,10W,601,426,1027,0.5851996105160662
9825,2014-11-01,10X,1195,614,1809,0.6605859590934218
9826,2014-11-01,10Y,1313,848,2161,0.6075890791300324
9827,2014-11-01,11A,3481,1768,5249,0.663173937892932
9828,2014-11-01,11C,909,368,1277,0.711824588880188
9829,2014-11-01,11D,635,589,1224,0.5187908496732027
9830,2014-11-01,11E,1129,888,2017,0.5597421913733267
9831,2014-11-01,11H,2677,1453,4130,0.64818401937046
9832,2014-11-01,11J,5271,2343,7614,0.6922773837667455
9833,2014-11-01,11M,3870,1924,5794,0.6679323438039351
9834,2014-11-01,11N,4198,1698,5896,0.7120081411126187
9835,2014-11-01,11T,1486,851,2337,0.6358579375267437
9836,2014-11-01,11X,3410,1866,5276,0.6463229719484458
9837,2014-11-01,12A,1491,655,2146,0.6947809878844362
9838,2014-11-01,12D,1144,865,2009,0.569437531110005
9839,2014-11-01,12F,2524,742,3266,0.7728107777097367
9840,2014-11-01,13P,2981,2117,5098,0.5847391133777952
9841,2014-11-01,13T,3042,1493,4535,0.6707828004410143
9842,2014-11-01,14L,3256,1689,4945,0.6584428715874621
9843,2014-11-01,99A,2883,1113,3996,0.7214714714714715
9844,2014-11-01,99C,1560,780,2340,0.6666666666666666
9845,2014-11-01,99D,1031,771,1802,0.5721420643729189
9846,2014-11-01,99E,1590,645,2235,0.7114093959731543
9847,2014-11-01,99F,1087,399,1486,0.7314939434724091
9848,2014-11-01,99G,1175,410,1585,0.7413249211356467
9849,2014-11-01,99H,1632,947,2579,0.6328034121752617
9850,2014-11-01,99J,2873,1636,4509,0.6371701042359725
9851,2014-11-01,99K,1012,627,1639,0.6174496644295302
9852,2014-11-01,99M,1100,807,1907,0.5768222338751966
9853,2014-11-01,99N,3069,2290,5359,0.5726814704235865
9854,2014-11-01,99P,6432,2441,8873,0.7248957511551899
9855,2014-11-01,99Q,1968,835,2803,0.7021048876204067
9856,2014-12-01,00C,794,322,1116,0.7114695340501792
9857,2014-12-01,00D,2386,1110,3496,0.6824942791762014
9858,2014-12-01,00J,1818,795,2613,0.695752009184845
9859,2014-12-01,00K,2302,1015,3317,0.694000602954477
9860,2014-12-01,00L,2390,1453,3843,0.6219099661722612
9861,2014-12-01,00M,2284,1130,3414,0.6690099589923842
9862,2014-12-01,00N,1217,630,1847,0.6589063345966432
9863,2014-12-01,00P,2025,847,2872,0.70508356545961
9864,2014-12-01,00Q,1055,436,1491,0.7075788061703555
9865,2014-12-01,00R,1153,649,1802,0.6398446170921198
9866,2014-12-01,00T,1928,1174,3102,0.6215344938749194
9867,2014-12-01,00V,1384,831,2215,0.6248306997742664
9868,2014-12-01,00W,21,3,24,0.875
9869,2014-12-01,00X,1002,333,1335,0.750561797752809
9870,2014-12-01,00Y,1746,1020,2766,0.631236442516269
9871,2014-12-01,01A,2510,1421,3931,0.6385143729330959
9872,2014-12-01,01C,1206,702,1908,0.6320754716981132
9873,2014-12-01,01D,1578,836,2414,0.6536868268434134
9874,2014-12-01,01E,1042,217,1259,0.8276409849086577
9875,2014-12-01,01F,1002,468,1470,0.6816326530612244
9876,2014-12-01,01G,1288,1309,2597,0.49595687331536387
9877,2014-12-01,01H,2528,976,3504,0.7214611872146118
9878,2014-12-01,01J,1151,560,1711,0.6727060198714202
9879,2014-12-01,01K,2148,1244,3392,0.6332547169811321
9880,2014-12-01,01N,16,13,29,0.5517241379310345
9881,2014-12-01,01R,1022,618,1640,0.6231707317073171
9882,2014-12-01,01T,821,468,1289,0.6369278510473235
9883,2014-12-01,01V,949,454,1403,0.6764076977904491
9884,2014-12-01,01W,2161,1071,3232,0.6686262376237624
9885,2014-12-01,01X,1406,848,2254,0.6237799467613132
9886,2014-12-01,01Y,1065,750,1815,0.5867768595041323
9887,2014-12-01,02A,1308,623,1931,0.677369238736406
9888,2014-12-01,02D,523,418,941,0.5557917109458024
9889,2014-12-01,02E,1291,625,1916,0.6737995824634656
9890,2014-12-01,02F,1704,616,2320,0.7344827586206897
9891,2014-12-01,02G,658,342,1000,0.658
9892,2014-12-01,02H,1569,1547,3116,0.5035301668806161
9893,2014-12-01,02M,1150,449,1599,0.7191994996873046
9894,2014-12-01,02N,1000,782,1782,0.5611672278338945
9895,2014-12-01,02P,1133,1488,2621,0.43227775658145745
9896,2014-12-01,02Q,651,485,1136,0.5730633802816901
9897,2014-12-01,02R,2167,1227,3394,0.6384796700058928
9898,2014-12-01,02T,1337,774,2111,0.6333491236380863
9899,2014-12-01,02V,1348,772,2120,0.6358490566037736
9900,2014-12-01,02W,551,334,885,0.6225988700564972
9901,2014-12-01,02X,2108,1006,3114,0.6769428387925498
9902,2014-12-01,02Y,2087,934,3021,0.6908308507116848
9903,2014-12-01,03A,1409,796,2205,0.6390022675736962
9904,2014-12-01,03C,1879,1321,3200,0.5871875
9905,2014-12-01,03D,940,446,1386,0.6782106782106783
9906,2014-12-01,03E,942,545,1487,0.6334902488231339
9907,2014-12-01,03F,1645,663,2308,0.712738301559792
9908,2014-12-01,03G,1689,993,2682,0.6297539149888143
9909,2014-12-01,03H,1288,552,1840,0.7
9910,2014-12-01,03J,1195,586,1781,0.6709713644020213
9911,2014-12-01,03K,1053,443,1496,0.7038770053475936
9912,2014-12-01,03L,1128,1321,2449,0.46059616169865253
9913,2014-12-01,03M,892,405,1297,0.6877409406322282
9914,2014-12-01,03N,3410,1303,4713,0.7235306598769361
9915,2014-12-01,03Q,2085,1065,3150,0.6619047619047619
9916,2014-12-01,03R,2494,1425,3919,0.6363868333758612
9917,2014-12-01,03T,1767,874,2641,0.6690647482014388
9918,2014-12-01,03V,439,271,710,0.6183098591549295
9919,2014-12-01,03W,2381,1198,3579,0.6652696283878178
9920,2014-12-01,03X,457,356,813,0.5621156211562116
9921,2014-12-01,03Y,783,433,1216,0.6439144736842105
9922,2014-12-01,04C,2218,849,3067,0.723182262797522
9923,2014-12-01,04D,1454,809,2263,0.6425099425541316
9924,2014-12-01,04E,1296,682,1978,0.6552072800808898
9925,2014-12-01,04F,1601,1070,2671,0.5994009734181954
9926,2014-12-01,04G,4266,2530,6796,0.627722189523249
9927,2014-12-01,04H,724,446,1170,0.6188034188034188
9928,2014-12-01,04J,2011,1259,3270,0.6149847094801223
9929,2014-12-01,04K,1624,878,2502,0.6490807354116707
9930,2014-12-01,04L,823,440,1263,0.6516231195566112
9931,2014-12-01,04M,553,318,871,0.634902411021814
9932,2014-12-01,04N,693,361,1054,0.6574952561669829
9933,2014-12-01,04Q,894,430,1324,0.675226586102719
9934,2014-12-01,04R,2532,1572,4104,0.6169590643274854
9935,2014-12-01,04V,2550,1161,3711,0.6871463217461601
9936,2014-12-01,04X,1323,1160,2483,0.5328231977446637
9937,2014-12-01,04Y,1057,433,1490,0.7093959731543624
9938,2014-12-01,05A,2694,1522,4216,0.6389943074003795
9939,2014-12-01,05C,1306,1767,3073,0.42499186462739996
9940,2014-12-01,05D,1034,475,1509,0.685222001325381
9941,2014-12-01,05F,1210,728,1938,0.6243550051599587
9942,2014-12-01,05G,1608,647,2255,0.7130820399113083
9943,2014-12-01,05H,1147,653,1800,0.6372222222222222
9944,2014-12-01,05J,1447,724,2171,0.6665131275909719
9945,2014-12-01,05L,2465,1556,4021,0.613031584183039
9946,2014-12-01,05N,2357,992,3349,0.7037921767691848
9947,2014-12-01,05P,1352,854,2206,0.6128739800543971
9948,2014-12-01,05Q,1417,741,2158,0.6566265060240963
9949,2014-12-01,05R,1883,1236,3119,0.6037191407502405
9950,2014-12-01,05T,2193,1180,3373,0.6501630595908686
9951,2014-12-01,05V,1079,505,1584,0.6811868686868687
9952,2014-12-01,05W,1848,763,2611,0.707774798927614
9953,2014-12-01,05X,1269,459,1728,0.734375
9954,2014-12-01,05Y,1876,993,2869,0.6538863715580342
9955,2014-12-01,06A,1728,732,2460,0.7024390243902439
9956,2014-12-01,06D,919,460,1379,0.6664249456127629
9957,2014-12-01,06F,1641,2537,4178,0.39277166108185735
9958,2014-12-01,06H,5366,2926,8292,0.6471297636275929
9959,2014-12-01,06K,3462,2496,5958,0.581067472306143
9960,2014-12-01,06L,2469,1107,3576,0.6904362416107382
9961,2014-12-01,06M,1917,902,2819,0.680028378857751
9962,2014-12-01,06N,3446,2443,5889,0.5851587705892342
9963,2014-12-01,06P,878,972,1850,0.4745945945945946
9964,2014-12-01,06Q,2507,1247,3754,0.6678209909429942
9965,2014-12-01,06T,2447,1342,3789,0.6458168382158881
9966,2014-12-01,06V,1486,695,2181,0.6813388353966071
9967,2014-12-01,06W,1437,563,2000,0.7185
9968,2014-12-01,06Y,1302,624,1926,0.67601246105919
9969,2014-12-01,07G,994,375,1369,0.7260774287801315
9970,2014-12-01,07H,1762,1091,2853,0.6175955134945671
9971,2014-12-01,07J,876,539,1415,0.6190812720848057
9972,2014-12-01,07K,1539,742,2281,0.6747040771591407
9973,2014-12-01,07L,797,370,1167,0.6829477292202228
9974,2014-12-01,07M,1292,924,2216,0.5830324909747292
9975,2014-12-01,07N,1400,739,2139,0.6545114539504441
9976,2014-12-01,07P,921,643,1564,0.5888746803069054
9977,2014-12-01,07Q,1775,926,2701,0.6571640133283969
9978,2014-12-01,07R,740,583,1323,0.5593348450491308
9979,2014-12-01,07T,657,609,1266,0.518957345971564
9980,2014-12-01,07V,1799,872,2671,0.6735305129165107
9981,2014-12-01,07W,1194,902,2096,0.5696564885496184
9982,2014-12-01,07X,1247,791,2038,0.611874386653582
9983,2014-12-01,07Y,899,529,1428,0.6295518207282913
9984,2014-12-01,08A,1130,718,1848,0.6114718614718615
9985,2014-12-01,08C,651,497,1148,0.5670731707317073
9986,2014-12-01,08D,823,546,1369,0.6011687363038715
9987,2014-12-01,08E,884,583,1467,0.6025903203817314
9988,2014-12-01,08F,1639,726,2365,0.6930232558139535
9989,2014-12-01,08G,546,1277,1823,0.2995063082830499
9990,2014-12-01,08H,771,579,1350,0.5711111111111111
9991,2014-12-01,08J,882,444,1326,0.665158371040724
9992,2014-12-01,08K,1208,613,1821,0.6633717737506865
9993,2014-12-01,08L,744,1252,1996,0.3727454909819639
9994,2014-12-01,08M,1080,528,1608,0.6716417910447762
9995,2014-12-01,08N,1235,552,1787,0.6911024062674874
9996,2014-12-01,08P,1010,611,1621,0.6230721776681061
9997,2014-12-01,08Q,944,447,1391,0.6786484543493889
9998,2014-12-01,08R,862,442,1304,0.661042944785276
9999,2014-12-01,08T,1045,498,1543,0.6772521062864549
10000,2014-12-01,08V,928,570,1498,0.6194926568758344
10001,2014-12-01,08W,1031,466,1497,0.6887107548430194
10002,2014-12-01,08X,1215,717,1932,0.6288819875776398
10003,2014-12-01,08Y,679,594,1273,0.5333857030636292
10004,2014-12-01,09A,539,626,1165,0.46266094420600856
10005,2014-12-01,09C,747,548,1295,0.5768339768339769
10006,2014-12-01,09D,1482,933,2415,0.613664596273292
10007,2014-12-01,09E,1628,674,2302,0.7072111207645526
10008,2014-12-01,09F,1377,700,2077,0.6629754453538758
10009,2014-12-01,09G,3649,1947,5596,0.652072909220872
10010,2014-12-01,09H,579,337,916,0.6320960698689956
10011,2014-12-01,09J,1688,1224,2912,0.5796703296703297
10012,2014-12-01,09L,856,570,1426,0.6002805049088359
10013,2014-12-01,09N,1204,722,1926,0.6251298026998962
10014,2014-12-01,09P,1222,900,2122,0.5758718190386428
10015,2014-12-01,09W,1288,902,2190,0.5881278538812785
10016,2014-12-01,09X,1079,849,1928,0.5596473029045643
10017,2014-12-01,09Y,1519,1317,2836,0.5356135401974612
10018,2014-12-01,10A,1204,871,2075,0.5802409638554217
10019,2014-12-01,10C,509,332,841,0.6052318668252081
10020,2014-12-01,10D,691,274,965,0.7160621761658031
10021,2014-12-01,10E,868,399,1267,0.6850828729281768
10022,2014-12-01,10G,828,440,1268,0.6529968454258676
10023,2014-12-01,10H,2107,1421,3528,0.5972222222222222
10024,2014-12-01,10J,1242,1004,2246,0.5529830810329475
10025,2014-12-01,10K,1374,692,2066,0.665053242981607
10026,2014-12-01,10L,1019,386,1405,0.7252669039145907
10027,2014-12-01,10M,561,453,1014,0.5532544378698225
10028,2014-12-01,10N,472,485,957,0.49320794148380354
10029,2014-12-01,10Q,3420,3216,6636,0.515370705244123
10030,2014-12-01,10R,1469,484,1953,0.7521761392729135
10031,2014-12-01,10T,590,316,906,0.6512141280353201
10032,2014-12-01,10V,1363,735,2098,0.6496663489037178
10033,2014-12-01,10W,652,450,1102,0.5916515426497277
10034,2014-12-01,10X,1230,649,1879,0.6546035125066525
10035,2014-12-01,10Y,1327,931,2258,0.587688219663419
10036,2014-12-01,11A,3549,1968,5517,0.643284393692224
10037,2014-12-01,11C,915,460,1375,0.6654545454545454
10038,2014-12-01,11D,646,654,1300,0.4969230769230769
10039,2014-12-01,11E,1155,962,2117,0.545583372697213
10040,2014-12-01,11H,2618,1533,4151,0.6306913996627319
10041,2014-12-01,11J,5465,2671,8136,0.6717059980334317
10042,2014-12-01,11M,4065,2169,6234,0.6520692974013474
10043,2014-12-01,11N,4281,1861,6142,0.6970042331488114
10044,2014-12-01,11T,1641,1016,2657,0.6176138502070003
10045,2014-12-01,11X,3455,2175,5630,0.6136767317939609
10046,2014-12-01,12A,1684,807,2491,0.6760337213970293
10047,2014-12-01,12D,1210,987,2197,0.5507510241238052
10048,2014-12-01,12F,2565,813,3378,0.7593250444049734
10049,2014-12-01,13P,3184,2127,5311,0.5995104500094144
10050,2014-12-01,13T,3214,1616,4830,0.665424430641822
10051,2014-12-01,14L,3293,1734,5027,0.655062661627213
10052,2014-12-01,99A,2901,1218,4119,0.7042971595047341
10053,2014-12-01,99C,1715,871,2586,0.6631863882443929
10054,2014-12-01,99D,1180,865,2045,0.5770171149144254
10055,2014-12-01,99E,1659,642,2301,0.7209908735332464
10056,2014-12-01,99F,1074,436,1510,0.7112582781456953
10057,2014-12-01,99G,1158,417,1575,0.7352380952380952
10058,2014-12-01,99H,1763,1046,2809,0.627625489498042
10059,2014-12-01,99J,3017,1848,4865,0.6201438848920864
10060,2014-12-01,99K,1092,759,1851,0.5899513776337115
10061,2014-12-01,99M,1100,892,1992,0.5522088353413654
10062,2014-12-01,99N,3104,2431,5535,0.5607949412827462
10063,2014-12-01,99P,6936,2731,9667,0.7174925002586118
10064,2014-12-01,99Q,1929,990,2919,0.6608427543679343
10065,2015-01-01,00C,717,330,1047,0.6848137535816619
10066,2015-01-01,00D,2327,1080,3407,0.6830055767537423
10067,2015-01-01,00J,1734,785,2519,0.6883684001587932
10068,2015-01-01,00K,2186,1097,3283,0.6658544014620774
10069,2015-01-01,00L,2229,1289,3518,0.6335986355884025
10070,2015-01-01,00M,2311,1118,3429,0.6739574219889181
10071,2015-01-01,00N,1134,627,1761,0.6439522998296422
10072,2015-01-01,00P,2035,810,2845,0.7152899824253075
10073,2015-01-01,00Q,924,412,1336,0.6916167664670658
10074,2015-01-01,00R,1218,648,1866,0.6527331189710611
10075,2015-01-01,00T,1851,1150,3001,0.6167944018660446
10076,2015-01-01,00V,1388,894,2282,0.6082383873794917
10077,2015-01-01,00W,17,7,24,0.7083333333333334
10078,2015-01-01,00X,1042,310,1352,0.7707100591715976
10079,2015-01-01,00Y,1696,1108,2804,0.6048502139800286
10080,2015-01-01,01A,2357,1385,3742,0.6298770710849813
10081,2015-01-01,01C,1171,634,1805,0.6487534626038781
10082,2015-01-01,01D,1556,852,2408,0.6461794019933554
10083,2015-01-01,01E,1102,234,1336,0.8248502994011976
10084,2015-01-01,01F,962,457,1419,0.6779422128259338
10085,2015-01-01,01G,1271,1347,2618,0.485485103132162
10086,2015-01-01,01H,2519,952,3471,0.7257274560645347
10087,2015-01-01,01J,1060,548,1608,0.6592039800995025
10088,2015-01-01,01K,2014,1287,3301,0.6101181460163587
10089,2015-01-01,01N,28,21,49,0.5714285714285714
10090,2015-01-01,01R,1017,564,1581,0.6432637571157496
10091,2015-01-01,01T,804,435,1239,0.648910411622276
10092,2015-01-01,01V,863,460,1323,0.6523053665910808
10093,2015-01-01,01W,2017,1105,3122,0.6460602178090967
10094,2015-01-01,01X,1379,721,2100,0.6566666666666666
10095,2015-01-01,01Y,1059,706,1765,0.6
10096,2015-01-01,02A,1211,592,1803,0.6716583471991125
10097,2015-01-01,02D,521,419,940,0.5542553191489362
10098,2015-01-01,02E,1115,698,1813,0.6150027578599007
10099,2015-01-01,02F,1518,639,2157,0.7037552155771906
10100,2015-01-01,02G,635,367,1002,0.6337325349301397
10101,2015-01-01,02H,1470,1506,2976,0.4939516129032258
10102,2015-01-01,02M,1032,411,1443,0.7151767151767152
10103,2015-01-01,02N,1007,700,1707,0.5899238429994141
10104,2015-01-01,02P,1107,1471,2578,0.42940263770364623
10105,2015-01-01,02Q,641,472,1113,0.5759209344115005
10106,2015-01-01,02R,2190,1325,3515,0.6230440967283073
10107,2015-01-01,02T,1296,739,2035,0.6368550368550369
10108,2015-01-01,02V,1269,807,2076,0.611271676300578
10109,2015-01-01,02W,547,336,883,0.6194790486976217
10110,2015-01-01,02X,2014,950,2964,0.6794871794871795
10111,2015-01-01,02Y,2060,902,2962,0.6954760297096556
10112,2015-01-01,03A,1410,725,2135,0.6604215456674473
10113,2015-01-01,03C,1807,1281,3088,0.5851683937823834
10114,2015-01-01,03D,878,411,1289,0.6811481768813034
10115,2015-01-01,03E,883,544,1427,0.6187806587245971
10116,2015-01-01,03F,1768,600,2368,0.7466216216216216
10117,2015-01-01,03G,1594,977,2571,0.6199922209257098
10118,2015-01-01,03H,1319,473,1792,0.7360491071428571
10119,2015-01-01,03J,1180,578,1758,0.6712172923777019
10120,2015-01-01,03K,1000,408,1408,0.7102272727272727
10121,2015-01-01,03L,1015,1298,2313,0.4388240380458279
10122,2015-01-01,03M,809,424,1233,0.6561232765612328
10123,2015-01-01,03N,3161,1198,4359,0.7251663225510439
10124,2015-01-01,03Q,1982,1059,3041,0.6517592897073331
10125,2015-01-01,03R,2413,1334,3747,0.6439818521483853
10126,2015-01-01,03T,1728,890,2618,0.6600458365164248
10127,2015-01-01,03V,488,255,743,0.6567967698519516
10128,2015-01-01,03W,2220,1132,3352,0.662291169451074
10129,2015-01-01,03X,452,300,752,0.601063829787234
10130,2015-01-01,03Y,746,376,1122,0.6648841354723708
10131,2015-01-01,04C,2166,836,3002,0.7215189873417721
10132,2015-01-01,04D,1344,822,2166,0.6204986149584487
10133,2015-01-01,04E,1209,690,1899,0.636650868878357
10134,2015-01-01,04F,1477,1027,2504,0.5898562300319489
10135,2015-01-01,04G,4433,2415,6848,0.6473422897196262
10136,2015-01-01,04H,713,450,1163,0.6130696474634566
10137,2015-01-01,04J,1951,1255,3206,0.6085464753587024
10138,2015-01-01,04K,1612,901,2513,0.6414643851969757
10139,2015-01-01,04L,867,405,1272,0.6816037735849056
10140,2015-01-01,04M,443,325,768,0.5768229166666666
10141,2015-01-01,04N,676,347,1023,0.6608015640273704
10142,2015-01-01,04Q,820,433,1253,0.6544293695131684
10143,2015-01-01,04R,2477,1684,4161,0.5952895938476328
10144,2015-01-01,04V,2352,1122,3474,0.6770293609671848
10145,2015-01-01,04X,1297,1174,2471,0.5248887090246863
10146,2015-01-01,04Y,972,422,1394,0.697274031563845
10147,2015-01-01,05A,2654,1587,4241,0.62579580287668
10148,2015-01-01,05C,1222,1777,2999,0.40746915638546183
10149,2015-01-01,05D,1030,470,1500,0.6866666666666666
10150,2015-01-01,05F,1279,716,1995,0.6411027568922306
10151,2015-01-01,05G,1574,614,2188,0.7193784277879341
10152,2015-01-01,05H,1198,645,1843,0.6500271296798698
10153,2015-01-01,05J,1440,624,2064,0.6976744186046512
10154,2015-01-01,05L,2471,1595,4066,0.6077225774717167
10155,2015-01-01,05N,2140,926,3066,0.6979778212654925
10156,2015-01-01,05P,1272,882,2154,0.5905292479108635
10157,2015-01-01,05Q,1495,725,2220,0.6734234234234234
10158,2015-01-01,05R,1739,1191,2930,0.5935153583617747
10159,2015-01-01,05T,2131,1190,3321,0.641674194519723
10160,2015-01-01,05V,1013,501,1514,0.6690885072655218
10161,2015-01-01,05W,1974,817,2791,0.7072733787173057
10162,2015-01-01,05X,1155,431,1586,0.7282471626733922
10163,2015-01-01,05Y,1912,1061,2973,0.643121426168853
10164,2015-01-01,06A,1677,736,2413,0.6949854952341483
10165,2015-01-01,06D,920,427,1347,0.6829992576095026
10166,2015-01-01,06F,1661,2585,4246,0.3911917098445596
10167,2015-01-01,06H,5388,2980,8368,0.6438814531548758
10168,2015-01-01,06K,3382,2439,5821,0.5809998282082116
10169,2015-01-01,06L,2446,1040,3486,0.7016637980493402
10170,2015-01-01,06M,1773,867,2640,0.6715909090909091
10171,2015-01-01,06N,3500,2328,5828,0.6005490734385724
10172,2015-01-01,06P,930,1070,2000,0.465
10173,2015-01-01,06Q,2564,1263,3827,0.6699764828847662
10174,2015-01-01,06T,2340,1355,3695,0.6332882273342354
10175,2015-01-01,06V,1382,616,1998,0.6916916916916916
10176,2015-01-01,06W,1422,586,2008,0.7081673306772909
10177,2015-01-01,06Y,1450,599,2049,0.7076622742801366
10178,2015-01-01,07G,890,413,1303,0.6830391404451266
10179,2015-01-01,07H,1743,1062,2805,0.6213903743315508
10180,2015-01-01,07J,845,512,1357,0.6226971260132645
10181,2015-01-01,07K,1533,688,2221,0.6902296262944619
10182,2015-01-01,07L,785,336,1121,0.7002676181980375
10183,2015-01-01,07M,1328,976,2304,0.5763888888888888
10184,2015-01-01,07N,1385,747,2132,0.649624765478424
10185,2015-01-01,07P,923,657,1580,0.5841772151898734
10186,2015-01-01,07Q,1692,880,2572,0.6578538102643857
10187,2015-01-01,07R,784,677,1461,0.5366187542778919
10188,2015-01-01,07T,679,567,1246,0.5449438202247191
10189,2015-01-01,07V,1757,861,2618,0.6711229946524064
10190,2015-01-01,07W,1178,927,2105,0.5596199524940617
10191,2015-01-01,07X,1151,747,1898,0.6064278187565859
10192,2015-01-01,07Y,976,538,1514,0.6446499339498019
10193,2015-01-01,08A,1218,689,1907,0.6386995280545359
10194,2015-01-01,08C,681,469,1150,0.5921739130434782
10195,2015-01-01,08D,867,635,1502,0.5772303595206392
10196,2015-01-01,08E,871,666,1537,0.5666883539362394
10197,2015-01-01,08F,1594,704,2298,0.6936466492602262
10198,2015-01-01,08G,485,1373,1858,0.26103336921420883
10199,2015-01-01,08H,756,622,1378,0.548621190130624
10200,2015-01-01,08J,944,454,1398,0.6752503576537912
10201,2015-01-01,08K,1266,622,1888,0.6705508474576272
10202,2015-01-01,08L,680,1287,1967,0.34570411794611083
10203,2015-01-01,08M,1158,597,1755,0.6598290598290598
10204,2015-01-01,08N,1294,514,1808,0.7157079646017699
10205,2015-01-01,08P,1017,611,1628,0.6246928746928747
10206,2015-01-01,08Q,1019,432,1451,0.7022742935906272
10207,2015-01-01,08R,865,462,1327,0.651846269781462
10208,2015-01-01,08T,988,589,1577,0.6265060240963856
10209,2015-01-01,08V,1064,530,1594,0.6675031367628608
10210,2015-01-01,08W,1050,508,1558,0.6739409499358151
10211,2015-01-01,08X,1394,781,2175,0.6409195402298851
10212,2015-01-01,08Y,662,589,1251,0.5291766586730615
10213,2015-01-01,09A,525,560,1085,0.4838709677419355
10214,2015-01-01,09C,686,470,1156,0.5934256055363322
10215,2015-01-01,09D,1568,970,2538,0.6178092986603625
10216,2015-01-01,09E,1624,688,2312,0.7024221453287197
10217,2015-01-01,09F,1323,660,1983,0.6671709531013615
10218,2015-01-01,09G,3560,1866,5426,0.6561002580169554
10219,2015-01-01,09H,622,369,991,0.627648839556004
10220,2015-01-01,09J,1594,1181,2775,0.5744144144144144
10221,2015-01-01,09L,883,538,1421,0.6213933849401829
10222,2015-01-01,09N,1135,752,1887,0.6014838367779545
10223,2015-01-01,09P,1201,885,2086,0.5757430488974113
10224,2015-01-01,09W,1346,920,2266,0.5939982347749339
10225,2015-01-01,09X,1001,777,1778,0.562992125984252
10226,2015-01-01,09Y,1360,1384,2744,0.4956268221574344
10227,2015-01-01,10A,1174,830,2004,0.5858283433133733
10228,2015-01-01,10C,465,367,832,0.5588942307692307
10229,2015-01-01,10D,666,289,955,0.6973821989528796
10230,2015-01-01,10E,853,434,1287,0.6627816627816627
10231,2015-01-01,10G,711,358,1069,0.6651075771749299
10232,2015-01-01,10H,1847,1406,3253,0.5677835843836458
10233,2015-01-01,10J,1098,931,2029,0.5411532774765895
10234,2015-01-01,10K,1287,659,1946,0.6613566289825282
10235,2015-01-01,10L,1055,413,1468,0.7186648501362398
10236,2015-01-01,10M,477,462,939,0.5079872204472844
10237,2015-01-01,10N,386,493,879,0.4391353811149033
10238,2015-01-01,10Q,3428,3114,6542,0.5239987771323754
10239,2015-01-01,10R,1364,584,1948,0.7002053388090349
10240,2015-01-01,10T,611,321,932,0.6555793991416309
10241,2015-01-01,10V,1313,779,2092,0.6276290630975143
10242,2015-01-01,10W,646,458,1104,0.5851449275362319
10243,2015-01-01,10X,1168,661,1829,0.6386003280481137
10244,2015-01-01,10Y,1262,946,2208,0.5715579710144928
10245,2015-01-01,11A,3449,1931,5380,0.6410780669144981
10246,2015-01-01,11C,885,415,1300,0.6807692307692308
10247,2015-01-01,11D,617,675,1292,0.4775541795665635
10248,2015-01-01,11E,1090,974,2064,0.5281007751937985
10249,2015-01-01,11H,2591,1701,4292,0.6036812674743709
10250,2015-01-01,11J,5442,2652,8094,0.6723498888065234
10251,2015-01-01,11M,3753,1987,5740,0.6538327526132404
10252,2015-01-01,11N,4247,1810,6057,0.7011721974574872
10253,2015-01-01,11T,1564,924,2488,0.6286173633440515
10254,2015-01-01,11X,3470,2234,5704,0.6083450210378681
10255,2015-01-01,12A,1586,795,2381,0.6661066778664426
10256,2015-01-01,12D,1124,987,2111,0.532449076267172
10257,2015-01-01,12F,2292,845,3137,0.7306343640420784
10258,2015-01-01,13P,3028,2240,5268,0.574791192103265
10259,2015-01-01,13T,3154,1611,4765,0.6619097586568731
10260,2015-01-01,14L,3078,1777,4855,0.6339855818743564
10261,2015-01-01,99A,2910,1203,4113,0.7075127644055434
10262,2015-01-01,99C,1519,856,2375,0.639578947368421
10263,2015-01-01,99D,1133,852,1985,0.5707808564231738
10264,2015-01-01,99E,1607,626,2233,0.7196596506941334
10265,2015-01-01,99F,1052,361,1413,0.7445152158527955
10266,2015-01-01,99G,1168,410,1578,0.7401774397972116
10267,2015-01-01,99H,1567,1024,2591,0.6047857969895793
10268,2015-01-01,99J,2923,1835,4758,0.614333753678016
10269,2015-01-01,99K,1076,703,1779,0.6048341765036538
10270,2015-01-01,99M,1097,894,1991,0.5509794073329984
10271,2015-01-01,99N,3098,2399,5497,0.563580134618883
10272,2015-01-01,99P,6467,2725,9192,0.7035465622280244
10273,2015-01-01,99Q,1898,1102,3000,0.6326666666666667
10274,2015-02-01,00C,669,357,1026,0.652046783625731
10275,2015-02-01,00D,2115,1060,3175,0.6661417322834645
10276,2015-02-01,00J,1696,727,2423,0.6999587288485348
10277,2015-02-01,00K,1988,955,2943,0.6755011892626571
10278,2015-02-01,00L,2052,1296,3348,0.6129032258064516
10279,2015-02-01,00M,2179,970,3149,0.6919657033979041
10280,2015-02-01,00N,1016,580,1596,0.6365914786967418
10281,2015-02-01,00P,1788,785,2573,0.6949086669257676
10282,2015-02-01,00Q,910,394,1304,0.6978527607361963
10283,2015-02-01,00R,1027,618,1645,0.6243161094224924
10284,2015-02-01,00T,1692,1034,2726,0.6206896551724138
10285,2015-02-01,00V,1278,809,2087,0.6123622424532822
10286,2015-02-01,00W,6,6,12,0.5
10287,2015-02-01,00X,961,355,1316,0.7302431610942249
10288,2015-02-01,00Y,1586,996,2582,0.6142525174283501
10289,2015-02-01,01A,2281,1339,3620,0.6301104972375691
10290,2015-02-01,01C,1015,601,1616,0.6280940594059405
10291,2015-02-01,01D,1314,809,2123,0.6189354686764014
10292,2015-02-01,01E,946,226,1172,0.8071672354948806
10293,2015-02-01,01F,917,387,1304,0.7032208588957055
10294,2015-02-01,01G,1207,1279,2486,0.48551890587288815
10295,2015-02-01,01H,2062,938,3000,0.6873333333333334
10296,2015-02-01,01J,1072,531,1603,0.6687461010605116
10297,2015-02-01,01K,1837,1153,2990,0.61438127090301
10298,2015-02-01,01R,814,528,1342,0.6065573770491803
10299,2015-02-01,01T,711,450,1161,0.6124031007751938
10300,2015-02-01,01V,797,389,1186,0.6720067453625632
10301,2015-02-01,01W,1903,1021,2924,0.6508207934336525
10302,2015-02-01,01X,1351,719,2070,0.6526570048309178
10303,2015-02-01,01Y,980,714,1694,0.5785123966942148
10304,2015-02-01,02A,1191,615,1806,0.659468438538206
10305,2015-02-01,02D,431,416,847,0.5088547815820543
10306,2015-02-01,02E,962,687,1649,0.5833838690115222
10307,2015-02-01,02F,1431,621,2052,0.6973684210526315
10308,2015-02-01,02G,533,339,872,0.6112385321100917
10309,2015-02-01,02H,1399,1399,2798,0.5
10310,2015-02-01,02M,968,482,1450,0.6675862068965517
10311,2015-02-01,02N,893,622,1515,0.5894389438943894
10312,2015-02-01,02P,985,1378,2363,0.4168429961912823
10313,2015-02-01,02Q,636,407,1043,0.6097794822627037
10314,2015-02-01,02R,1970,1197,3167,0.6220397852857594
10315,2015-02-01,02T,1059,815,1874,0.5651013874066169
10316,2015-02-01,02V,1130,717,1847,0.6118029236599891
10317,2015-02-01,02W,567,313,880,0.6443181818181818
10318,2015-02-01,02X,1879,896,2775,0.6771171171171171
10319,2015-02-01,02Y,1859,911,2770,0.6711191335740072
10320,2015-02-01,03A,1231,691,1922,0.6404786680541104
10321,2015-02-01,03C,1583,1209,2792,0.5669770773638968
10322,2015-02-01,03D,895,376,1271,0.7041699449252558
10323,2015-02-01,03E,800,545,1345,0.5947955390334573
10324,2015-02-01,03F,1685,543,2228,0.7562836624775583
10325,2015-02-01,03G,1488,925,2413,0.6166597596353087
10326,2015-02-01,03H,1179,484,1663,0.708959711365003
10327,2015-02-01,03J,1051,588,1639,0.6412446613788896
10328,2015-02-01,03K,885,376,1261,0.7018239492466296
10329,2015-02-01,03L,925,1219,2144,0.4314365671641791
10330,2015-02-01,03M,807,393,1200,0.6725
10331,2015-02-01,03N,3110,1229,4339,0.7167550126757317
10332,2015-02-01,03Q,1755,1008,2763,0.6351791530944625
10333,2015-02-01,03R,2220,1271,3491,0.6359209395588656
10334,2015-02-01,03T,1623,895,2518,0.6445591739475774
10335,2015-02-01,03V,433,218,651,0.6651305683563749
10336,2015-02-01,03W,2067,1018,3085,0.6700162074554294
10337,2015-02-01,03X,413,299,712,0.5800561797752809
10338,2015-02-01,03Y,712,381,1093,0.6514181152790485
10339,2015-02-01,04C,2048,778,2826,0.7246992215145082
10340,2015-02-01,04D,1253,754,2007,0.6243148978574987
10341,2015-02-01,04E,1078,623,1701,0.6337448559670782
10342,2015-02-01,04F,1392,954,2346,0.5933503836317136
10343,2015-02-01,04G,3807,2289,6096,0.624507874015748
10344,2015-02-01,04H,678,396,1074,0.6312849162011173
10345,2015-02-01,04J,1795,1067,2862,0.627183787561146
10346,2015-02-01,04K,1618,889,2507,0.6453928998803351
10347,2015-02-01,04L,720,407,1127,0.6388642413487134
10348,2015-02-01,04M,433,285,718,0.6030640668523677
10349,2015-02-01,04N,586,322,908,0.6453744493392071
10350,2015-02-01,04Q,686,492,1178,0.5823429541595926
10351,2015-02-01,04R,2184,1538,3722,0.5867813003761418
10352,2015-02-01,04V,2237,1080,3317,0.6744045824540247
10353,2015-02-01,04X,1140,1078,2218,0.5139765554553652
10354,2015-02-01,04Y,945,373,1318,0.7169954476479514
10355,2015-02-01,05A,2389,1498,3887,0.6146128119372266
10356,2015-02-01,05C,1230,1614,2844,0.43248945147679324
10357,2015-02-01,05D,948,443,1391,0.6815240833932422
10358,2015-02-01,05F,1123,614,1737,0.6465169833045481
10359,2015-02-01,05G,1445,654,2099,0.6884230585993331
10360,2015-02-01,05H,1109,587,1696,0.6538915094339622
10361,2015-02-01,05J,1182,699,1881,0.6283891547049442
10362,2015-02-01,05L,2165,1512,3677,0.5887952134892576
10363,2015-02-01,05N,1816,1038,2854,0.6362999299229152
10364,2015-02-01,05P,1092,819,1911,0.5714285714285714
10365,2015-02-01,05Q,1318,625,1943,0.6783324755532681
10366,2015-02-01,05R,1628,1103,2731,0.5961186378615891
10367,2015-02-01,05T,1891,1179,3070,0.6159609120521172
10368,2015-02-01,05V,946,487,1433,0.6601535240753663
10369,2015-02-01,05W,1650,710,2360,0.6991525423728814
10370,2015-02-01,05X,1067,476,1543,0.6915100453661698
10371,2015-02-01,05Y,1770,947,2717,0.6514538093485462
10372,2015-02-01,06A,1512,792,2304,0.65625
10373,2015-02-01,06D,811,440,1251,0.64828137490008
10374,2015-02-01,06F,1429,2275,3704,0.3857991360691145
10375,2015-02-01,06H,4914,2819,7733,0.6354584249321091
10376,2015-02-01,06K,3105,2392,5497,0.5648535564853556
10377,2015-02-01,06L,2251,962,3213,0.7005913476501712
10378,2015-02-01,06M,1645,781,2426,0.6780708985985161
10379,2015-02-01,06N,3138,2149,5287,0.5935313031965198
10380,2015-02-01,06P,863,819,1682,0.5130796670630202
10381,2015-02-01,06Q,2267,1159,3426,0.6617046117921774
10382,2015-02-01,06T,1972,1315,3287,0.5999391542439915
10383,2015-02-01,06V,1313,670,1983,0.6621280887544125
10384,2015-02-01,06W,1268,583,1851,0.6850351161534306
10385,2015-02-01,06Y,1150,550,1700,0.6764705882352942
10386,2015-02-01,07G,920,358,1278,0.7198748043818466
10387,2015-02-01,07H,1649,1011,2660,0.6199248120300752
10388,2015-02-01,07J,802,467,1269,0.6319936958234831
10389,2015-02-01,07K,1433,642,2075,0.6906024096385542
10390,2015-02-01,07L,736,297,1033,0.712487899322362
10391,2015-02-01,07M,1172,964,2136,0.548689138576779
10392,2015-02-01,07N,1174,645,1819,0.6454095656954371
10393,2015-02-01,07P,829,624,1453,0.5705437026841018
10394,2015-02-01,07Q,1550,780,2330,0.6652360515021459
10395,2015-02-01,07R,776,607,1383,0.5610990600144613
10396,2015-02-01,07T,627,539,1166,0.5377358490566038
10397,2015-02-01,07V,1663,717,2380,0.6987394957983193
10398,2015-02-01,07W,1059,809,1868,0.566916488222698
10399,2015-02-01,07X,1139,664,1803,0.6317249029395452
10400,2015-02-01,07Y,817,477,1294,0.6313755795981453
10401,2015-02-01,08A,1086,612,1698,0.6395759717314488
10402,2015-02-01,08C,562,519,1081,0.5198889916743756
10403,2015-02-01,08D,835,489,1324,0.6306646525679759
10404,2015-02-01,08E,800,565,1365,0.5860805860805861
10405,2015-02-01,08F,1397,623,2020,0.6915841584158415
10406,2015-02-01,08G,455,1174,1629,0.27931246163290363
10407,2015-02-01,08H,681,548,1229,0.5541090317331163
10408,2015-02-01,08J,860,426,1286,0.6687402799377916
10409,2015-02-01,08K,1097,545,1642,0.6680876979293544
10410,2015-02-01,08L,643,1136,1779,0.3614390106801574
10411,2015-02-01,08M,1102,481,1583,0.6961465571699305
10412,2015-02-01,08N,1126,473,1599,0.7041901188242652
10413,2015-02-01,08P,900,521,1421,0.633356790992259
10414,2015-02-01,08Q,853,435,1288,0.6622670807453416
10415,2015-02-01,08R,751,398,1149,0.6536118363794604
10416,2015-02-01,08T,900,462,1362,0.6607929515418502
10417,2015-02-01,08V,922,582,1504,0.613031914893617
10418,2015-02-01,08W,951,461,1412,0.6735127478753541
10419,2015-02-01,08X,1205,684,1889,0.6379036527263102
10420,2015-02-01,08Y,619,534,1153,0.5368603642671292
10421,2015-02-01,09A,462,501,963,0.4797507788161994
10422,2015-02-01,09C,709,460,1169,0.6065012831479898
10423,2015-02-01,09D,1322,902,2224,0.5944244604316546
10424,2015-02-01,09E,1478,621,2099,0.7041448308718438
10425,2015-02-01,09F,1207,640,1847,0.6534921494315106
10426,2015-02-01,09G,3250,1801,5051,0.6434369431795685
10427,2015-02-01,09H,511,370,881,0.5800227014755959
10428,2015-02-01,09J,1435,994,2429,0.590778097982709
10429,2015-02-01,09L,795,482,1277,0.6225528582615505
10430,2015-02-01,09N,999,743,1742,0.5734787600459242
10431,2015-02-01,09P,1084,784,1868,0.5802997858672377
10432,2015-02-01,09W,1210,789,1999,0.6053026513256629
10433,2015-02-01,09X,938,733,1671,0.5613405146618791
10434,2015-02-01,09Y,1130,1284,2414,0.46810273405136704
10435,2015-02-01,10A,1163,769,1932,0.6019668737060041
10436,2015-02-01,10C,467,319,786,0.594147582697201
10437,2015-02-01,10D,608,252,860,0.7069767441860465
10438,2015-02-01,10E,794,334,1128,0.7039007092198581
10439,2015-02-01,10G,671,345,1016,0.6604330708661418
10440,2015-02-01,10H,1744,1279,3023,0.5769103539530268
10441,2015-02-01,10J,1021,849,1870,0.5459893048128343
10442,2015-02-01,10K,1121,675,1796,0.6241648106904232
10443,2015-02-01,10L,951,387,1338,0.7107623318385651
10444,2015-02-01,10M,491,455,946,0.5190274841437632
10445,2015-02-01,10N,379,414,793,0.47793190416141235
10446,2015-02-01,10Q,3050,2901,5951,0.5125189043858175
10447,2015-02-01,10R,1290,499,1789,0.7210732252655114
10448,2015-02-01,10T,555,312,867,0.6401384083044983
10449,2015-02-01,10V,1224,754,1978,0.6188068756319515
10450,2015-02-01,10W,519,366,885,0.5864406779661017
10451,2015-02-01,10X,1088,633,1721,0.6321905868680999
10452,2015-02-01,10Y,1082,907,1989,0.5439919557566616
10453,2015-02-01,11A,2953,1715,4668,0.632604970008569
10454,2015-02-01,11C,800,384,1184,0.6756756756756757
10455,2015-02-01,11D,572,622,1194,0.47906197654941374
10456,2015-02-01,11E,1070,851,1921,0.5570015616866215
10457,2015-02-01,11H,2289,1592,3881,0.5897964442154084
10458,2015-02-01,11J,4920,2234,7154,0.6877271456527817
10459,2015-02-01,11M,3641,2017,5658,0.643513609049134
10460,2015-02-01,11N,3714,1565,5279,0.7035423375639326
10461,2015-02-01,11T,1404,915,2319,0.6054333764553687
10462,2015-02-01,11X,3107,1872,4979,0.6240208877284595
10463,2015-02-01,12A,1455,731,2186,0.6655992680695334
10464,2015-02-01,12D,1013,844,1857,0.5455035002692514
10465,2015-02-01,12F,2120,726,2846,0.7449051300070274
10466,2015-02-01,13P,2867,2088,4955,0.5786074672048436
10467,2015-02-01,13T,2839,1428,4267,0.6653386454183267
10468,2015-02-01,14L,2864,1811,4675,0.612620320855615
10469,2015-02-01,99A,2677,1125,3802,0.7041031036296685
10470,2015-02-01,99C,1292,869,2161,0.5978713558537714
10471,2015-02-01,99D,963,738,1701,0.5661375661375662
10472,2015-02-01,99E,1504,568,2072,0.7258687258687259
10473,2015-02-01,99F,1082,399,1481,0.7305874409182984
10474,2015-02-01,99G,1050,348,1398,0.7510729613733905
10475,2015-02-01,99H,1471,979,2450,0.6004081632653061
10476,2015-02-01,99J,2652,1616,4268,0.6213683223992502
10477,2015-02-01,99K,903,686,1589,0.5682819383259912
10478,2015-02-01,99M,1009,834,1843,0.5474769397721106
10479,2015-02-01,99N,2655,2288,4943,0.537123204531661
10480,2015-02-01,99P,5725,2269,7994,0.7161621215911934
10481,2015-02-01,99Q,1740,960,2700,0.6444444444444445
10482,2015-03-01,00C,775,323,1098,0.7058287795992714
10483,2015-03-01,00D,2284,1168,3452,0.6616454229432214
10484,2015-03-01,00J,1779,746,2525,0.7045544554455445
10485,2015-03-01,00K,2290,1132,3422,0.6691992986557569
10486,2015-03-01,00L,2316,1424,3740,0.6192513368983957
10487,2015-03-01,00M,2312,1066,3378,0.6844286560094731
10488,2015-03-01,00N,1402,621,2023,0.6930301532377657
10489,2015-03-01,00P,2018,840,2858,0.7060881735479356
10490,2015-03-01,00Q,1025,373,1398,0.7331902718168812
10491,2015-03-01,00R,1160,685,1845,0.6287262872628726
10492,2015-03-01,00T,1864,1049,2913,0.6398901476141435
10493,2015-03-01,00V,1397,884,2281,0.6124506795265234
10494,2015-03-01,00W,3,0,3,1.0
10495,2015-03-01,00X,1010,371,1381,0.7313540912382331
10496,2015-03-01,00Y,1754,998,2752,0.6373546511627907
10497,2015-03-01,01A,2380,1436,3816,0.6236897274633124
10498,2015-03-01,01C,1124,649,1773,0.6339537507050197
10499,2015-03-01,01D,1418,945,2363,0.6000846381718155
10500,2015-03-01,01E,1024,246,1270,0.8062992125984252
10501,2015-03-01,01F,1008,454,1462,0.6894664842681258
10502,2015-03-01,01G,1317,1331,2648,0.4973564954682779
10503,2015-03-01,01H,2418,970,3388,0.7136953955135773
10504,2015-03-01,01J,1139,532,1671,0.6816277678037104
10505,2015-03-01,01K,2016,1228,3244,0.6214549938347719
10506,2015-03-01,01R,911,605,1516,0.6009234828496042
10507,2015-03-01,01T,777,477,1254,0.6196172248803827
10508,2015-03-01,01V,924,453,1377,0.6710239651416122
10509,2015-03-01,01W,2047,945,2992,0.6841577540106952
10510,2015-03-01,01X,1473,788,2261,0.6514816452896949
10511,2015-03-01,01Y,1045,746,1791,0.5834729201563372
10512,2015-03-01,02A,1284,576,1860,0.6903225806451613
10513,2015-03-01,02D,467,463,930,0.5021505376344086
10514,2015-03-01,02E,1211,679,1890,0.6407407407407407
10515,2015-03-01,02F,1625,688,2313,0.7025507998270644
10516,2015-03-01,02G,636,380,1016,0.6259842519685039
10517,2015-03-01,02H,1578,1576,3154,0.5003170577045022
10518,2015-03-01,02M,1033,503,1536,0.6725260416666666
10519,2015-03-01,02N,1002,713,1715,0.5842565597667638
10520,2015-03-01,02P,1056,1474,2530,0.41739130434782606
10521,2015-03-01,02Q,667,491,1158,0.575993091537133
10522,2015-03-01,02R,2134,1271,3405,0.6267254038179149
10523,2015-03-01,02T,1256,880,2136,0.5880149812734082
10524,2015-03-01,02V,1248,740,1988,0.6277665995975855
10525,2015-03-01,02W,602,344,946,0.6363636363636364
10526,2015-03-01,02X,2003,1000,3003,0.666999666999667
10527,2015-03-01,02Y,2017,977,2994,0.6736806947227789
10528,2015-03-01,03A,1460,806,2266,0.6443071491615181
10529,2015-03-01,03C,1878,1358,3236,0.5803461063040791
10530,2015-03-01,03D,997,478,1475,0.6759322033898305
10531,2015-03-01,03E,897,538,1435,0.6250871080139373
10532,2015-03-01,03F,1708,602,2310,0.7393939393939394
10533,2015-03-01,03G,1574,1063,2637,0.5968904057641259
10534,2015-03-01,03H,1282,513,1795,0.7142061281337048
10535,2015-03-01,03J,1144,631,1775,0.6445070422535212
10536,2015-03-01,03K,976,414,1390,0.702158273381295
10537,2015-03-01,03L,1036,1384,2420,0.428099173553719
10538,2015-03-01,03M,849,447,1296,0.6550925925925926
10539,2015-03-01,03N,3376,1304,4680,0.7213675213675214
10540,2015-03-01,03Q,2057,963,3020,0.6811258278145695
10541,2015-03-01,03R,2528,1386,3914,0.6458865610628512
10542,2015-03-01,03T,1762,884,2646,0.6659108087679516
10543,2015-03-01,03V,455,239,694,0.6556195965417867
10544,2015-03-01,03W,2239,1137,3376,0.6632109004739336
10545,2015-03-01,03X,410,313,723,0.5670816044260027
10546,2015-03-01,03Y,780,402,1182,0.6598984771573604
10547,2015-03-01,04C,2281,822,3103,0.735095069287786
10548,2015-03-01,04D,1421,821,2242,0.6338090990187333
10549,2015-03-01,04E,1188,687,1875,0.6336
10550,2015-03-01,04F,1594,1092,2686,0.5934475055845123
10551,2015-03-01,04G,3995,2534,6529,0.6118854342165723
10552,2015-03-01,04H,735,459,1194,0.6155778894472361
10553,2015-03-01,04J,1890,1208,3098,0.6100710135571337
10554,2015-03-01,04K,1709,989,2698,0.6334321719792438
10555,2015-03-01,04L,883,469,1352,0.6531065088757396
10556,2015-03-01,04M,468,312,780,0.6
10557,2015-03-01,04N,668,363,1031,0.6479146459747818
10558,2015-03-01,04Q,728,468,1196,0.6086956521739131
10559,2015-03-01,04R,2398,1728,4126,0.5811924381968008
10560,2015-03-01,04V,2298,1168,3466,0.6630121177149452
10561,2015-03-01,04X,1342,1174,2516,0.5333863275039745
10562,2015-03-01,04Y,1017,387,1404,0.7243589743589743
10563,2015-03-01,05A,2580,1516,4096,0.6298828125
10564,2015-03-01,05C,1190,1701,2891,0.4116222760290557
10565,2015-03-01,05D,995,477,1472,0.6759510869565217
10566,2015-03-01,05F,1243,716,1959,0.6345074017355794
10567,2015-03-01,05G,1563,643,2206,0.7085222121486854
10568,2015-03-01,05H,1201,599,1800,0.6672222222222223
10569,2015-03-01,05J,1305,684,1989,0.6561085972850679
10570,2015-03-01,05L,2270,1720,3990,0.568922305764411
10571,2015-03-01,05N,2097,1053,3150,0.6657142857142857
10572,2015-03-01,05P,1298,918,2216,0.5857400722021661
10573,2015-03-01,05Q,1477,730,2207,0.6692342546443135
10574,2015-03-01,05R,1757,1198,2955,0.594585448392555
10575,2015-03-01,05T,1993,1192,3185,0.62574568288854
10576,2015-03-01,05V,991,517,1508,0.6571618037135278
10577,2015-03-01,05W,1858,809,2667,0.6966629171353581
10578,2015-03-01,05X,1147,509,1656,0.6926328502415459
10579,2015-03-01,05Y,1999,1005,3004,0.6654460719041279
10580,2015-03-01,06A,1662,772,2434,0.6828266228430567
10581,2015-03-01,06D,907,484,1391,0.6520488856937455
10582,2015-03-01,06F,1604,2484,4088,0.3923679060665362
10583,2015-03-01,06H,5400,2912,8312,0.6496631376323387
10584,2015-03-01,06K,3363,2587,5950,0.5652100840336134
10585,2015-03-01,06L,2418,988,3406,0.7099236641221374
10586,2015-03-01,06M,1817,834,2651,0.6854017351942663
10587,2015-03-01,06N,3245,2296,5541,0.5856343620285147
10588,2015-03-01,06P,879,936,1815,0.484297520661157
10589,2015-03-01,06Q,2275,1244,3519,0.646490480250071
10590,2015-03-01,06T,2172,1353,3525,0.6161702127659574
10591,2015-03-01,06V,1416,695,2111,0.670772145902416
10592,2015-03-01,06W,1406,580,1986,0.7079556898288016
10593,2015-03-01,06Y,1216,658,1874,0.6488794023479189
10594,2015-03-01,07G,937,410,1347,0.6956198960653304
10595,2015-03-01,07H,1725,1111,2836,0.6082510578279267
10596,2015-03-01,07J,956,522,1478,0.6468200270635994
10597,2015-03-01,07K,1467,733,2200,0.6668181818181819
10598,2015-03-01,07L,773,288,1061,0.7285579641847314
10599,2015-03-01,07M,1249,1110,2359,0.5294616362865621
10600,2015-03-01,07N,1436,725,2161,0.6645071726052754
10601,2015-03-01,07P,990,675,1665,0.5945945945945946
10602,2015-03-01,07Q,1550,830,2380,0.6512605042016807
10603,2015-03-01,07R,799,591,1390,0.5748201438848921
10604,2015-03-01,07T,690,574,1264,0.5458860759493671
10605,2015-03-01,07V,1607,744,2351,0.6835389196086772
10606,2015-03-01,07W,1165,906,2071,0.5625301786576533
10607,2015-03-01,07X,1241,694,1935,0.641343669250646
10608,2015-03-01,07Y,948,544,1492,0.6353887399463807
10609,2015-03-01,08A,1185,670,1855,0.6388140161725068
10610,2015-03-01,08C,710,527,1237,0.5739692805173807
10611,2015-03-01,08D,818,588,1406,0.5817923186344239
10612,2015-03-01,08E,844,641,1485,0.5683501683501684
10613,2015-03-01,08F,1528,670,2198,0.6951774340309372
10614,2015-03-01,08G,480,1367,1847,0.2598808879263671
10615,2015-03-01,08H,774,590,1364,0.5674486803519062
10616,2015-03-01,08J,836,426,1262,0.6624405705229794
10617,2015-03-01,08K,1293,567,1860,0.6951612903225807
10618,2015-03-01,08L,638,1226,1864,0.34227467811158796
10619,2015-03-01,08M,1184,576,1760,0.6727272727272727
10620,2015-03-01,08N,1293,525,1818,0.7112211221122112
10621,2015-03-01,08P,902,592,1494,0.6037483266398929
10622,2015-03-01,08Q,941,440,1381,0.6813902968863143
10623,2015-03-01,08R,820,473,1293,0.634184068058778
10624,2015-03-01,08T,992,509,1501,0.6608927381745503
10625,2015-03-01,08V,1001,618,1619,0.6182828906732551
10626,2015-03-01,08W,1016,515,1531,0.6636185499673416
10627,2015-03-01,08X,1291,729,2020,0.6391089108910891
10628,2015-03-01,08Y,674,582,1256,0.5366242038216561
10629,2015-03-01,09A,503,573,1076,0.4674721189591078
10630,2015-03-01,09C,663,483,1146,0.5785340314136126
10631,2015-03-01,09D,1531,988,2519,0.6077808654227869
10632,2015-03-01,09E,1684,787,2471,0.6815054633751517
10633,2015-03-01,09F,1314,647,1961,0.6700662927078022
10634,2015-03-01,09G,3553,1915,5468,0.6497805413313826
10635,2015-03-01,09H,603,358,961,0.627471383975026
10636,2015-03-01,09J,1666,1134,2800,0.595
10637,2015-03-01,09L,863,498,1361,0.6340925789860397
10638,2015-03-01,09N,1117,742,1859,0.6008606777837547
10639,2015-03-01,09P,1134,823,1957,0.5794583546244252
10640,2015-03-01,09W,1287,881,2168,0.5936346863468634
10641,2015-03-01,09X,1132,795,1927,0.5874416190970421
10642,2015-03-01,09Y,1228,1394,2622,0.4683447749809306
10643,2015-03-01,10A,1290,776,2066,0.6243949661181026
10644,2015-03-01,10C,476,304,780,0.6102564102564103
10645,2015-03-01,10D,687,333,1020,0.6735294117647059
10646,2015-03-01,10E,916,370,1286,0.7122861586314152
10647,2015-03-01,10G,692,398,1090,0.634862385321101
10648,2015-03-01,10H,1930,1438,3368,0.5730403800475059
10649,2015-03-01,10J,1089,883,1972,0.5522312373225152
10650,2015-03-01,10K,1330,690,2020,0.6584158415841584
10651,2015-03-01,10L,1014,412,1426,0.7110799438990182
10652,2015-03-01,10M,528,466,994,0.5311871227364185
10653,2015-03-01,10N,424,464,888,0.4774774774774775
10654,2015-03-01,10Q,3465,3121,6586,0.5261160036440935
10655,2015-03-01,10R,1378,537,1915,0.7195822454308094
10656,2015-03-01,10T,636,354,990,0.6424242424242425
10657,2015-03-01,10V,1388,768,2156,0.6437847866419295
10658,2015-03-01,10W,593,446,1039,0.5707410972088547
10659,2015-03-01,10X,1252,698,1950,0.642051282051282
10660,2015-03-01,10Y,1281,1001,2282,0.5613496932515337
10661,2015-03-01,11A,3437,1842,5279,0.6510702784618299
10662,2015-03-01,11C,893,397,1290,0.6922480620155039
10663,2015-03-01,11D,624,631,1255,0.49721115537848604
10664,2015-03-01,11E,1138,891,2029,0.5608674223755544
10665,2015-03-01,11H,2566,1606,4172,0.6150527325023969
10666,2015-03-01,11J,5445,2551,7996,0.6809654827413707
10667,2015-03-01,11M,3949,2134,6083,0.6491862567811935
10668,2015-03-01,11N,4228,1812,6040,0.7
10669,2015-03-01,11T,1570,915,2485,0.6317907444668008
10670,2015-03-01,11X,3533,1985,5518,0.6402682131206959
10671,2015-03-01,12A,1585,717,2302,0.6885317115551695
10672,2015-03-01,12D,1111,925,2036,0.5456777996070727
10673,2015-03-01,12F,2340,796,3136,0.7461734693877551
10674,2015-03-01,13P,3065,2202,5267,0.5819251946079362
10675,2015-03-01,13T,3167,1636,4803,0.6593795544451384
10676,2015-03-01,14L,3134,1878,5012,0.6252992817238627
10677,2015-03-01,99A,2956,1317,4273,0.6917856307044231
10678,2015-03-01,99C,1516,914,2430,0.6238683127572017
10679,2015-03-01,99D,1025,886,1911,0.5363683935112507
10680,2015-03-01,99E,1580,652,2232,0.7078853046594982
10681,2015-03-01,99F,1044,413,1457,0.7165408373369938
10682,2015-03-01,99G,1203,375,1578,0.7623574144486692
10683,2015-03-01,99H,1613,967,2580,0.6251937984496124
10684,2015-03-01,99J,2801,1794,4595,0.609575625680087
10685,2015-03-01,99K,1031,740,1771,0.5821569734613213
10686,2015-03-01,99M,1124,949,2073,0.5422093584177521
10687,2015-03-01,99N,2591,2697,5288,0.48997730711043874
10688,2015-03-01,99P,6573,2649,9222,0.7127521145087834
10689,2015-03-01,99Q,1930,998,2928,0.6591530054644809
10690,2015-04-01,00C,743,309,1052,0.7062737642585551
10691,2015-04-01,00D,2285,1090,3375,0.677037037037037
10692,2015-04-01,00J,1669,775,2444,0.6828968903436988
10693,2015-04-01,00K,2074,1086,3160,0.6563291139240506
10694,2015-04-01,00L,2113,1246,3359,0.6290562667460554
10695,2015-04-01,00M,2113,1027,3140,0.6729299363057325
10696,2015-04-01,00N,1125,603,1728,0.6510416666666666
10697,2015-04-01,00P,1934,755,2689,0.7192264782447007
10698,2015-04-01,00Q,920,410,1330,0.6917293233082706
10699,2015-04-01,00R,1086,578,1664,0.6526442307692307
10700,2015-04-01,00T,1802,1113,2915,0.6181818181818182
10701,2015-04-01,00V,1271,866,2137,0.5947590079550772
10702,2015-04-01,00W,1,0,1,1.0
10703,2015-04-01,00X,949,324,1273,0.7454831107619796
10704,2015-04-01,00Y,1719,1021,2740,0.6273722627737226
10705,2015-04-01,01A,2185,1309,3494,0.6253577561534058
10706,2015-04-01,01C,1004,611,1615,0.621671826625387
10707,2015-04-01,01D,1295,800,2095,0.6181384248210023
10708,2015-04-01,01E,955,212,1167,0.818337617823479
10709,2015-04-01,01F,911,395,1306,0.6975497702909648
10710,2015-04-01,01G,1215,1259,2474,0.4911075181891673
10711,2015-04-01,01H,2380,893,3273,0.7271616254201039
10712,2015-04-01,01J,1039,499,1538,0.6755526657997399
10713,2015-04-01,01K,2028,1184,3212,0.6313823163138231
10714,2015-04-01,01R,938,581,1519,0.6175115207373272
10715,2015-04-01,01T,740,446,1186,0.6239460370994941
10716,2015-04-01,01V,825,433,1258,0.6558028616852146
10717,2015-04-01,01W,2023,953,2976,0.6797715053763441
10718,2015-04-01,01X,1366,750,2116,0.6455576559546313
10719,2015-04-01,01Y,938,942,1880,0.498936170212766
10720,2015-04-01,02A,1242,557,1799,0.6903835464146748
10721,2015-04-01,02D,480,411,891,0.5387205387205387
10722,2015-04-01,02E,1103,691,1794,0.6148272017837235
10723,2015-04-01,02F,1429,658,2087,0.6847149017728797
10724,2015-04-01,02G,615,322,937,0.656350053361793
10725,2015-04-01,02H,1438,1476,2914,0.4934797529169526
10726,2015-04-01,02M,977,442,1419,0.6885130373502466
10727,2015-04-01,02N,1010,600,1610,0.6273291925465838
10728,2015-04-01,02P,1044,1336,2380,0.43865546218487395
10729,2015-04-01,02Q,624,433,1057,0.5903500473036897
10730,2015-04-01,02R,2060,1153,3213,0.6411453470277
10731,2015-04-01,02T,1120,777,1897,0.5904059040590406
10732,2015-04-01,02V,1227,711,1938,0.6331269349845201
10733,2015-04-01,02W,531,302,833,0.6374549819927972
10734,2015-04-01,02X,1985,912,2897,0.6851915774939593
10735,2015-04-01,02Y,1881,880,2761,0.6812749003984063
10736,2015-04-01,03A,1267,752,2019,0.6275383853392769
10737,2015-04-01,03C,1611,1246,2857,0.5638781939096955
10738,2015-04-01,03D,846,391,1237,0.6839126919967664
10739,2015-04-01,03E,819,476,1295,0.6324324324324324
10740,2015-04-01,03F,1659,612,2271,0.7305151915455746
10741,2015-04-01,03G,1344,923,2267,0.5928539920599912
10742,2015-04-01,03H,1243,445,1688,0.7363744075829384
10743,2015-04-01,03J,1105,574,1679,0.658129839189994
10744,2015-04-01,03K,869,382,1251,0.6946442845723422
10745,2015-04-01,03L,892,1257,2149,0.4150767798976268
10746,2015-04-01,03M,773,368,1141,0.677475898334794
10747,2015-04-01,03N,3203,1209,4412,0.7259746146872167
10748,2015-04-01,03Q,1827,1018,2845,0.6421792618629174
10749,2015-04-01,03R,2314,1387,3701,0.6252364225884895
10750,2015-04-01,03T,1617,829,2446,0.66107931316435
10751,2015-04-01,03V,444,245,689,0.6444121915820029
10752,2015-04-01,03W,2017,1047,3064,0.658289817232376
10753,2015-04-01,03X,411,277,688,0.5973837209302325
10754,2015-04-01,03Y,708,390,1098,0.644808743169399
10755,2015-04-01,04C,1940,817,2757,0.7036634022488212
10756,2015-04-01,04D,1294,766,2060,0.6281553398058253
10757,2015-04-01,04E,1089,692,1781,0.6114542391914655
10758,2015-04-01,04F,1389,1048,2437,0.5699630693475585
10759,2015-04-01,04G,4054,2408,6462,0.6273599504797276
10760,2015-04-01,04H,628,420,1048,0.5992366412213741
10761,2015-04-01,04J,1768,1238,3006,0.5881570192947438
10762,2015-04-01,04K,1537,857,2394,0.6420217209690894
10763,2015-04-01,04L,696,449,1145,0.6078602620087337
10764,2015-04-01,04M,463,274,737,0.6282225237449118
10765,2015-04-01,04N,560,318,878,0.6378132118451025
10766,2015-04-01,04Q,700,459,1159,0.6039689387402933
10767,2015-04-01,04R,2122,1561,3683,0.5761607385283736
10768,2015-04-01,04V,2191,1061,3252,0.673739237392374
10769,2015-04-01,04X,1204,1075,2279,0.5283018867924528
10770,2015-04-01,04Y,952,371,1323,0.7195767195767195
10771,2015-04-01,05A,2316,1454,3770,0.6143236074270557
10772,2015-04-01,05C,1208,1588,2796,0.43204577968526464
10773,2015-04-01,05D,976,427,1403,0.6956521739130435
10774,2015-04-01,05F,1138,790,1928,0.5902489626556017
10775,2015-04-01,05G,1480,617,2097,0.7057701478302336
10776,2015-04-01,05H,1025,560,1585,0.6466876971608833
10777,2015-04-01,05J,1321,663,1984,0.6658266129032258
10778,2015-04-01,05L,2180,1604,3784,0.5761099365750528
10779,2015-04-01,05N,2035,992,3027,0.6722827882391808
10780,2015-04-01,05P,1180,795,1975,0.5974683544303797
10781,2015-04-01,05Q,1320,685,2005,0.6583541147132169
10782,2015-04-01,05R,1651,1109,2760,0.5981884057971014
10783,2015-04-01,05T,1902,1132,3034,0.6268951878707977
10784,2015-04-01,05V,935,453,1388,0.6736311239193083
10785,2015-04-01,05W,1692,738,2430,0.6962962962962963
10786,2015-04-01,05X,1033,408,1441,0.7168632893823733
10787,2015-04-01,05Y,1744,969,2713,0.6428308145963878
10788,2015-04-01,06A,1450,721,2171,0.6678949792722247
10789,2015-04-01,06D,823,436,1259,0.653693407466243
10790,2015-04-01,06F,1505,2289,3794,0.3966789667896679
10791,2015-04-01,06H,5075,2776,7851,0.6464144694943319
10792,2015-04-01,06K,3188,2593,5781,0.5514616848296142
10793,2015-04-01,06L,2365,968,3333,0.7095709570957096
10794,2015-04-01,06M,1652,814,2466,0.6699107866991079
10795,2015-04-01,06N,3033,2324,5357,0.5661750980026135
10796,2015-04-01,06P,827,876,1703,0.48561362301820316
10797,2015-04-01,06Q,2100,1107,3207,0.6548175865294668
10798,2015-04-01,06T,1989,1322,3311,0.60072485653881
10799,2015-04-01,06V,1304,607,1911,0.6823652537938252
10800,2015-04-01,06W,1319,578,1897,0.6953083816552451
10801,2015-04-01,06Y,1105,624,1729,0.6390977443609023
10802,2015-04-01,07G,857,356,1213,0.7065127782357791
10803,2015-04-01,07H,1555,1023,2578,0.6031807602792862
10804,2015-04-01,07J,831,518,1349,0.6160118606375092
10805,2015-04-01,07K,1425,669,2094,0.6805157593123209
10806,2015-04-01,07L,655,331,986,0.6643002028397565
10807,2015-04-01,07M,1219,1019,2238,0.5446827524575514
10808,2015-04-01,07N,1313,652,1965,0.6681933842239186
10809,2015-04-01,07P,825,568,1393,0.5922469490308686
10810,2015-04-01,07Q,1615,814,2429,0.6648826677645121
10811,2015-04-01,07R,650,558,1208,0.5380794701986755
10812,2015-04-01,07T,624,556,1180,0.5288135593220339
10813,2015-04-01,07V,1662,849,2511,0.6618876941457587
10814,2015-04-01,07W,1034,811,1845,0.5604336043360434
10815,2015-04-01,07X,1153,720,1873,0.6155899626268019
10816,2015-04-01,07Y,906,515,1421,0.6375791695988741
10817,2015-04-01,08A,1032,618,1650,0.6254545454545455
10818,2015-04-01,08C,593,471,1064,0.5573308270676691
10819,2015-04-01,08D,713,531,1244,0.5731511254019293
10820,2015-04-01,08E,824,617,1441,0.5718251214434421
10821,2015-04-01,08F,1280,672,1952,0.6557377049180327
10822,2015-04-01,08G,461,1174,1635,0.2819571865443425
10823,2015-04-01,08H,734,592,1326,0.5535444947209653
10824,2015-04-01,08J,877,442,1319,0.6648976497346475
10825,2015-04-01,08K,1086,528,1614,0.6728624535315985
10826,2015-04-01,08L,691,1210,1901,0.3634928984744871
10827,2015-04-01,08M,1099,481,1580,0.6955696202531646
10828,2015-04-01,08N,1184,473,1657,0.7145443572721787
10829,2015-04-01,08P,879,580,1459,0.6024674434544208
10830,2015-04-01,08Q,845,420,1265,0.6679841897233202
10831,2015-04-01,08R,841,435,1276,0.6590909090909091
10832,2015-04-01,08T,926,510,1436,0.6448467966573816
10833,2015-04-01,08V,955,547,1502,0.6358189081225033
10834,2015-04-01,08W,983,501,1484,0.6623989218328841
10835,2015-04-01,08X,1134,682,1816,0.6244493392070485
10836,2015-04-01,08Y,621,528,1149,0.5404699738903395
10837,2015-04-01,09A,488,527,1015,0.4807881773399015
10838,2015-04-01,09C,650,504,1154,0.5632582322357019
10839,2015-04-01,09D,1295,885,2180,0.5940366972477065
10840,2015-04-01,09E,1500,742,2242,0.6690454950936664
10841,2015-04-01,09F,1174,633,1807,0.6496956281128943
10842,2015-04-01,09G,3435,1715,5150,0.6669902912621359
10843,2015-04-01,09H,579,355,934,0.619914346895075
10844,2015-04-01,09J,1526,959,2485,0.6140845070422535
10845,2015-04-01,09L,756,514,1270,0.5952755905511811
10846,2015-04-01,09N,978,665,1643,0.5952525867315885
10847,2015-04-01,09P,1008,801,1809,0.5572139303482587
10848,2015-04-01,09W,1226,770,1996,0.6142284569138277
10849,2015-04-01,09X,902,705,1607,0.5612943372744243
10850,2015-04-01,09Y,1301,1272,2573,0.5056354450058298
10851,2015-04-01,10A,1208,748,1956,0.6175869120654397
10852,2015-04-01,10C,407,343,750,0.5426666666666666
10853,2015-04-01,10D,616,280,896,0.6875
10854,2015-04-01,10E,795,374,1169,0.6800684345594525
10855,2015-04-01,10G,634,361,995,0.6371859296482412
10856,2015-04-01,10H,1779,1300,3079,0.5777849951282884
10857,2015-04-01,10J,983,896,1879,0.5231506120276743
10858,2015-04-01,10K,1215,562,1777,0.6837366347777153
10859,2015-04-01,10L,922,332,1254,0.7352472089314195
10860,2015-04-01,10M,405,411,816,0.4963235294117647
10861,2015-04-01,10N,413,403,816,0.5061274509803921
10862,2015-04-01,10Q,3030,2874,5904,0.5132113821138211
10863,2015-04-01,10R,1315,500,1815,0.7245179063360881
10864,2015-04-01,10T,586,310,896,0.6540178571428571
10865,2015-04-01,10V,1311,663,1974,0.6641337386018237
10866,2015-04-01,10W,524,384,908,0.5770925110132159
10867,2015-04-01,10X,1038,621,1659,0.6256781193490054
10868,2015-04-01,10Y,1144,900,2044,0.5596868884540117
10869,2015-04-01,11A,3112,1696,4808,0.6472545757071547
10870,2015-04-01,11C,774,399,1173,0.659846547314578
10871,2015-04-01,11D,564,520,1084,0.5202952029520295
10872,2015-04-01,11E,1101,915,2016,0.5461309523809523
10873,2015-04-01,11H,2427,1451,3878,0.6258380608561114
10874,2015-04-01,11J,4993,2253,7246,0.6890698316312448
10875,2015-04-01,11M,3586,1938,5524,0.6491672700941347
10876,2015-04-01,11N,3891,1673,5564,0.6993170381020848
10877,2015-04-01,11T,1479,865,2344,0.6309726962457338
10878,2015-04-01,11X,3240,1982,5222,0.6204519341248563
10879,2015-04-01,12A,1481,701,2182,0.6787351054078826
10880,2015-04-01,12D,1125,911,2036,0.5525540275049116
10881,2015-04-01,12F,2112,705,2817,0.7497337593184239
10882,2015-04-01,13P,2965,1992,4957,0.5981440387331047
10883,2015-04-01,13T,3031,1537,4568,0.6635288966725044
10884,2015-04-01,14L,2913,1737,4650,0.6264516129032258
10885,2015-04-01,99A,2726,1135,3861,0.7060347060347061
10886,2015-04-01,99C,1444,790,2234,0.6463742166517458
10887,2015-04-01,99D,997,806,1803,0.5529672767609539
10888,2015-04-01,99E,1423,597,2020,0.7044554455445544
10889,2015-04-01,99F,1008,375,1383,0.7288503253796096
10890,2015-04-01,99G,1138,427,1565,0.7271565495207668
10891,2015-04-01,99H,1511,979,2490,0.6068273092369478
10892,2015-04-01,99J,2696,1692,4388,0.6144029170464904
10893,2015-04-01,99K,956,727,1683,0.5680332739156269
10894,2015-04-01,99M,1026,949,1975,0.5194936708860759
10895,2015-04-01,99N,2396,2524,4920,0.4869918699186992
10896,2015-04-01,99P,6085,2383,8468,0.7185876239962211
10897,2015-04-01,99Q,1769,896,2665,0.6637898686679174
10898,2015-05-01,00C,756,336,1092,0.6923076923076923
10899,2015-05-01,00D,2289,1029,3318,0.689873417721519
10900,2015-05-01,00J,1714,782,2496,0.686698717948718
10901,2015-05-01,00K,1943,1030,2973,0.653548604103599
10902,2015-05-01,00L,2001,1262,3263,0.6132393502911431
10903,2015-05-01,00M,2014,1035,3049,0.6605444408002624
10904,2015-05-01,00N,1034,540,1574,0.6569250317662008
10905,2015-05-01,00P,2006,758,2764,0.7257597684515196
10906,2015-05-01,00Q,895,437,1332,0.6719219219219219
10907,2015-05-01,00R,1017,659,1676,0.6068019093078759
10908,2015-05-01,00T,1704,1092,2796,0.6094420600858369
10909,2015-05-01,00V,1235,908,2143,0.5762949136724218
10910,2015-05-01,00X,954,309,1263,0.7553444180522565
10911,2015-05-01,00Y,1737,1080,2817,0.6166134185303515
10912,2015-05-01,01A,2264,1362,3626,0.6243794815223387
10913,2015-05-01,01C,1048,646,1694,0.6186540731995277
10914,2015-05-01,01D,1252,846,2098,0.5967588179218303
10915,2015-05-01,01E,908,242,1150,0.7895652173913044
10916,2015-05-01,01F,876,421,1297,0.6754047802621435
10917,2015-05-01,01G,1235,1200,2435,0.5071868583162218
10918,2015-05-01,01H,2364,923,3287,0.7191968360206875
10919,2015-05-01,01J,1024,519,1543,0.6636422553467272
10920,2015-05-01,01K,2081,1176,3257,0.6389315320847405
10921,2015-05-01,01R,837,606,1443,0.58004158004158
10922,2015-05-01,01T,711,453,1164,0.6108247422680413
10923,2015-05-01,01V,727,371,1098,0.6621129326047359
10924,2015-05-01,01W,1936,934,2870,0.6745644599303136
10925,2015-05-01,01X,1263,699,1962,0.6437308868501529
10926,2015-05-01,01Y,672,1141,1813,0.37065637065637064
10927,2015-05-01,02A,1172,536,1708,0.6861826697892272
10928,2015-05-01,02D,439,401,840,0.5226190476190476
10929,2015-05-01,02E,1076,641,1717,0.6266744321490972
10930,2015-05-01,02F,1278,892,2170,0.5889400921658986
10931,2015-05-01,02G,642,319,961,0.668054110301769
10932,2015-05-01,02H,1434,1395,2829,0.5068928950159067
10933,2015-05-01,02M,954,469,1423,0.6704146170063247
10934,2015-05-01,02N,864,574,1438,0.6008344923504868
10935,2015-05-01,02P,1030,1302,2332,0.44168096054888506
10936,2015-05-01,02Q,651,427,1078,0.6038961038961039
10937,2015-05-01,02R,1954,1050,3004,0.6504660452729694
10938,2015-05-01,02T,1158,757,1915,0.6046997389033942
10939,2015-05-01,02V,1155,848,2003,0.5766350474288567
10940,2015-05-01,02W,536,309,845,0.6343195266272189
10941,2015-05-01,02X,1863,915,2778,0.6706263498920086
10942,2015-05-01,02Y,1849,943,2792,0.6622492836676218
10943,2015-05-01,03A,1288,735,2023,0.6366782006920415
10944,2015-05-01,03C,1517,1295,2812,0.5394736842105263
10945,2015-05-01,03D,914,421,1335,0.6846441947565544
10946,2015-05-01,03E,856,490,1346,0.6359583952451708
10947,2015-05-01,03F,1631,658,2289,0.7125382262996942
10948,2015-05-01,03G,1263,1035,2298,0.5496083550913838
10949,2015-05-01,03H,1163,466,1629,0.7139349294045426
10950,2015-05-01,03J,1048,516,1564,0.670076726342711
10951,2015-05-01,03K,820,408,1228,0.6677524429967426
10952,2015-05-01,03L,923,1334,2257,0.40894993354009745
10953,2015-05-01,03M,728,401,1129,0.6448184233835252
10954,2015-05-01,03N,2972,1191,4163,0.7139082392505405
10955,2015-05-01,03Q,1937,898,2835,0.6832451499118166
10956,2015-05-01,03R,2214,1275,3489,0.6345657781599312
10957,2015-05-01,03T,1611,723,2334,0.6902313624678663
10958,2015-05-01,03V,411,236,647,0.6352395672333848
10959,2015-05-01,03W,2160,1065,3225,0.6697674418604651
10960,2015-05-01,03X,375,269,644,0.5822981366459627
10961,2015-05-01,03Y,666,388,1054,0.6318785578747628
10962,2015-05-01,04C,1892,729,2621,0.7218618847768028
10963,2015-05-01,04D,1261,725,1986,0.634944612286002
10964,2015-05-01,04E,1016,676,1692,0.6004728132387707
10965,2015-05-01,04F,1339,965,2304,0.5811631944444444
10966,2015-05-01,04G,3923,2311,6234,0.6292909849213988
10967,2015-05-01,04H,637,428,1065,0.5981220657276995
10968,2015-05-01,04J,1735,1216,2951,0.5879362927821078
10969,2015-05-01,04K,1488,915,2403,0.6192259675405742
10970,2015-05-01,04L,785,404,1189,0.6602186711522288
10971,2015-05-01,04M,428,269,697,0.6140602582496413
10972,2015-05-01,04N,558,344,902,0.6186252771618626
10973,2015-05-01,04Q,704,464,1168,0.6027397260273972
10974,2015-05-01,04R,2061,1552,3613,0.5704400774979241
10975,2015-05-01,04V,2069,1019,3088,0.6700129533678757
10976,2015-05-01,04X,1212,1123,2335,0.5190578158458244
10977,2015-05-01,04Y,918,382,1300,0.7061538461538461
10978,2015-05-01,05A,2351,1477,3828,0.614158829676071
10979,2015-05-01,05C,1188,1524,2712,0.43805309734513276
10980,2015-05-01,05D,892,451,1343,0.6641846612062546
10981,2015-05-01,05F,1136,748,1884,0.6029723991507431
10982,2015-05-01,05G,1519,587,2106,0.7212725546058879
10983,2015-05-01,05H,1027,572,1599,0.6422764227642277
10984,2015-05-01,05J,1279,543,1822,0.7019758507135017
10985,2015-05-01,05L,2136,1669,3805,0.5613666228646518
10986,2015-05-01,05N,1972,872,2844,0.6933895921237694
10987,2015-05-01,05P,1159,823,1982,0.5847628657921292
10988,2015-05-01,05Q,1281,703,1984,0.6456653225806451
10989,2015-05-01,05R,1625,1091,2716,0.5983063328424153
10990,2015-05-01,05T,1828,1148,2976,0.614247311827957
10991,2015-05-01,05V,892,450,1342,0.6646795827123696
10992,2015-05-01,05W,1728,730,2458,0.7030105777054516
10993,2015-05-01,05X,1062,462,1524,0.6968503937007874
10994,2015-05-01,05Y,1759,981,2740,0.641970802919708
10995,2015-05-01,06A,1561,727,2288,0.6822552447552448
10996,2015-05-01,06D,767,395,1162,0.6600688468158348
10997,2015-05-01,06F,1554,2239,3793,0.40970208278407594
10998,2015-05-01,06H,4966,2777,7743,0.6413534805630893
10999,2015-05-01,06K,3062,2527,5589,0.5478618715333691
11000,2015-05-01,06L,2257,881,3138,0.7192479286169535
11001,2015-05-01,06M,1573,839,2412,0.6521558872305141
11002,2015-05-01,06N,2994,2261,5255,0.5697431018078021
11003,2015-05-01,06P,863,919,1782,0.48428731762065097
11004,2015-05-01,06Q,2135,1122,3257,0.6555112066318698
11005,2015-05-01,06T,1949,1312,3261,0.5976694265562711
11006,2015-05-01,06V,1255,638,1893,0.6629688325409403
11007,2015-05-01,06W,1386,617,2003,0.6919620569146281
11008,2015-05-01,06Y,1139,565,1704,0.6684272300469484
11009,2015-05-01,07G,834,335,1169,0.7134302822925578
11010,2015-05-01,07H,1597,1072,2669,0.5983514424878231
11011,2015-05-01,07J,829,484,1313,0.6313785224676314
11012,2015-05-01,07K,1384,626,2010,0.6885572139303483
11013,2015-05-01,07L,661,332,993,0.6656596173212488
11014,2015-05-01,07M,1167,970,2137,0.5460926532522228
11015,2015-05-01,07N,1303,712,2015,0.6466501240694789
11016,2015-05-01,07P,823,620,1443,0.5703395703395704
11017,2015-05-01,07Q,1444,769,2213,0.6525079078174424
11018,2015-05-01,07R,681,546,1227,0.5550122249388753
11019,2015-05-01,07T,649,575,1224,0.5302287581699346
11020,2015-05-01,07V,1716,754,2470,0.6947368421052632
11021,2015-05-01,07W,1048,812,1860,0.5634408602150538
11022,2015-05-01,07X,1110,621,1731,0.6412478336221837
11023,2015-05-01,07Y,903,511,1414,0.6386138613861386
11024,2015-05-01,08A,978,582,1560,0.6269230769230769
11025,2015-05-01,08C,605,535,1140,0.5307017543859649
11026,2015-05-01,08D,744,567,1311,0.5675057208237986
11027,2015-05-01,08E,780,657,1437,0.5427974947807933
11028,2015-05-01,08F,1309,627,1936,0.6761363636363636
11029,2015-05-01,08G,434,1179,1613,0.2690638561686299
11030,2015-05-01,08H,641,572,1213,0.528441879637263
11031,2015-05-01,08J,800,402,1202,0.6655574043261231
11032,2015-05-01,08K,1082,561,1643,0.6585514303104077
11033,2015-05-01,08L,689,1289,1978,0.3483316481294237
11034,2015-05-01,08M,1019,500,1519,0.6708360763660303
11035,2015-05-01,08N,1122,511,1633,0.6870789957134109
11036,2015-05-01,08P,876,542,1418,0.6177715091678421
11037,2015-05-01,08Q,853,404,1257,0.6785998408910103
11038,2015-05-01,08R,867,409,1276,0.6794670846394985
11039,2015-05-01,08T,883,475,1358,0.6502209131075111
11040,2015-05-01,08V,971,567,1538,0.6313394018205462
11041,2015-05-01,08W,999,594,1593,0.6271186440677966
11042,2015-05-01,08X,1221,778,1999,0.6108054027013506
11043,2015-05-01,08Y,558,530,1088,0.5128676470588235
11044,2015-05-01,09A,487,557,1044,0.4664750957854406
11045,2015-05-01,09C,602,487,1089,0.5528007346189164
11046,2015-05-01,09D,1393,973,2366,0.5887573964497042
11047,2015-05-01,09E,1430,706,2136,0.6694756554307116
11048,2015-05-01,09F,1209,653,1862,0.6493018259935553
11049,2015-05-01,09G,3318,1730,5048,0.6572900158478605
11050,2015-05-01,09H,559,321,880,0.6352272727272728
11051,2015-05-01,09J,1593,1019,2612,0.6098774885145483
11052,2015-05-01,09L,833,530,1363,0.6111518708730741
11053,2015-05-01,09N,980,706,1686,0.5812574139976275
11054,2015-05-01,09P,1029,790,1819,0.565695437053326
11055,2015-05-01,09W,1247,781,2028,0.6148915187376726
11056,2015-05-01,09X,893,729,1622,0.5505548705302096
11057,2015-05-01,09Y,1203,1297,2500,0.4812
11058,2015-05-01,10A,1129,701,1830,0.6169398907103825
11059,2015-05-01,10C,418,293,711,0.5879043600562588
11060,2015-05-01,10D,610,274,884,0.6900452488687783
11061,2015-05-01,10E,781,390,1171,0.6669513236549958
11062,2015-05-01,10G,644,396,1040,0.6192307692307693
11063,2015-05-01,10H,1787,1272,3059,0.584177835894083
11064,2015-05-01,10J,1002,867,1869,0.536115569823435
11065,2015-05-01,10K,1281,603,1884,0.6799363057324841
11066,2015-05-01,10L,873,364,1237,0.7057396928051738
11067,2015-05-01,10M,481,442,923,0.5211267605633803
11068,2015-05-01,10N,406,394,800,0.5075
11069,2015-05-01,10Q,3078,2797,5875,0.5239148936170213
11070,2015-05-01,10R,1342,504,1846,0.7269772481040087
11071,2015-05-01,10T,594,302,896,0.6629464285714286
11072,2015-05-01,10V,1211,681,1892,0.6400634249471459
11073,2015-05-01,10W,530,397,927,0.5717367853290184
11074,2015-05-01,10X,1063,636,1699,0.6256621542083579
11075,2015-05-01,10Y,1191,834,2025,0.5881481481481482
11076,2015-05-01,11A,3208,1624,4832,0.6639072847682119
11077,2015-05-01,11C,826,408,1234,0.6693679092382496
11078,2015-05-01,11D,596,555,1151,0.5178105994787141
11079,2015-05-01,11E,1078,921,1999,0.5392696348174087
11080,2015-05-01,11H,2518,1420,3938,0.6394108684611478
11081,2015-05-01,11J,4744,2266,7010,0.6767475035663338
11082,2015-05-01,11M,3609,1875,5484,0.6580962800875274
11083,2015-05-01,11N,3832,1631,5463,0.7014460918909025
11084,2015-05-01,11T,1470,863,2333,0.6300900128589798
11085,2015-05-01,11X,3096,1908,5004,0.6187050359712231
11086,2015-05-01,12A,1354,667,2021,0.6699653636813458
11087,2015-05-01,12D,1096,856,1952,0.5614754098360656
11088,2015-05-01,12F,2151,705,2856,0.7531512605042017
11089,2015-05-01,13P,2905,2140,5045,0.5758176412289395
11090,2015-05-01,13T,2883,1497,4380,0.6582191780821918
11091,2015-05-01,14L,2721,1834,4555,0.5973655323819979
11092,2015-05-01,99A,2666,1156,3822,0.6975405546834118
11093,2015-05-01,99C,1410,793,2203,0.640036314117113
11094,2015-05-01,99D,936,738,1674,0.5591397849462365
11095,2015-05-01,99E,1397,590,1987,0.7030699547055863
11096,2015-05-01,99F,966,376,1342,0.7198211624441133
11097,2015-05-01,99G,1066,382,1448,0.7361878453038674
11098,2015-05-01,99H,1365,940,2305,0.5921908893709328
11099,2015-05-01,99J,2670,1720,4390,0.6082004555808656
11100,2015-05-01,99K,835,691,1526,0.5471821756225426
11101,2015-05-01,99M,968,872,1840,0.5260869565217391
11102,2015-05-01,99N,2570,2555,5125,0.5014634146341463
11103,2015-05-01,99P,5869,2341,8210,0.7148599269183922
11104,2015-05-01,99Q,1690,887,2577,0.6558013193636011
11105,2015-06-01,00C,832,320,1152,0.7222222222222222
11106,2015-06-01,00D,2322,1108,3430,0.6769679300291546
11107,2015-06-01,00J,1780,847,2627,0.6775789874381424
11108,2015-06-01,00K,2101,1011,3112,0.6751285347043702
11109,2015-06-01,00L,2078,1305,3383,0.6142477091339048
11110,2015-06-01,00M,2263,1113,3376,0.6703199052132701
11111,2015-06-01,00N,1109,603,1712,0.6477803738317757
11112,2015-06-01,00P,2068,904,2972,0.6958277254374159
11113,2015-06-01,00Q,949,470,1419,0.6687808315715292
11114,2015-06-01,00R,1078,698,1776,0.6069819819819819
11115,2015-06-01,00T,1799,1137,2936,0.6127384196185286
11116,2015-06-01,00V,1316,935,2251,0.5846290537538872
11117,2015-06-01,00W,1,0,1,1.0
11118,2015-06-01,00X,995,311,1306,0.7618683001531393
11119,2015-06-01,00Y,1739,1154,2893,0.6011061182163844
11120,2015-06-01,01A,2324,1356,3680,0.6315217391304347
11121,2015-06-01,01C,990,652,1642,0.6029232643118149
11122,2015-06-01,01D,1336,950,2286,0.584426946631671
11123,2015-06-01,01E,926,266,1192,0.7768456375838926
11124,2015-06-01,01F,903,451,1354,0.6669128508124077
11125,2015-06-01,01G,1220,1295,2515,0.4850894632206759
11126,2015-06-01,01H,2310,976,3286,0.7029823493609252
11127,2015-06-01,01J,1118,509,1627,0.6871542716656422
11128,2015-06-01,01K,2038,1225,3263,0.6245786086423537
11129,2015-06-01,01R,937,656,1593,0.5881983678593848
11130,2015-06-01,01T,795,518,1313,0.6054836252856055
11131,2015-06-01,01V,842,439,1281,0.6572989851678376
11132,2015-06-01,01W,2063,982,3045,0.677504105090312
11133,2015-06-01,01X,1385,779,2164,0.640018484288355
11134,2015-06-01,01Y,683,1241,1924,0.35498960498960497
11135,2015-06-01,02A,1290,631,1921,0.6715252472670484
11136,2015-06-01,02D,461,444,905,0.5093922651933702
11137,2015-06-01,02E,1183,685,1868,0.6332976445396146
11138,2015-06-01,02F,1212,1043,2255,0.5374722838137472
11139,2015-06-01,02G,647,356,1003,0.6450648055832503
11140,2015-06-01,02H,1500,1522,3022,0.49636002647253474
11141,2015-06-01,02M,1006,462,1468,0.6852861035422343
11142,2015-06-01,02N,1011,644,1655,0.6108761329305136
11143,2015-06-01,02P,1056,1463,2519,0.4192139737991266
11144,2015-06-01,02Q,646,450,1096,0.5894160583941606
11145,2015-06-01,02R,2215,1281,3496,0.6335812356979404
11146,2015-06-01,02T,1109,787,1896,0.584915611814346
11147,2015-06-01,02V,885,992,1877,0.4714970697922216
11148,2015-06-01,02W,554,366,920,0.6021739130434782
11149,2015-06-01,02X,1834,895,2729,0.6720410406742396
11150,2015-06-01,02Y,1956,881,2837,0.6894606979203384
11151,2015-06-01,03A,1374,821,2195,0.6259681093394077
11152,2015-06-01,03C,1536,1352,2888,0.5318559556786704
11153,2015-06-01,03D,945,448,1393,0.678391959798995
11154,2015-06-01,03E,893,574,1467,0.6087252897068848
11155,2015-06-01,03F,1782,672,2454,0.726161369193154
11156,2015-06-01,03G,1361,1263,2624,0.5186737804878049
11157,2015-06-01,03H,1329,506,1835,0.7242506811989101
11158,2015-06-01,03J,1181,590,1771,0.6668548842461886
11159,2015-06-01,03K,916,427,1343,0.6820551005212211
11160,2015-06-01,03L,910,1381,2291,0.3972064600611087
11161,2015-06-01,03M,817,415,1232,0.6631493506493507
11162,2015-06-01,03N,3377,1280,4657,0.725144943096414
11163,2015-06-01,03Q,1882,996,2878,0.6539263377345379
11164,2015-06-01,03R,2399,1409,3808,0.6299894957983193
11165,2015-06-01,03T,1785,817,2602,0.686010760953113
11166,2015-06-01,03V,437,278,715,0.6111888111888112
11167,2015-06-01,03W,2118,1090,3208,0.6602244389027432
11168,2015-06-01,03X,402,283,685,0.5868613138686132
11169,2015-06-01,03Y,738,410,1148,0.6428571428571429
11170,2015-06-01,04C,2049,732,2781,0.7367853290183387
11171,2015-06-01,04D,1326,753,2079,0.6378066378066378
11172,2015-06-01,04E,1085,773,1858,0.5839612486544672
11173,2015-06-01,04F,1484,979,2463,0.6025172553796183
11174,2015-06-01,04G,4205,2440,6645,0.6328066215199398
11175,2015-06-01,04H,663,522,1185,0.5594936708860759
11176,2015-06-01,04J,1860,1298,3158,0.5889803673210893
11177,2015-06-01,04K,1528,1115,2643,0.5781309118426031
11178,2015-06-01,04L,816,478,1294,0.6306027820710973
11179,2015-06-01,04M,483,376,859,0.5622817229336438
11180,2015-06-01,04N,608,406,1014,0.5996055226824457
11181,2015-06-01,04Q,760,473,1233,0.616382806163828
11182,2015-06-01,04R,2121,1671,3792,0.5593354430379747
11183,2015-06-01,04V,2235,1072,3307,0.6758391291200484
11184,2015-06-01,04X,1252,1288,2540,0.49291338582677163
11185,2015-06-01,04Y,923,426,1349,0.6842105263157895
11186,2015-06-01,05A,2596,1481,4077,0.6367427029678685
11187,2015-06-01,05C,1295,1648,2943,0.4400271831464492
11188,2015-06-01,05D,927,471,1398,0.6630901287553648
11189,2015-06-01,05F,1196,794,1990,0.6010050251256281
11190,2015-06-01,05G,1469,656,2125,0.6912941176470588
11191,2015-06-01,05H,1128,645,1773,0.6362098138747885
11192,2015-06-01,05J,1361,613,1974,0.6894630192502533
11193,2015-06-01,05L,2300,1805,4105,0.5602923264311814
11194,2015-06-01,05N,2144,991,3135,0.6838915470494418
11195,2015-06-01,05P,1262,862,2124,0.5941619585687382
11196,2015-06-01,05Q,1393,733,2126,0.6552210724365005
11197,2015-06-01,05R,1655,1227,2882,0.5742539902845246
11198,2015-06-01,05T,2042,1166,3208,0.6365336658354115
11199,2015-06-01,05V,995,479,1474,0.675033921302578
11200,2015-06-01,05W,1831,787,2618,0.69938884644767
11201,2015-06-01,05X,1106,627,1733,0.638199653779573
11202,2015-06-01,05Y,1873,1052,2925,0.6403418803418803
11203,2015-06-01,06A,1595,777,2372,0.6724283305227656
11204,2015-06-01,06D,850,472,1322,0.642965204236006
11205,2015-06-01,06F,1575,2406,3981,0.39562923888470236
11206,2015-06-01,06H,5178,2964,8142,0.6359616801768607
11207,2015-06-01,06K,3138,2500,5638,0.5565803476410075
11208,2015-06-01,06L,2389,967,3356,0.7118593563766389
11209,2015-06-01,06M,1803,898,2701,0.6675305442428731
11210,2015-06-01,06N,3225,2535,5760,0.5598958333333334
11211,2015-06-01,06P,863,918,1781,0.4845592363840539
11212,2015-06-01,06Q,2287,1142,3429,0.6669582968795568
11213,2015-06-01,06T,1977,1445,3422,0.5777323202805377
11214,2015-06-01,06V,1358,746,2104,0.6454372623574145
11215,2015-06-01,06W,1426,601,2027,0.7035027133695116
11216,2015-06-01,06Y,1227,625,1852,0.6625269978401728
11217,2015-06-01,07G,882,361,1243,0.7095736122284795
11218,2015-06-01,07H,1742,1088,2830,0.615547703180212
11219,2015-06-01,07J,790,578,1368,0.577485380116959
11220,2015-06-01,07K,1504,711,2215,0.6790067720090294
11221,2015-06-01,07L,689,319,1008,0.683531746031746
11222,2015-06-01,07M,1217,1063,2280,0.5337719298245615
11223,2015-06-01,07N,1385,755,2140,0.647196261682243
11224,2015-06-01,07P,840,700,1540,0.5454545454545454
11225,2015-06-01,07Q,1564,888,2452,0.6378466557911908
11226,2015-06-01,07R,680,594,1274,0.533751962323391
11227,2015-06-01,07T,695,583,1278,0.5438184663536776
11228,2015-06-01,07V,1474,1046,2520,0.584920634920635
11229,2015-06-01,07W,1072,891,1963,0.5461029037187978
11230,2015-06-01,07X,1242,688,1930,0.6435233160621762
11231,2015-06-01,07Y,952,531,1483,0.6419420094403236
11232,2015-06-01,08A,1100,664,1764,0.6235827664399093
11233,2015-06-01,08C,663,534,1197,0.5538847117794486
11234,2015-06-01,08D,810,670,1480,0.5472972972972973
11235,2015-06-01,08E,790,667,1457,0.5422100205902539
11236,2015-06-01,08F,1461,655,2116,0.6904536862003781
11237,2015-06-01,08G,453,1268,1721,0.26321905868681
11238,2015-06-01,08H,681,766,1447,0.47062888735314445
11239,2015-06-01,08J,872,436,1308,0.6666666666666666
11240,2015-06-01,08K,1133,548,1681,0.6740035693039858
11241,2015-06-01,08L,669,1290,1959,0.34150076569678406
11242,2015-06-01,08M,1156,506,1662,0.6955475330926595
11243,2015-06-01,08N,1150,547,1697,0.6776664702416029
11244,2015-06-01,08P,876,615,1491,0.5875251509054326
11245,2015-06-01,08Q,906,489,1395,0.6494623655913978
11246,2015-06-01,08R,797,477,1274,0.6255886970172685
11247,2015-06-01,08T,1006,556,1562,0.6440460947503202
11248,2015-06-01,08V,1067,626,1693,0.6302421736562316
11249,2015-06-01,08W,968,561,1529,0.6330935251798561
11250,2015-06-01,08X,1212,751,1963,0.6174223127865512
11251,2015-06-01,08Y,617,622,1239,0.4979822437449556
11252,2015-06-01,09A,521,598,1119,0.46559428060768543
11253,2015-06-01,09C,736,473,1209,0.608767576509512
11254,2015-06-01,09D,1293,1041,2334,0.5539845758354756
11255,2015-06-01,09E,1615,749,2364,0.6831641285956007
11256,2015-06-01,09F,1328,728,2056,0.6459143968871596
11257,2015-06-01,09G,3526,1922,5448,0.6472099853157122
11258,2015-06-01,09H,599,333,932,0.6427038626609443
11259,2015-06-01,09J,1602,1059,2661,0.6020293122886133
11260,2015-06-01,09L,862,570,1432,0.6019553072625698
11261,2015-06-01,09N,976,732,1708,0.5714285714285714
11262,2015-06-01,09P,1138,809,1947,0.5844889573703133
11263,2015-06-01,09W,1352,847,2199,0.614824920418372
11264,2015-06-01,09X,980,729,1709,0.5734347571679345
11265,2015-06-01,09Y,1272,1312,2584,0.49226006191950467
11266,2015-06-01,10A,1255,820,2075,0.6048192771084338
11267,2015-06-01,10C,512,323,835,0.6131736526946108
11268,2015-06-01,10D,668,315,983,0.6795523906408952
11269,2015-06-01,10E,831,440,1271,0.6538158929976396
11270,2015-06-01,10G,677,363,1040,0.6509615384615385
11271,2015-06-01,10H,1837,1439,3276,0.5607448107448108
11272,2015-06-01,10J,1115,885,2000,0.5575
11273,2015-06-01,10K,1293,662,1955,0.661381074168798
11274,2015-06-01,10L,999,427,1426,0.7005610098176718
11275,2015-06-01,10M,513,494,1007,0.5094339622641509
11276,2015-06-01,10N,426,448,874,0.4874141876430206
11277,2015-06-01,10Q,3355,3007,6362,0.5273498899717071
11278,2015-06-01,10R,1381,569,1950,0.7082051282051282
11279,2015-06-01,10T,652,321,973,0.6700924974306269
11280,2015-06-01,10V,1273,764,2037,0.6249386352479136
11281,2015-06-01,10W,577,428,1005,0.5741293532338309
11282,2015-06-01,10X,1220,671,1891,0.6451612903225806
11283,2015-06-01,10Y,1217,930,2147,0.5668374476013042
11284,2015-06-01,11A,3238,1668,4906,0.6600081532816959
11285,2015-06-01,11C,811,420,1231,0.6588139723801787
11286,2015-06-01,11D,596,581,1177,0.5063721325403568
11287,2015-06-01,11E,1070,1002,2072,0.5164092664092664
11288,2015-06-01,11H,2486,1454,3940,0.6309644670050761
11289,2015-06-01,11J,5244,2343,7587,0.6911822854883353
11290,2015-06-01,11M,3803,2033,5836,0.6516449623029472
11291,2015-06-01,11N,4065,1725,5790,0.7020725388601037
11292,2015-06-01,11T,1569,915,2484,0.6316425120772947
11293,2015-06-01,11X,3314,2135,5449,0.6081849880712057
11294,2015-06-01,12A,1530,759,2289,0.6684141546526867
11295,2015-06-01,12D,1175,888,2063,0.5695588948133786
11296,2015-06-01,12F,2198,782,2980,0.7375838926174496
11297,2015-06-01,13P,2960,2194,5154,0.5743112145906092
11298,2015-06-01,13T,3084,1618,4702,0.6558911101658869
11299,2015-06-01,14L,2909,1870,4779,0.6087047499476878
11300,2015-06-01,99A,2873,1225,4098,0.7010736944851147
11301,2015-06-01,99C,1444,808,2252,0.6412078152753108
11302,2015-06-01,99D,1071,792,1863,0.5748792270531401
11303,2015-06-01,99E,1516,633,2149,0.7054443927408097
11304,2015-06-01,99F,1021,386,1407,0.7256574271499645
11305,2015-06-01,99G,1136,413,1549,0.7333763718528082
11306,2015-06-01,99H,1528,1031,2559,0.5971082454083626
11307,2015-06-01,99J,2767,1830,4597,0.6019142919295193
11308,2015-06-01,99K,901,738,1639,0.549725442342892
11309,2015-06-01,99M,1011,947,1958,0.5163432073544433
11310,2015-06-01,99N,2629,2704,5333,0.4929683105194075
11311,2015-06-01,99P,6284,2558,8842,0.7106989368921058
11312,2015-06-01,99Q,1946,988,2934,0.6632583503749148
11313,2015-07-01,00C,774,345,1119,0.6916890080428955
11314,2015-07-01,00D,2475,1095,3570,0.6932773109243697
11315,2015-07-01,00J,1834,886,2720,0.674264705882353
11316,2015-07-01,00K,2283,1107,3390,0.6734513274336283
11317,2015-07-01,00L,2232,1439,3671,0.6080087169708527
11318,2015-07-01,00M,2361,1141,3502,0.6741861793260994
11319,2015-07-01,00N,1122,683,1805,0.621606648199446
11320,2015-07-01,00P,2105,875,2980,0.7063758389261745
11321,2015-07-01,00Q,951,463,1414,0.6725601131541725
11322,2015-07-01,00R,1182,691,1873,0.6310731446876668
11323,2015-07-01,00T,1868,1201,3069,0.6086673183447378
11324,2015-07-01,00V,1287,929,2216,0.5807761732851986
11325,2015-07-01,00X,1048,369,1417,0.739590684544813
11326,2015-07-01,00Y,1804,1198,3002,0.6009327115256495
11327,2015-07-01,01A,2411,1446,3857,0.6250972258231786
11328,2015-07-01,01C,1041,740,1781,0.5845030881527232
11329,2015-07-01,01D,1416,901,2317,0.6111350884764782
11330,2015-07-01,01E,1006,283,1289,0.7804499612102405
11331,2015-07-01,01F,1040,432,1472,0.7065217391304348
11332,2015-07-01,01G,1280,1469,2749,0.46562386322299015
11333,2015-07-01,01H,2523,995,3518,0.7171688459351905
11334,2015-07-01,01J,1108,569,1677,0.6607036374478235
11335,2015-07-01,01K,2256,1322,3578,0.6305198434879821
11336,2015-07-01,01R,903,715,1618,0.5580964153275649
11337,2015-07-01,01T,777,490,1267,0.6132596685082873
11338,2015-07-01,01V,906,475,1381,0.6560463432295438
11339,2015-07-01,01W,2199,1159,3358,0.6548540798094103
11340,2015-07-01,01X,1447,844,2291,0.631601920558708
11341,2015-07-01,01Y,714,1263,1977,0.3611532625189681
11342,2015-07-01,02A,1343,634,1977,0.6793120890237734
11343,2015-07-01,02D,491,442,933,0.5262593783494105
11344,2015-07-01,02E,1275,798,2073,0.6150506512301013
11345,2015-07-01,02F,1188,1058,2246,0.5289403383793411
11346,2015-07-01,02G,677,337,1014,0.6676528599605522
11347,2015-07-01,02H,1569,1674,3243,0.4838112858464385
11348,2015-07-01,02M,1132,489,1621,0.6983343615052436
11349,2015-07-01,02N,1060,727,1787,0.5931729155008394
11350,2015-07-01,02P,1115,1600,2715,0.4106813996316759
11351,2015-07-01,02Q,691,469,1160,0.5956896551724138
11352,2015-07-01,02R,2351,1341,3692,0.6367822318526544
11353,2015-07-01,02T,1254,834,2088,0.6005747126436781
11354,2015-07-01,02V,842,1149,1991,0.4229030637870417
11355,2015-07-01,02W,564,334,898,0.6280623608017817
11356,2015-07-01,02X,1982,1014,2996,0.6615487316421896
11357,2015-07-01,02Y,2114,977,3091,0.6839210611452604
11358,2015-07-01,03A,1376,827,2203,0.6246028143440763
11359,2015-07-01,03C,1434,1536,2970,0.48282828282828283
11360,2015-07-01,03D,959,487,1446,0.6632088520055325
11361,2015-07-01,03E,915,615,1530,0.5980392156862745
11362,2015-07-01,03F,1778,665,2443,0.7277936962750716
11363,2015-07-01,03G,1304,1371,2675,0.4874766355140187
11364,2015-07-01,03H,1388,531,1919,0.7232933819697759
11365,2015-07-01,03J,1171,577,1748,0.669908466819222
11366,2015-07-01,03K,1046,452,1498,0.69826435246996
11367,2015-07-01,03L,1007,1452,2459,0.40951606344042296
11368,2015-07-01,03M,976,497,1473,0.6625933469110659
11369,2015-07-01,03N,3312,1389,4701,0.7045309508615188
11370,2015-07-01,03Q,2018,1040,3058,0.6599084368868542
11371,2015-07-01,03R,2357,1473,3830,0.6154046997389034
11372,2015-07-01,03T,1899,963,2862,0.6635220125786163
11373,2015-07-01,03V,500,351,851,0.5875440658049353
11374,2015-07-01,03W,2370,1203,3573,0.6633081444164568
11375,2015-07-01,03X,445,340,785,0.5668789808917197
11376,2015-07-01,03Y,758,425,1183,0.6407438715131023
11377,2015-07-01,04C,1988,819,2807,0.7082294264339152
11378,2015-07-01,04D,1395,832,2227,0.6264032330489447
11379,2015-07-01,04E,1020,893,1913,0.5331939362258233
11380,2015-07-01,04F,1635,1110,2745,0.5956284153005464
11381,2015-07-01,04G,4422,2670,7092,0.6235194585448393
11382,2015-07-01,04H,658,570,1228,0.5358306188925082
11383,2015-07-01,04J,1907,1386,3293,0.5791071970847251
11384,2015-07-01,04K,1248,1225,2473,0.504650222401941
11385,2015-07-01,04L,743,641,1384,0.536849710982659
11386,2015-07-01,04M,399,430,829,0.4813027744270205
11387,2015-07-01,04N,563,553,1116,0.5044802867383512
11388,2015-07-01,04Q,840,488,1328,0.6325301204819277
11389,2015-07-01,04R,2341,1873,4214,0.5555291884195539
11390,2015-07-01,04V,2374,1169,3543,0.6700536268698842
11391,2015-07-01,04X,1278,1240,2518,0.5075456711675933
11392,2015-07-01,04Y,968,410,1378,0.7024673439767779
11393,2015-07-01,05A,2653,1587,4240,0.6257075471698114
11394,2015-07-01,05C,1246,1717,2963,0.4205197435032062
11395,2015-07-01,05D,1029,481,1510,0.6814569536423841
11396,2015-07-01,05F,1221,914,2135,0.5718969555035128
11397,2015-07-01,05G,1573,673,2246,0.7003561887800535
11398,2015-07-01,05H,1213,674,1887,0.6428192898781134
11399,2015-07-01,05J,1429,764,2193,0.6516187870497036
11400,2015-07-01,05L,2429,1808,4237,0.5732829832428605
11401,2015-07-01,05N,2251,1061,3312,0.6796497584541062
11402,2015-07-01,05P,1268,935,2203,0.5755787562414889
11403,2015-07-01,05Q,1592,840,2432,0.6546052631578947
11404,2015-07-01,05R,1725,1261,2986,0.5776959142665774
11405,2015-07-01,05T,2112,1204,3316,0.6369119420989143
11406,2015-07-01,05V,1064,523,1587,0.6704473850031506
11407,2015-07-01,05W,1945,742,2687,0.7238556010420544
11408,2015-07-01,05X,1021,674,1695,0.6023598820058997
11409,2015-07-01,05Y,1940,1145,3085,0.6288492706645057
11410,2015-07-01,06A,1654,870,2524,0.6553090332805072
11411,2015-07-01,06D,880,525,1405,0.6263345195729537
11412,2015-07-01,06F,1583,2647,4230,0.3742316784869976
11413,2015-07-01,06H,5527,3271,8798,0.62821095703569
11414,2015-07-01,06K,3409,2726,6135,0.5556642216788916
11415,2015-07-01,06L,2711,1086,3797,0.7139847247827232
11416,2015-07-01,06M,1941,921,2862,0.6781970649895178
11417,2015-07-01,06N,3254,2591,5845,0.5567151411462788
11418,2015-07-01,06P,896,979,1875,0.47786666666666666
11419,2015-07-01,06Q,2440,1381,3821,0.6385762889295996
11420,2015-07-01,06T,2104,1614,3718,0.5658956428187197
11421,2015-07-01,06V,1365,762,2127,0.6417489421720733
11422,2015-07-01,06W,1297,591,1888,0.6869703389830508
11423,2015-07-01,06Y,1351,666,2017,0.6698066435299951
11424,2015-07-01,07G,897,401,1298,0.6910631741140215
11425,2015-07-01,07H,1781,1167,2948,0.6041383989145184
11426,2015-07-01,07J,944,650,1594,0.5922208281053952
11427,2015-07-01,07K,1524,696,2220,0.6864864864864865
11428,2015-07-01,07L,822,355,1177,0.6983857264231096
11429,2015-07-01,07M,1341,1219,2560,0.523828125
11430,2015-07-01,07N,1531,804,2335,0.6556745182012848
11431,2015-07-01,07P,862,718,1580,0.5455696202531646
11432,2015-07-01,07Q,1656,878,2534,0.6535122336227308
11433,2015-07-01,07R,722,707,1429,0.5052484254723583
11434,2015-07-01,07T,699,732,1431,0.48846960167714887
11435,2015-07-01,07V,1352,1324,2676,0.5052316890881914
11436,2015-07-01,07W,1161,858,2019,0.575037147102526
11437,2015-07-01,07X,1228,749,1977,0.6211431461810825
11438,2015-07-01,07Y,990,564,1554,0.637065637065637
11439,2015-07-01,08A,1042,706,1748,0.5961098398169337
11440,2015-07-01,08C,749,568,1317,0.568716780561883
11441,2015-07-01,08D,798,672,1470,0.5428571428571428
11442,2015-07-01,08E,828,678,1506,0.549800796812749
11443,2015-07-01,08F,1501,714,2215,0.6776523702031603
11444,2015-07-01,08G,482,1322,1804,0.26718403547671843
11445,2015-07-01,08H,656,773,1429,0.45906228131560534
11446,2015-07-01,08J,893,445,1338,0.6674140508221226
11447,2015-07-01,08K,1135,753,1888,0.6011652542372882
11448,2015-07-01,08L,653,1518,2171,0.3007830492860433
11449,2015-07-01,08M,1197,610,1807,0.6624239070282236
11450,2015-07-01,08N,1230,598,1828,0.6728665207877462
11451,2015-07-01,08P,1092,694,1786,0.6114221724524076
11452,2015-07-01,08Q,863,529,1392,0.6199712643678161
11453,2015-07-01,08R,875,476,1351,0.6476683937823834
11454,2015-07-01,08T,971,582,1553,0.6252414681262073
11455,2015-07-01,08V,1049,678,1727,0.6074116965836711
11456,2015-07-01,08W,989,656,1645,0.6012158054711246
11457,2015-07-01,08X,1295,825,2120,0.6108490566037735
11458,2015-07-01,08Y,617,565,1182,0.5219966159052454
11459,2015-07-01,09A,538,642,1180,0.4559322033898305
11460,2015-07-01,09C,776,514,1290,0.6015503875968993
11461,2015-07-01,09D,1339,1086,2425,0.5521649484536082
11462,2015-07-01,09E,1527,755,2282,0.6691498685363716
11463,2015-07-01,09F,1343,762,2105,0.6380047505938242
11464,2015-07-01,09G,3773,1996,5769,0.6540128271797538
11465,2015-07-01,09H,586,371,957,0.6123301985370951
11466,2015-07-01,09J,1691,1228,2919,0.57930798218568
11467,2015-07-01,09L,946,601,1547,0.6115061409179057
11468,2015-07-01,09N,1045,824,1869,0.5591225254146602
11469,2015-07-01,09P,1169,862,2031,0.5755785327424914
11470,2015-07-01,09W,1334,975,2309,0.577739281074058
11471,2015-07-01,09X,1077,784,1861,0.5787211176786674
11472,2015-07-01,09Y,1364,1490,2854,0.47792571829011915
11473,2015-07-01,10A,1333,889,2222,0.5999099909990999
11474,2015-07-01,10C,487,340,827,0.5888754534461911
11475,2015-07-01,10D,609,363,972,0.6265432098765432
11476,2015-07-01,10E,922,439,1361,0.677443056576047
11477,2015-07-01,10G,794,419,1213,0.6545754328112119
11478,2015-07-01,10H,1914,1433,3347,0.5718553928891544
11479,2015-07-01,10J,1126,1008,2134,0.5276476101218369
11480,2015-07-01,10K,1376,684,2060,0.6679611650485436
11481,2015-07-01,10L,1004,366,1370,0.7328467153284671
11482,2015-07-01,10M,496,509,1005,0.4935323383084577
11483,2015-07-01,10N,473,471,944,0.5010593220338984
11484,2015-07-01,10Q,3631,3223,6854,0.5297636416690983
11485,2015-07-01,10R,1402,577,1979,0.7084386053562405
11486,2015-07-01,10T,664,333,997,0.6659979939819458
11487,2015-07-01,10V,1433,769,2202,0.650772025431426
11488,2015-07-01,10W,587,411,998,0.5881763527054108
11489,2015-07-01,10X,1187,702,1889,0.6283748014822658
11490,2015-07-01,10Y,1335,997,2332,0.5724699828473413
11491,2015-07-01,11A,3561,1886,5447,0.6537543601982743
11492,2015-07-01,11C,948,416,1364,0.6950146627565983
11493,2015-07-01,11D,677,611,1288,0.5256211180124224
11494,2015-07-01,11E,1025,1067,2092,0.48996175908221795
11495,2015-07-01,11H,2708,1662,4370,0.6196796338672769
11496,2015-07-01,11J,5570,2514,8084,0.6890153389411182
11497,2015-07-01,11M,4034,2187,6221,0.6484488024433371
11498,2015-07-01,11N,4389,1952,6341,0.6921621195395048
11499,2015-07-01,11T,1544,960,2504,0.6166134185303515
11500,2015-07-01,11X,3499,2222,5721,0.6116063625240342
11501,2015-07-01,12A,1655,825,2480,0.6673387096774194
11502,2015-07-01,12D,1131,954,2085,0.5424460431654676
11503,2015-07-01,12F,2452,828,3280,0.7475609756097561
11504,2015-07-01,13P,3108,2407,5515,0.5635539437896645
11505,2015-07-01,13T,3183,1613,4796,0.6636780650542119
11506,2015-07-01,14L,2959,1974,4933,0.5998378268801946
11507,2015-07-01,99A,2993,1365,4358,0.6867829279486003
11508,2015-07-01,99C,1613,865,2478,0.6509281678773204
11509,2015-07-01,99D,1078,846,1924,0.5602910602910602
11510,2015-07-01,99E,1720,691,2411,0.7133969307341352
11511,2015-07-01,99F,1193,413,1606,0.7428393524283935
11512,2015-07-01,99G,1125,436,1561,0.7206918641896221
11513,2015-07-01,99H,1578,1125,2703,0.5837957824639289
11514,2015-07-01,99J,2984,2019,5003,0.5964421347191685
11515,2015-07-01,99K,1050,793,1843,0.5697232772653282
11516,2015-07-01,99M,1106,1077,2183,0.5066422354557948
11517,2015-07-01,99N,2977,2706,5683,0.5238430406475453
11518,2015-07-01,99P,6703,2582,9285,0.721917070543888
11519,2015-07-01,99Q,1960,1040,3000,0.6533333333333333
11520,2015-08-01,00C,721,356,1077,0.669452181987001
11521,2015-08-01,00D,2191,1021,3212,0.6821295143212951
11522,2015-08-01,00J,1655,756,2411,0.6864371630029034
11523,2015-08-01,00K,2057,1060,3117,0.6599294193134424
11524,2015-08-01,00L,2130,1281,3411,0.6244503078276166
11525,2015-08-01,00M,2066,1095,3161,0.6535906358747232
11526,2015-08-01,00N,1056,577,1633,0.6466625842008573
11527,2015-08-01,00P,1961,817,2778,0.7059035277177825
11528,2015-08-01,00Q,911,480,1391,0.6549245147375988
11529,2015-08-01,00R,1091,697,1788,0.610178970917226
11530,2015-08-01,00T,1775,1083,2858,0.6210636808957313
11531,2015-08-01,00V,1175,931,2106,0.5579297245963912
11532,2015-08-01,00X,947,398,1345,0.704089219330855
11533,2015-08-01,00Y,1585,1098,2683,0.5907566157286619
11534,2015-08-01,01A,2172,1388,3560,0.6101123595505618
11535,2015-08-01,01C,880,740,1620,0.5432098765432098
11536,2015-08-01,01D,1226,923,2149,0.570497906002792
11537,2015-08-01,01E,959,308,1267,0.7569060773480663
11538,2015-08-01,01F,824,459,1283,0.642244738893219
11539,2015-08-01,01G,1106,1357,2463,0.4490458790093382
11540,2015-08-01,01H,2405,1033,3438,0.6995346131471786
11541,2015-08-01,01J,978,524,1502,0.6511318242343542
11542,2015-08-01,01K,2031,1203,3234,0.6280148423005566
11543,2015-08-01,01R,786,703,1489,0.5278710543989255
11544,2015-08-01,01T,696,459,1155,0.6025974025974026
11545,2015-08-01,01V,798,395,1193,0.6689019279128248
11546,2015-08-01,01W,2041,1066,3107,0.6569037656903766
11547,2015-08-01,01X,1340,759,2099,0.6383992377322535
11548,2015-08-01,01Y,640,1258,1898,0.33719704952581664
11549,2015-08-01,02A,1150,596,1746,0.6586483390607102
11550,2015-08-01,02D,474,420,894,0.5302013422818792
11551,2015-08-01,02E,1043,702,1745,0.5977077363896848
11552,2015-08-01,02F,1113,1051,2164,0.5143253234750462
11553,2015-08-01,02G,644,331,975,0.6605128205128206
11554,2015-08-01,02H,1444,1481,2925,0.49367521367521366
11555,2015-08-01,02M,1055,473,1528,0.6904450261780105
11556,2015-08-01,02N,891,617,1508,0.5908488063660478
11557,2015-08-01,02P,970,1519,2489,0.38971474487746083
11558,2015-08-01,02Q,604,464,1068,0.5655430711610487
11559,2015-08-01,02R,2062,1212,3274,0.6298106291997556
11560,2015-08-01,02T,1171,843,2014,0.5814299900695135
11561,2015-08-01,02V,729,1188,1917,0.38028169014084506
11562,2015-08-01,02W,519,380,899,0.5773081201334817
11563,2015-08-01,02X,1872,988,2860,0.6545454545454545
11564,2015-08-01,02Y,1917,884,2801,0.6843984291324527
11565,2015-08-01,03A,1348,775,2123,0.634950541686293
11566,2015-08-01,03C,1187,1597,2784,0.42636494252873564
11567,2015-08-01,03D,952,473,1425,0.6680701754385965
11568,2015-08-01,03E,922,561,1483,0.6217127444369521
11569,2015-08-01,03F,1673,736,2409,0.6944790369447904
11570,2015-08-01,03G,1229,1260,2489,0.4937725994375251
11571,2015-08-01,03H,1201,472,1673,0.7178720860729229
11572,2015-08-01,03J,1028,512,1540,0.6675324675324675
11573,2015-08-01,03K,857,406,1263,0.6785431512272367
11574,2015-08-01,03L,870,1375,2245,0.38752783964365256
11575,2015-08-01,03M,863,454,1317,0.6552771450265755
11576,2015-08-01,03N,3130,1297,4427,0.7070250734131466
11577,2015-08-01,03Q,1844,969,2813,0.6555279061500178
11578,2015-08-01,03R,2186,1263,3449,0.6338069005508843
11579,2015-08-01,03T,1889,816,2705,0.6983364140480591
11580,2015-08-01,03V,393,310,703,0.5590327169274538
11581,2015-08-01,03W,2120,1104,3224,0.6575682382133995
11582,2015-08-01,03X,399,323,722,0.5526315789473685
11583,2015-08-01,03Y,676,427,1103,0.6128739800543971
11584,2015-08-01,04C,1908,789,2697,0.7074527252502781
11585,2015-08-01,04D,1274,752,2026,0.6288252714708786
11586,2015-08-01,04E,851,980,1831,0.4647733478973239
11587,2015-08-01,04F,1445,1041,2486,0.581255028157683
11588,2015-08-01,04G,4006,2448,6454,0.6207003408738767
11589,2015-08-01,04H,493,622,1115,0.442152466367713
11590,2015-08-01,04J,1766,1348,3114,0.5671162491971741
11591,2015-08-01,04K,1030,1351,2381,0.4325913481730365
11592,2015-08-01,04L,448,745,1193,0.3755238893545683
11593,2015-08-01,04M,377,453,830,0.4542168674698795
11594,2015-08-01,04N,461,512,973,0.473792394655704
11595,2015-08-01,04Q,757,437,1194,0.6340033500837521
11596,2015-08-01,04R,1996,1688,3684,0.5418023887079262
11597,2015-08-01,04V,2129,1031,3160,0.6737341772151899
11598,2015-08-01,04X,1235,1158,2393,0.5160885917258671
11599,2015-08-01,04Y,889,441,1330,0.6684210526315789
11600,2015-08-01,05A,2507,1428,3935,0.6371029224904702
11601,2015-08-01,05C,1195,1648,2843,0.42033063665142456
11602,2015-08-01,05D,949,421,1370,0.6927007299270073
11603,2015-08-01,05F,1134,856,1990,0.5698492462311557
11604,2015-08-01,05G,1483,627,2110,0.7028436018957346
11605,2015-08-01,05H,1095,600,1695,0.6460176991150443
11606,2015-08-01,05J,1351,676,2027,0.6665022200296004
11607,2015-08-01,05L,2346,1712,4058,0.5781172991621488
11608,2015-08-01,05N,2040,950,2990,0.6822742474916388
11609,2015-08-01,05P,1158,892,2050,0.5648780487804878
11610,2015-08-01,05Q,1335,740,2075,0.6433734939759036
11611,2015-08-01,05R,1539,1242,2781,0.5533980582524272
11612,2015-08-01,05T,1902,1192,3094,0.6147382029734971
11613,2015-08-01,05V,905,501,1406,0.6436699857752489
11614,2015-08-01,05W,1675,799,2474,0.6770412287793047
11615,2015-08-01,05X,911,654,1565,0.582108626198083
11616,2015-08-01,05Y,1690,1087,2777,0.6085703997119193
11617,2015-08-01,06A,1540,818,2358,0.6530958439355385
11618,2015-08-01,06D,828,461,1289,0.6423584173778123
11619,2015-08-01,06F,1543,2406,3949,0.39073183084325147
11620,2015-08-01,06H,5019,3006,8025,0.6254205607476635
11621,2015-08-01,06K,3087,2881,5968,0.5172587131367292
11622,2015-08-01,06L,2398,949,3347,0.7164625037346878
11623,2015-08-01,06M,1722,908,2630,0.6547528517110266
11624,2015-08-01,06N,2999,2531,5530,0.5423146473779386
11625,2015-08-01,06P,839,934,1773,0.47320924985899604
11626,2015-08-01,06Q,2201,1250,3451,0.6377861489423355
11627,2015-08-01,06T,1945,1453,3398,0.5723955267804591
11628,2015-08-01,06V,1362,675,2037,0.6686303387334315
11629,2015-08-01,06W,1399,678,2077,0.673567645642754
11630,2015-08-01,06Y,1269,653,1922,0.6602497398543185
11631,2015-08-01,07G,903,399,1302,0.6935483870967742
11632,2015-08-01,07H,1576,1095,2671,0.5900411830774991
11633,2015-08-01,07J,870,611,1481,0.587440918298447
11634,2015-08-01,07K,1413,679,2092,0.6754302103250478
11635,2015-08-01,07L,617,342,959,0.643378519290928
11636,2015-08-01,07M,1157,1122,2279,0.5076788064940764
11637,2015-08-01,07N,1454,814,2268,0.6410934744268078
11638,2015-08-01,07P,828,656,1484,0.5579514824797843
11639,2015-08-01,07Q,1429,803,2232,0.6402329749103942
11640,2015-08-01,07R,641,647,1288,0.49767080745341613
11641,2015-08-01,07T,588,630,1218,0.4827586206896552
11642,2015-08-01,07V,1301,1362,2663,0.4885467517837026
11643,2015-08-01,07W,1033,903,1936,0.5335743801652892
11644,2015-08-01,07X,1150,743,1893,0.6075013206550449
11645,2015-08-01,07Y,881,519,1400,0.6292857142857143
11646,2015-08-01,08A,1103,649,1752,0.6295662100456622
11647,2015-08-01,08C,663,559,1222,0.5425531914893617
11648,2015-08-01,08D,688,646,1334,0.5157421289355323
11649,2015-08-01,08E,723,655,1378,0.5246734397677794
11650,2015-08-01,08F,1381,681,2062,0.6697381183317168
11651,2015-08-01,08G,384,1288,1672,0.22966507177033493
11652,2015-08-01,08H,621,735,1356,0.4579646017699115
11653,2015-08-01,08J,856,457,1313,0.6519421172886519
11654,2015-08-01,08K,1032,747,1779,0.5801011804384486
11655,2015-08-01,08L,620,1302,1922,0.3225806451612903
11656,2015-08-01,08M,1158,593,1751,0.6613363792118789
11657,2015-08-01,08N,1110,564,1674,0.6630824372759857
11658,2015-08-01,08P,907,600,1507,0.6018579960185799
11659,2015-08-01,08Q,769,546,1315,0.5847908745247148
11660,2015-08-01,08R,754,484,1238,0.6090468497576736
11661,2015-08-01,08T,848,578,1426,0.5946704067321178
11662,2015-08-01,08V,993,709,1702,0.5834312573443008
11663,2015-08-01,08W,918,601,1519,0.6043449637919684
11664,2015-08-01,08X,1236,850,2086,0.5925215723873442
11665,2015-08-01,08Y,611,541,1152,0.5303819444444444
11666,2015-08-01,09A,453,674,1127,0.40195208518189884
11667,2015-08-01,09C,673,498,1171,0.5747224594363791
11668,2015-08-01,09D,1249,1010,2259,0.5528995130588756
11669,2015-08-01,09E,1545,794,2339,0.6605386917486105
11670,2015-08-01,09F,1367,671,2038,0.6707556427870461
11671,2015-08-01,09G,3548,1888,5436,0.6526857983811626
11672,2015-08-01,09H,593,373,966,0.6138716356107661
11673,2015-08-01,09J,1498,1115,2613,0.5732874091083047
11674,2015-08-01,09L,890,513,1403,0.6343549536707056
11675,2015-08-01,09N,936,751,1687,0.5548310610551275
11676,2015-08-01,09P,1040,850,1890,0.5502645502645502
11677,2015-08-01,09W,1218,861,2079,0.5858585858585859
11678,2015-08-01,09X,1004,807,1811,0.5543898398674766
11679,2015-08-01,09Y,1370,1329,2699,0.507595405705817
11680,2015-08-01,10A,1197,790,1987,0.6024157020634122
11681,2015-08-01,10C,474,347,821,0.5773447015834349
11682,2015-08-01,10D,624,337,961,0.6493236212278877
11683,2015-08-01,10E,796,454,1250,0.6368
11684,2015-08-01,10G,711,377,1088,0.6534926470588235
11685,2015-08-01,10H,1842,1353,3195,0.5765258215962441
11686,2015-08-01,10J,1030,838,1868,0.5513918629550322
11687,2015-08-01,10K,1290,620,1910,0.675392670157068
11688,2015-08-01,10L,940,383,1323,0.7105064247921391
11689,2015-08-01,10M,465,446,911,0.5104281009879253
11690,2015-08-01,10N,430,424,854,0.5035128805620609
11691,2015-08-01,10Q,3187,2896,6083,0.5239191188558278
11692,2015-08-01,10R,1300,607,1907,0.6816990036706869
11693,2015-08-01,10T,620,336,956,0.6485355648535565
11694,2015-08-01,10V,1354,702,2056,0.6585603112840467
11695,2015-08-01,10W,537,364,901,0.5960044395116537
11696,2015-08-01,10X,1039,586,1625,0.6393846153846154
11697,2015-08-01,10Y,1165,936,2101,0.5544978581627796
11698,2015-08-01,11A,3219,1767,4986,0.6456077015643803
11699,2015-08-01,11C,818,432,1250,0.6544
11700,2015-08-01,11D,630,599,1229,0.5126118795768918
11701,2015-08-01,11E,998,954,1952,0.5112704918032787
11702,2015-08-01,11H,2452,1468,3920,0.6255102040816326
11703,2015-08-01,11J,5193,2348,7541,0.6886354594881315
11704,2015-08-01,11M,3614,2002,5616,0.6435185185185185
11705,2015-08-01,11N,4121,1763,5884,0.7003738953093134
11706,2015-08-01,11T,1511,903,2414,0.6259320629660314
11707,2015-08-01,11X,3395,2064,5459,0.6219087745008244
11708,2015-08-01,12A,1519,823,2342,0.6485909479077712
11709,2015-08-01,12D,1090,903,1993,0.5469141996989463
11710,2015-08-01,12F,2137,786,2923,0.7310981867943893
11711,2015-08-01,13P,2812,2284,5096,0.5518053375196232
11712,2015-08-01,13T,2917,1515,4432,0.6581678700361011
11713,2015-08-01,14L,2726,1789,4515,0.603765227021041
11714,2015-08-01,99A,2686,1185,3871,0.6938775510204082
11715,2015-08-01,99C,1440,774,2214,0.6504065040650406
11716,2015-08-01,99D,1017,759,1776,0.5726351351351351
11717,2015-08-01,99E,1517,638,2155,0.7039443155452436
11718,2015-08-01,99F,1010,397,1407,0.7178393745557925
11719,2015-08-01,99G,1130,425,1555,0.7266881028938906
11720,2015-08-01,99H,1492,1052,2544,0.5864779874213837
11721,2015-08-01,99J,2727,1971,4698,0.5804597701149425
11722,2015-08-01,99K,951,838,1789,0.5315818893236445
11723,2015-08-01,99M,1010,955,1965,0.5139949109414759
11724,2015-08-01,99N,2781,2597,5378,0.5171067311268129
11725,2015-08-01,99P,6143,2531,8674,0.7082084390131427
11726,2015-08-01,99Q,1946,1019,2965,0.6563237774030354
11727,2015-09-01,00C,818,328,1146,0.7137870855148342
11728,2015-09-01,00D,2355,1175,3530,0.6671388101983002
11729,2015-09-01,00J,1864,842,2706,0.688839615668884
11730,2015-09-01,00K,2257,1153,3410,0.6618768328445748
11731,2015-09-01,00L,2155,1357,3512,0.6136104783599089
11732,2015-09-01,00M,2406,1107,3513,0.6848847139197267
11733,2015-09-01,00N,1213,666,1879,0.6455561468866419
11734,2015-09-01,00P,2061,927,2988,0.6897590361445783
11735,2015-09-01,00Q,1067,483,1550,0.6883870967741935
11736,2015-09-01,00R,1176,675,1851,0.6353322528363047
11737,2015-09-01,00T,1961,1167,3128,0.6269181585677749
11738,2015-09-01,00V,1219,983,2202,0.5535876475930972
11739,2015-09-01,00X,1013,415,1428,0.7093837535014006
11740,2015-09-01,00Y,1804,1190,2994,0.6025384101536406
11741,2015-09-01,01A,2463,1492,3955,0.62275600505689
11742,2015-09-01,01C,988,729,1717,0.5754222481071637
11743,2015-09-01,01D,1348,1053,2401,0.56143273635985
11744,2015-09-01,01E,973,312,1285,0.7571984435797665
11745,2015-09-01,01F,945,489,1434,0.6589958158995816
11746,2015-09-01,01G,1218,1450,2668,0.45652173913043476
11747,2015-09-01,01H,2370,983,3353,0.7068297047420221
11748,2015-09-01,01J,1141,620,1761,0.6479273140261215
11749,2015-09-01,01K,2156,1355,3511,0.6140700655084022
11750,2015-09-01,01R,882,715,1597,0.5522855353788353
11751,2015-09-01,01T,843,508,1351,0.6239822353811991
11752,2015-09-01,01V,905,467,1372,0.6596209912536443
11753,2015-09-01,01W,2194,1073,3267,0.6715641261095806
11754,2015-09-01,01X,1423,797,2220,0.640990990990991
11755,2015-09-01,01Y,743,1398,2141,0.34703409621672116
11756,2015-09-01,02A,1342,674,2016,0.6656746031746031
11757,2015-09-01,02D,495,455,950,0.5210526315789473
11758,2015-09-01,02E,1191,734,1925,0.6187012987012988
11759,2015-09-01,02F,1198,1164,2362,0.5071972904318375
11760,2015-09-01,02G,717,388,1105,0.648868778280543
11761,2015-09-01,02H,1562,1609,3171,0.4925890886155787
11762,2015-09-01,02M,1175,564,1739,0.6756756756756757
11763,2015-09-01,02N,1089,716,1805,0.6033240997229917
11764,2015-09-01,02P,1085,1488,2573,0.42168674698795183
11765,2015-09-01,02Q,673,501,1174,0.5732538330494037
11766,2015-09-01,02R,2224,1316,3540,0.6282485875706215
11767,2015-09-01,02T,1261,890,2151,0.5862389586238959
11768,2015-09-01,02V,844,1175,2019,0.4180287270926201
11769,2015-09-01,02W,585,370,955,0.612565445026178
11770,2015-09-01,02X,2126,1018,3144,0.676208651399491
11771,2015-09-01,02Y,2133,964,3097,0.6887310300290603
11772,2015-09-01,03A,1410,926,2336,0.603595890410959
11773,2015-09-01,03C,1302,1819,3121,0.4171739826978533
11774,2015-09-01,03D,933,554,1487,0.6274377942165433
11775,2015-09-01,03E,928,611,1539,0.6029889538661468
11776,2015-09-01,03F,1664,650,2314,0.7191011235955056
11777,2015-09-01,03G,1230,1364,2594,0.47417116422513494
11778,2015-09-01,03H,1313,533,1846,0.7112676056338029
11779,2015-09-01,03J,1205,640,1845,0.6531165311653117
11780,2015-09-01,03K,964,444,1408,0.6846590909090909
11781,2015-09-01,03L,1026,1555,2581,0.39752034095311894
11782,2015-09-01,03M,899,473,1372,0.6552478134110787
11783,2015-09-01,03N,3489,1575,5064,0.6889810426540285
11784,2015-09-01,03Q,1972,1073,3045,0.6476190476190476
11785,2015-09-01,03R,2526,1488,4014,0.6292974588938715
11786,2015-09-01,03T,1775,828,2603,0.6819054936611602
11787,2015-09-01,03V,436,287,723,0.603042876901798
11788,2015-09-01,03W,2348,1278,3626,0.6475455046883618
11789,2015-09-01,03X,404,337,741,0.5452091767881242
11790,2015-09-01,03Y,735,466,1201,0.6119900083263947
11791,2015-09-01,04C,2120,880,3000,0.7066666666666667
11792,2015-09-01,04D,1373,741,2114,0.6494796594134342
11793,2015-09-01,04E,833,1071,1904,0.4375
11794,2015-09-01,04F,1586,1110,2696,0.5882789317507419
11795,2015-09-01,04G,4385,2708,7093,0.6182151416889892
11796,2015-09-01,04H,415,661,1076,0.3856877323420074
11797,2015-09-01,04J,1879,1347,3226,0.5824550526968382
11798,2015-09-01,04K,951,1633,2584,0.36803405572755415
11799,2015-09-01,04L,439,884,1323,0.3318216175359032
11800,2015-09-01,04M,303,495,798,0.37969924812030076
11801,2015-09-01,04N,403,712,1115,0.3614349775784753
11802,2015-09-01,04Q,722,492,1214,0.5947281713344317
11803,2015-09-01,04R,2301,1747,4048,0.5684288537549407
11804,2015-09-01,04V,2316,1200,3516,0.658703071672355
11805,2015-09-01,04X,1272,1187,2459,0.5172834485563237
11806,2015-09-01,04Y,1001,413,1414,0.7079207920792079
11807,2015-09-01,05A,2751,1640,4391,0.6265087679344113
11808,2015-09-01,05C,1254,1813,3067,0.40886860123899577
11809,2015-09-01,05D,1014,475,1489,0.6809939556749496
11810,2015-09-01,05F,1128,892,2020,0.5584158415841585
11811,2015-09-01,05G,1603,648,2251,0.7121279431363838
11812,2015-09-01,05H,1196,662,1858,0.643702906350915
11813,2015-09-01,05J,1441,718,2159,0.667438628994905
11814,2015-09-01,05L,2471,1832,4303,0.5742505228910063
11815,2015-09-01,05N,2196,1071,3267,0.6721763085399449
11816,2015-09-01,05P,1291,891,2182,0.5916590284142988
11817,2015-09-01,05Q,1443,781,2224,0.6488309352517986
11818,2015-09-01,05R,1693,1339,3032,0.558377308707124
11819,2015-09-01,05T,2205,1266,3471,0.6352636127917026
11820,2015-09-01,05V,1082,570,1652,0.6549636803874092
11821,2015-09-01,05W,1925,797,2722,0.7072005878030859
11822,2015-09-01,05X,993,636,1629,0.6095764272559853
11823,2015-09-01,05Y,1882,1085,2967,0.6343107516009437
11824,2015-09-01,06A,1509,841,2350,0.642127659574468
11825,2015-09-01,06D,916,566,1482,0.6180836707152496
11826,2015-09-01,06F,1736,2492,4228,0.4105960264900662
11827,2015-09-01,06H,5408,3104,8512,0.6353383458646616
11828,2015-09-01,06K,3119,3128,6247,0.4992796542340323
11829,2015-09-01,06L,2693,1037,3730,0.7219839142091152
11830,2015-09-01,06M,1945,969,2914,0.6674673987645847
11831,2015-09-01,06N,3344,2921,6265,0.5337589784517158
11832,2015-09-01,06P,953,908,1861,0.5120902740462118
11833,2015-09-01,06Q,2488,1432,3920,0.6346938775510204
11834,2015-09-01,06T,2201,1537,3738,0.5888175494917068
11835,2015-09-01,06V,1433,753,2186,0.6555352241537054
11836,2015-09-01,06W,1439,667,2106,0.6832858499525166
11837,2015-09-01,06Y,1359,677,2036,0.6674852652259332
11838,2015-09-01,07G,1078,410,1488,0.7244623655913979
11839,2015-09-01,07H,1814,1185,2999,0.60486828942981
11840,2015-09-01,07J,871,688,1559,0.5586914688903143
11841,2015-09-01,07K,1592,733,2325,0.6847311827956989
11842,2015-09-01,07L,774,383,1157,0.668971477960242
11843,2015-09-01,07M,1292,1241,2533,0.5100671140939598
11844,2015-09-01,07N,1568,871,2439,0.6428864288642886
11845,2015-09-01,07P,960,709,1669,0.5751947273816657
11846,2015-09-01,07Q,1736,872,2608,0.6656441717791411
11847,2015-09-01,07R,713,682,1395,0.5111111111111111
11848,2015-09-01,07T,673,694,1367,0.49231894659839065
11849,2015-09-01,07V,1310,1496,2806,0.4668567355666429
11850,2015-09-01,07W,1124,977,2101,0.5349833412660637
11851,2015-09-01,07X,1317,754,2071,0.6359246740704974
11852,2015-09-01,07Y,1020,599,1619,0.6300185299567634
11853,2015-09-01,08A,1114,730,1844,0.60412147505423
11854,2015-09-01,08C,743,543,1286,0.5777604976671851
11855,2015-09-01,08D,866,619,1485,0.5831649831649832
11856,2015-09-01,08E,852,730,1582,0.538558786346397
11857,2015-09-01,08F,1599,774,2373,0.6738305941845765
11858,2015-09-01,08G,402,1454,1856,0.2165948275862069
11859,2015-09-01,08H,681,835,1516,0.4492084432717678
11860,2015-09-01,08J,957,455,1412,0.6777620396600567
11861,2015-09-01,08K,1112,899,2011,0.5529587270014918
11862,2015-09-01,08L,705,1433,2138,0.32974742750233865
11863,2015-09-01,08M,1174,639,1813,0.6475455046883618
11864,2015-09-01,08N,1222,599,1821,0.671059857221307
11865,2015-09-01,08P,1064,659,1723,0.6175275681950088
11866,2015-09-01,08Q,788,658,1446,0.5449515905947441
11867,2015-09-01,08R,894,481,1375,0.6501818181818182
11868,2015-09-01,08T,1048,616,1664,0.6298076923076923
11869,2015-09-01,08V,1156,705,1861,0.6211714132186996
11870,2015-09-01,08W,1062,650,1712,0.6203271028037384
11871,2015-09-01,08X,1481,911,2392,0.6191471571906354
11872,2015-09-01,08Y,713,634,1347,0.5293244246473645
11873,2015-09-01,09A,550,769,1319,0.41698256254738436
11874,2015-09-01,09C,728,488,1216,0.5986842105263158
11875,2015-09-01,09D,1296,1154,2450,0.5289795918367347
11876,2015-09-01,09E,1640,791,2431,0.6746194981489099
11877,2015-09-01,09F,1363,772,2135,0.638407494145199
11878,2015-09-01,09G,3727,2025,5752,0.6479485396383866
11879,2015-09-01,09H,660,410,1070,0.616822429906542
11880,2015-09-01,09J,1646,1140,2786,0.5908111988513999
11881,2015-09-01,09L,994,597,1591,0.6247642991829039
11882,2015-09-01,09N,1050,793,1843,0.5697232772653282
11883,2015-09-01,09P,1211,939,2150,0.5632558139534883
11884,2015-09-01,09W,1320,936,2256,0.5851063829787234
11885,2015-09-01,09X,1065,892,1957,0.544200306591722
11886,2015-09-01,09Y,1393,1442,2835,0.49135802469135803
11887,2015-09-01,10A,1371,806,2177,0.6297657326596233
11888,2015-09-01,10C,488,390,878,0.5558086560364465
11889,2015-09-01,10D,660,405,1065,0.6197183098591549
11890,2015-09-01,10E,943,460,1403,0.6721311475409836
11891,2015-09-01,10G,756,425,1181,0.6401354784081287
11892,2015-09-01,10H,1948,1450,3398,0.5732783990582696
11893,2015-09-01,10J,1264,990,2254,0.5607808340727596
11894,2015-09-01,10K,1442,716,2158,0.6682113067655236
11895,2015-09-01,10L,989,428,1417,0.6979534227240649
11896,2015-09-01,10M,523,483,1006,0.5198807157057654
11897,2015-09-01,10N,504,463,967,0.5211995863495347
11898,2015-09-01,10Q,3547,3077,6624,0.5354770531400966
11899,2015-09-01,10R,1460,615,2075,0.7036144578313253
11900,2015-09-01,10T,667,338,1005,0.663681592039801
11901,2015-09-01,10V,1447,799,2246,0.6442564559216385
11902,2015-09-01,10W,584,368,952,0.6134453781512605
11903,2015-09-01,10X,1239,661,1900,0.6521052631578947
11904,2015-09-01,10Y,1324,970,2294,0.5771578029642546
11905,2015-09-01,11A,3604,1980,5584,0.6454154727793696
11906,2015-09-01,11C,933,442,1375,0.6785454545454546
11907,2015-09-01,11D,698,647,1345,0.5189591078066914
11908,2015-09-01,11E,1145,1004,2149,0.532805956258725
11909,2015-09-01,11H,2587,1582,4169,0.6205325017989926
11910,2015-09-01,11J,5515,2535,8050,0.6850931677018633
11911,2015-09-01,11M,4074,2137,6211,0.6559330220576397
11912,2015-09-01,11N,4366,1875,6241,0.6995673770229129
11913,2015-09-01,11T,1585,941,2526,0.6274742676167855
11914,2015-09-01,11X,3419,2185,5604,0.6100999286224126
11915,2015-09-01,12A,1671,892,2563,0.6519703472493172
11916,2015-09-01,12D,1117,952,2069,0.5398743354277429
11917,2015-09-01,12F,2270,910,3180,0.7138364779874213
11918,2015-09-01,13P,2859,2607,5466,0.5230515916575192
11919,2015-09-01,13T,3217,1643,4860,0.6619341563786009
11920,2015-09-01,14L,3003,2030,5033,0.5966620305980529
11921,2015-09-01,99A,3021,1340,4361,0.6927310249942674
11922,2015-09-01,99C,1632,803,2435,0.6702258726899384
11923,2015-09-01,99D,1080,820,1900,0.5684210526315789
11924,2015-09-01,99E,1561,714,2275,0.6861538461538461
11925,2015-09-01,99F,1212,404,1616,0.75
11926,2015-09-01,99G,1142,451,1593,0.7168863779033271
11927,2015-09-01,99H,1567,1152,2719,0.5763148216255977
11928,2015-09-01,99J,2970,2052,5022,0.5913978494623656
11929,2015-09-01,99K,1021,799,1820,0.560989010989011
11930,2015-09-01,99M,1101,969,2070,0.5318840579710145
11931,2015-09-01,99N,2922,2581,5503,0.5309831001272033
11932,2015-09-01,99P,6698,2619,9317,0.7189009337769668
11933,2015-09-01,99Q,2042,1044,3086,0.6616979909267661
11934,2015-10-01,00C,753,350,1103,0.6826835902085222
11935,2015-10-01,00D,2294,1080,3374,0.6799051570835803
11936,2015-10-01,00J,1860,841,2701,0.6886338393187709
11937,2015-10-01,00K,2214,1077,3291,0.6727438468550593
11938,2015-10-01,00L,2366,1499,3865,0.6121604139715394
11939,2015-10-01,00M,2138,1092,3230,0.6619195046439629
11940,2015-10-01,00N,1154,605,1759,0.6560545764639
11941,2015-10-01,00P,2005,878,2883,0.6954561220950399
11942,2015-10-01,00Q,996,519,1515,0.6574257425742575
11943,2015-10-01,00R,1194,733,1927,0.6196159833938765
11944,2015-10-01,00T,1932,1108,3040,0.6355263157894737
11945,2015-10-01,00V,1197,917,2114,0.5662251655629139
11946,2015-10-01,00X,1035,388,1423,0.7273366127898805
11947,2015-10-01,00Y,1698,1181,2879,0.589788120875304
11948,2015-10-01,01A,2390,1334,3724,0.6417830290010741
11949,2015-10-01,01C,1013,796,1809,0.5599778883360973
11950,2015-10-01,01D,1366,989,2355,0.5800424628450106
11951,2015-10-01,01E,1080,384,1464,0.7377049180327869
11952,2015-10-01,01F,867,493,1360,0.6375
11953,2015-10-01,01G,1201,1370,2571,0.46713341112407625
11954,2015-10-01,01H,2427,1121,3548,0.6840473506200676
11955,2015-10-01,01J,1111,621,1732,0.6414549653579676
11956,2015-10-01,01K,2147,1364,3511,0.6115066932497863
11957,2015-10-01,01R,869,768,1637,0.5308491142333537
11958,2015-10-01,01T,801,509,1310,0.6114503816793894
11959,2015-10-01,01V,875,464,1339,0.6534727408513816
11960,2015-10-01,01W,2160,1084,3244,0.6658446362515413
11961,2015-10-01,01X,1501,816,2317,0.6478204574881312
11962,2015-10-01,01Y,741,1374,2115,0.350354609929078
11963,2015-10-01,02A,1282,646,1928,0.6649377593360996
11964,2015-10-01,02D,450,447,897,0.5016722408026756
11965,2015-10-01,02E,1253,790,2043,0.6133137542829172
11966,2015-10-01,02F,1164,1209,2373,0.49051833122629585
11967,2015-10-01,02G,680,352,1032,0.6589147286821705
11968,2015-10-01,02H,1527,1644,3171,0.4815515610217597
11969,2015-10-01,02M,1093,521,1614,0.6771995043370508
11970,2015-10-01,02N,1035,705,1740,0.5948275862068966
11971,2015-10-01,02P,1034,1515,2549,0.4056492742251864
11972,2015-10-01,02Q,661,490,1151,0.5742832319721981
11973,2015-10-01,02R,2116,1333,3449,0.6135111626558423
11974,2015-10-01,02T,1260,928,2188,0.5758683729433273
11975,2015-10-01,02V,829,1193,2022,0.40999010880316517
11976,2015-10-01,02W,620,396,1016,0.610236220472441
11977,2015-10-01,02X,1979,1085,3064,0.64588772845953
11978,2015-10-01,02Y,2071,979,3050,0.679016393442623
11979,2015-10-01,03A,1381,844,2225,0.6206741573033708
11980,2015-10-01,03C,1262,1888,3150,0.4006349206349206
11981,2015-10-01,03D,846,646,1492,0.5670241286863271
11982,2015-10-01,03E,843,581,1424,0.5919943820224719
11983,2015-10-01,03F,1725,726,2451,0.7037943696450428
11984,2015-10-01,03G,1214,1433,2647,0.45863241405364563
11985,2015-10-01,03H,1296,541,1837,0.7054980947196516
11986,2015-10-01,03J,1024,652,1676,0.6109785202863962
11987,2015-10-01,03K,988,459,1447,0.68279198341396
11988,2015-10-01,03L,978,1565,2543,0.38458513566653557
11989,2015-10-01,03M,894,460,1354,0.6602658788774003
11990,2015-10-01,03N,3466,1575,5041,0.6875619916683198
11991,2015-10-01,03Q,2114,1069,3183,0.6641533144831919
11992,2015-10-01,03R,2394,1393,3787,0.6321626617375231
11993,2015-10-01,03T,1804,870,2674,0.674644727000748
11994,2015-10-01,03V,414,322,736,0.5625
11995,2015-10-01,03W,2353,1214,3567,0.6596579758901038
11996,2015-10-01,03X,384,424,808,0.4752475247524752
11997,2015-10-01,03Y,671,469,1140,0.5885964912280702
11998,2015-10-01,04C,2238,844,3082,0.7261518494484102
11999,2015-10-01,04D,1382,817,2199,0.6284674852205548
12000,2015-10-01,04E,699,1225,1924,0.3633056133056133
12001,2015-10-01,04F,1550,1159,2709,0.5721668512366187
12002,2015-10-01,04G,4363,2842,7205,0.6055517002081887
12003,2015-10-01,04H,431,791,1222,0.3527004909983633
12004,2015-10-01,04J,1833,1495,3328,0.55078125
12005,2015-10-01,04K,834,1752,2586,0.3225058004640371
12006,2015-10-01,04L,449,890,1339,0.33532486930545186
12007,2015-10-01,04M,260,511,771,0.33722438391699094
12008,2015-10-01,04N,313,755,1068,0.29307116104868913
12009,2015-10-01,04Q,756,471,1227,0.6161369193154034
12010,2015-10-01,04R,2136,1861,3997,0.5344008006004504
12011,2015-10-01,04V,2508,1231,3739,0.6707675849157528
12012,2015-10-01,04X,1285,1316,2601,0.4940407535563245
12013,2015-10-01,04Y,1044,466,1510,0.6913907284768211
12014,2015-10-01,05A,2897,1715,4612,0.6281439722463139
12015,2015-10-01,05C,1343,1790,3133,0.42866262368337055
12016,2015-10-01,05D,1076,498,1574,0.6836086404066074
12017,2015-10-01,05F,1182,993,2175,0.543448275862069
12018,2015-10-01,05G,1575,613,2188,0.7198354661791591
12019,2015-10-01,05H,1315,663,1978,0.6648129423660263
12020,2015-10-01,05J,1420,702,2122,0.6691800188501413
12021,2015-10-01,05L,2538,1879,4417,0.5745981435363369
12022,2015-10-01,05N,2160,1066,3226,0.6695598264104153
12023,2015-10-01,05P,1011,1122,2133,0.4739803094233474
12024,2015-10-01,05Q,1418,770,2188,0.6480804387568556
12025,2015-10-01,05R,1638,1317,2955,0.5543147208121827
12026,2015-10-01,05T,2100,1274,3374,0.6224066390041494
12027,2015-10-01,05V,1042,556,1598,0.6520650813516896
12028,2015-10-01,05W,1834,829,2663,0.6886969583176868
12029,2015-10-01,05X,974,696,1670,0.5832335329341317
12030,2015-10-01,05Y,1768,1101,2869,0.6162425932380621
12031,2015-10-01,06A,1593,912,2505,0.6359281437125749
12032,2015-10-01,06D,1009,515,1524,0.6620734908136483
12033,2015-10-01,06F,1774,2428,4202,0.4221799143265112
12034,2015-10-01,06H,5623,3368,8991,0.6254031809587365
12035,2015-10-01,06K,3126,3095,6221,0.5024915608423083
12036,2015-10-01,06L,2624,1080,3704,0.7084233261339092
12037,2015-10-01,06M,1952,1030,2982,0.6545942320590208
12038,2015-10-01,06N,3133,2992,6125,0.5115102040816326
12039,2015-10-01,06P,917,963,1880,0.4877659574468085
12040,2015-10-01,06Q,2435,1254,3689,0.6600704798048251
12041,2015-10-01,06T,2092,1650,3742,0.5590593265633351
12042,2015-10-01,06V,1462,733,2195,0.6660592255125285
12043,2015-10-01,06W,1503,747,2250,0.668
12044,2015-10-01,06Y,1356,648,2004,0.6766467065868264
12045,2015-10-01,07G,1074,405,1479,0.7261663286004056
12046,2015-10-01,07H,1815,1200,3015,0.6019900497512438
12047,2015-10-01,07J,952,684,1636,0.5819070904645477
12048,2015-10-01,07K,1648,704,2352,0.7006802721088435
12049,2015-10-01,07L,747,383,1130,0.6610619469026549
12050,2015-10-01,07M,1235,1299,2534,0.48737174427782165
12051,2015-10-01,07N,1548,813,2361,0.6556543837357052
12052,2015-10-01,07P,926,714,1640,0.5646341463414634
12053,2015-10-01,07Q,1711,887,2598,0.6585835257890685
12054,2015-10-01,07R,703,719,1422,0.49437412095639943
12055,2015-10-01,07T,611,808,1419,0.43058491895701195
12056,2015-10-01,07V,1262,1672,2934,0.43012951601908656
12057,2015-10-01,07W,1137,972,2109,0.5391180654338549
12058,2015-10-01,07X,1254,832,2086,0.6011505273250239
12059,2015-10-01,07Y,935,543,1478,0.6326116373477673
12060,2015-10-01,08A,1205,716,1921,0.6272774596564289
12061,2015-10-01,08C,759,592,1351,0.5618060695780903
12062,2015-10-01,08D,932,643,1575,0.5917460317460318
12063,2015-10-01,08E,790,791,1581,0.49968374446552816
12064,2015-10-01,08F,1608,762,2370,0.6784810126582278
12065,2015-10-01,08G,446,1392,1838,0.2426550598476605
12066,2015-10-01,08H,550,930,1480,0.3716216216216216
12067,2015-10-01,08J,945,523,1468,0.6437329700272479
12068,2015-10-01,08K,1127,864,1991,0.5660472124560523
12069,2015-10-01,08L,719,1438,2157,0.3333333333333333
12070,2015-10-01,08M,1295,660,1955,0.6624040920716112
12071,2015-10-01,08N,1274,631,1905,0.6687664041994751
12072,2015-10-01,08P,953,678,1631,0.5843041079092581
12073,2015-10-01,08Q,811,666,1477,0.5490859851049424
12074,2015-10-01,08R,932,501,1433,0.650383810188416
12075,2015-10-01,08T,1030,630,1660,0.6204819277108434
12076,2015-10-01,08V,1038,826,1864,0.5568669527896996
12077,2015-10-01,08W,1100,600,1700,0.6470588235294118
12078,2015-10-01,08X,1458,957,2415,0.6037267080745342
12079,2015-10-01,08Y,699,757,1456,0.4800824175824176
12080,2015-10-01,09A,582,785,1367,0.42574981711777615
12081,2015-10-01,09C,619,591,1210,0.5115702479338843
12082,2015-10-01,09D,1336,1154,2490,0.5365461847389559
12083,2015-10-01,09E,1689,826,2515,0.6715705765407555
12084,2015-10-01,09F,1358,762,2120,0.6405660377358491
12085,2015-10-01,09G,3605,2015,5620,0.641459074733096
12086,2015-10-01,09H,561,398,959,0.5849843587069864
12087,2015-10-01,09J,1632,1158,2790,0.5849462365591398
12088,2015-10-01,09L,908,630,1538,0.5903771131339401
12089,2015-10-01,09N,1096,802,1898,0.5774499473129611
12090,2015-10-01,09P,1261,888,2149,0.5867845509539321
12091,2015-10-01,09W,1425,974,2399,0.5939974989578991
12092,2015-10-01,09X,1042,838,1880,0.5542553191489362
12093,2015-10-01,09Y,1378,1552,2930,0.47030716723549487
12094,2015-10-01,10A,1322,862,2184,0.6053113553113553
12095,2015-10-01,10C,524,366,890,0.5887640449438202
12096,2015-10-01,10D,650,411,1061,0.6126295947219604
12097,2015-10-01,10E,884,460,1344,0.6577380952380952
12098,2015-10-01,10G,736,410,1146,0.6422338568935427
12099,2015-10-01,10H,1902,1428,3330,0.5711711711711712
12100,2015-10-01,10J,1170,891,2061,0.5676855895196506
12101,2015-10-01,10K,1449,734,2183,0.6637654603756299
12102,2015-10-01,10L,975,417,1392,0.7004310344827587
12103,2015-10-01,10M,554,466,1020,0.5431372549019607
12104,2015-10-01,10N,514,461,975,0.5271794871794871
12105,2015-10-01,10Q,3574,3082,6656,0.5369591346153846
12106,2015-10-01,10R,1464,601,2065,0.7089588377723971
12107,2015-10-01,10T,690,387,1077,0.6406685236768802
12108,2015-10-01,10V,1391,781,2172,0.6404235727440147
12109,2015-10-01,10W,656,440,1096,0.5985401459854015
12110,2015-10-01,10X,1212,741,1953,0.620583717357911
12111,2015-10-01,10Y,1310,1024,2334,0.5612682090831191
12112,2015-10-01,11A,3498,1817,5315,0.658137347130762
12113,2015-10-01,11C,937,474,1411,0.6640680368532955
12114,2015-10-01,11D,709,650,1359,0.5217071376011774
12115,2015-10-01,11E,1087,1028,2115,0.5139479905437352
12116,2015-10-01,11H,2770,1677,4447,0.6228918371936136
12117,2015-10-01,11J,5639,2619,8258,0.6828529910389924
12118,2015-10-01,11M,4026,2119,6145,0.6551668022782751
12119,2015-10-01,11N,4278,2030,6308,0.6781864299302474
12120,2015-10-01,11T,1706,1019,2725,0.6260550458715596
12121,2015-10-01,11X,3425,2221,5646,0.6066241586964223
12122,2015-10-01,12A,1572,892,2464,0.637987012987013
12123,2015-10-01,12D,1144,1019,2163,0.5288950531668978
12124,2015-10-01,12F,2361,904,3265,0.7231240428790199
12125,2015-10-01,13P,2695,2918,5613,0.48013539996436844
12126,2015-10-01,13T,3217,1771,4988,0.6449478748997595
12127,2015-10-01,14L,2884,2068,4952,0.5823909531502424
12128,2015-10-01,99A,3100,1360,4460,0.695067264573991
12129,2015-10-01,99C,1599,878,2477,0.6455389584174405
12130,2015-10-01,99D,1143,844,1987,0.5752390538500252
12131,2015-10-01,99E,1688,709,2397,0.7042136003337505
12132,2015-10-01,99F,1269,436,1705,0.7442815249266862
12133,2015-10-01,99G,1128,470,1598,0.7058823529411765
12134,2015-10-01,99H,1582,1174,2756,0.5740203193033382
12135,2015-10-01,99J,3050,1961,5011,0.6086609459189782
12136,2015-10-01,99K,1008,786,1794,0.5618729096989966
12137,2015-10-01,99M,1048,979,2027,0.5170202269363592
12138,2015-10-01,99N,2954,2549,5503,0.5367981101217518
12139,2015-10-01,99P,6323,2702,9025,0.7006094182825485
12140,2015-10-01,99Q,2049,1067,3116,0.6575738125802311
12141,2015-11-01,00C,724,350,1074,0.6741154562383612
12142,2015-11-01,00D,2128,1044,3172,0.6708701134930644
12143,2015-11-01,00J,1849,807,2656,0.6961596385542169
12144,2015-11-01,00K,2007,1021,3028,0.6628137384412153
12145,2015-11-01,00L,2145,1348,3493,0.6140853134841111
12146,2015-11-01,00M,2066,1103,3169,0.6519406752918901
12147,2015-11-01,00N,1199,556,1755,0.6831908831908832
12148,2015-11-01,00P,1947,851,2798,0.6958541815582558
12149,2015-11-01,00Q,932,449,1381,0.6748732802317161
12150,2015-11-01,00R,1106,738,1844,0.5997830802603037
12151,2015-11-01,00T,1830,1034,2864,0.6389664804469274
12152,2015-11-01,00V,1131,917,2048,0.55224609375
12153,2015-11-01,00X,989,398,1387,0.7130497476568133
12154,2015-11-01,00Y,1719,1130,2849,0.6033696033696033
12155,2015-11-01,01A,2376,1331,3707,0.6409495548961425
12156,2015-11-01,01C,933,825,1758,0.5307167235494881
12157,2015-11-01,01D,1269,1050,2319,0.5472186287192755
12158,2015-11-01,01E,1034,418,1452,0.7121212121212122
12159,2015-11-01,01F,878,523,1401,0.6266952177016417
12160,2015-11-01,01G,1175,1370,2545,0.46168958742632615
12161,2015-11-01,01H,2361,1073,3434,0.6875364006988934
12162,2015-11-01,01J,977,600,1577,0.6195307545973368
12163,2015-11-01,01K,2038,1414,3452,0.5903823870220162
12164,2015-11-01,01R,815,780,1595,0.5109717868338558
12165,2015-11-01,01T,790,503,1293,0.6109822119102861
12166,2015-11-01,01V,844,429,1273,0.6630007855459544
12167,2015-11-01,01W,2056,1139,3195,0.6435054773082942
12168,2015-11-01,01X,1387,795,2182,0.6356553620531622
12169,2015-11-01,01Y,739,1271,2010,0.36766169154228856
12170,2015-11-01,02A,1304,633,1937,0.6732059886422302
12171,2015-11-01,02D,477,479,956,0.4989539748953975
12172,2015-11-01,02E,1171,771,1942,0.6029866117404737
12173,2015-11-01,02F,1084,1262,2346,0.4620630861040068
12174,2015-11-01,02G,699,380,1079,0.6478220574606117
12175,2015-11-01,02H,1524,1545,3069,0.4965786901270772
12176,2015-11-01,02M,1066,509,1575,0.6768253968253968
12177,2015-11-01,02N,979,751,1730,0.5658959537572255
12178,2015-11-01,02P,1031,1535,2566,0.40179267342166797
12179,2015-11-01,02Q,603,508,1111,0.5427542754275427
12180,2015-11-01,02R,2005,1274,3279,0.6114669106434889
12181,2015-11-01,02T,1284,876,2160,0.5944444444444444
12182,2015-11-01,02V,895,1198,2093,0.4276158623984711
12183,2015-11-01,02W,575,366,941,0.6110520722635494
12184,2015-11-01,02X,1884,995,2879,0.6543938867662383
12185,2015-11-01,02Y,2028,936,2964,0.6842105263157895
12186,2015-11-01,03A,1376,934,2310,0.5956709956709957
12187,2015-11-01,03C,1157,2005,3162,0.3659076533839342
12188,2015-11-01,03D,745,606,1351,0.5514433752775721
12189,2015-11-01,03E,779,553,1332,0.5848348348348348
12190,2015-11-01,03F,1722,635,2357,0.7305897327110734
12191,2015-11-01,03G,1158,1398,2556,0.45305164319248825
12192,2015-11-01,03H,1273,500,1773,0.7179921037789058
12193,2015-11-01,03J,1229,661,1890,0.6502645502645502
12194,2015-11-01,03K,1004,436,1440,0.6972222222222222
12195,2015-11-01,03L,903,1520,2423,0.37267849773008666
12196,2015-11-01,03M,877,409,1286,0.6819595645412131
12197,2015-11-01,03N,3398,1507,4905,0.6927624872579001
12198,2015-11-01,03Q,1998,1078,3076,0.6495448634590377
12199,2015-11-01,03R,2369,1335,3704,0.6395788336933045
12200,2015-11-01,03T,1730,838,2568,0.6736760124610592
12201,2015-11-01,03V,362,316,678,0.5339233038348082
12202,2015-11-01,03W,2392,1136,3528,0.6780045351473923
12203,2015-11-01,03X,370,388,758,0.48812664907651715
12204,2015-11-01,03Y,645,474,1119,0.5764075067024129
12205,2015-11-01,04C,2008,855,2863,0.7013622074746769
12206,2015-11-01,04D,1399,794,2193,0.6379388964888281
12207,2015-11-01,04E,665,1241,1906,0.34889821615949634
12208,2015-11-01,04F,1451,1063,2514,0.5771678599840891
12209,2015-11-01,04G,4123,2728,6851,0.6018099547511312
12210,2015-11-01,04H,409,743,1152,0.3550347222222222
12211,2015-11-01,04J,1717,1521,3238,0.5302655960469426
12212,2015-11-01,04K,767,1835,2602,0.2947732513451191
12213,2015-11-01,04L,434,846,1280,0.3390625
12214,2015-11-01,04M,262,463,725,0.36137931034482756
12215,2015-11-01,04N,276,808,1084,0.25461254612546125
12216,2015-11-01,04Q,723,450,1173,0.6163682864450127
12217,2015-11-01,04R,2128,1859,3987,0.5337346375721094
12218,2015-11-01,04V,2360,1152,3512,0.6719817767653758
12219,2015-11-01,04X,1114,1352,2466,0.45174371451743717
12220,2015-11-01,04Y,970,441,1411,0.6874557051736357
12221,2015-11-01,05A,2745,1686,4431,0.6194989844278944
12222,2015-11-01,05C,1227,1824,3051,0.40216322517207476
12223,2015-11-01,05D,962,446,1408,0.6832386363636364
12224,2015-11-01,05F,1147,928,2075,0.5527710843373494
12225,2015-11-01,05G,1564,642,2206,0.7089755213055303
12226,2015-11-01,05H,1157,651,1808,0.639933628318584
12227,2015-11-01,05J,1331,723,2054,0.6480038948393378
12228,2015-11-01,05L,2360,1913,4273,0.5523051720102972
12229,2015-11-01,05N,2141,1026,3167,0.6760341016735081
12230,2015-11-01,05P,972,1129,2101,0.46263683960019036
12231,2015-11-01,05Q,1442,759,2201,0.6551567469332121
12232,2015-11-01,05R,1751,1333,3084,0.567769130998703
12233,2015-11-01,05T,1975,1138,3113,0.6344362351429489
12234,2015-11-01,05V,1133,594,1727,0.6560509554140127
12235,2015-11-01,05W,1809,797,2606,0.6941673062164236
12236,2015-11-01,05X,1028,665,1693,0.607206142941524
12237,2015-11-01,05Y,1676,1102,2778,0.6033117350611951
12238,2015-11-01,06A,1444,840,2284,0.6322241681260946
12239,2015-11-01,06D,870,502,1372,0.6341107871720116
12240,2015-11-01,06F,1542,2471,4013,0.3842511836531273
12241,2015-11-01,06H,5467,3084,8551,0.6393404280201146
12242,2015-11-01,06K,3164,3069,6233,0.5076207283811969
12243,2015-11-01,06L,2474,1049,3523,0.7022424070394551
12244,2015-11-01,06M,1852,1003,2855,0.6486865148861646
12245,2015-11-01,06N,2905,2926,5831,0.49819927971188477
12246,2015-11-01,06P,875,875,1750,0.5
12247,2015-11-01,06Q,2249,1222,3471,0.6479400749063671
12248,2015-11-01,06T,2076,1478,3554,0.5841305571187394
12249,2015-11-01,06V,1305,733,2038,0.6403336604514229
12250,2015-11-01,06W,1449,698,2147,0.6748952026082906
12251,2015-11-01,06Y,1230,680,1910,0.643979057591623
12252,2015-11-01,07G,1002,428,1430,0.7006993006993008
12253,2015-11-01,07H,1811,1201,3012,0.601261620185923
12254,2015-11-01,07J,922,669,1591,0.57950974230044
12255,2015-11-01,07K,1514,726,2240,0.6758928571428572
12256,2015-11-01,07L,788,377,1165,0.6763948497854078
12257,2015-11-01,07M,1368,1383,2751,0.49727371864776443
12258,2015-11-01,07N,1537,809,2346,0.6551577152600171
12259,2015-11-01,07P,926,758,1684,0.5498812351543944
12260,2015-11-01,07Q,1655,870,2525,0.6554455445544555
12261,2015-11-01,07R,682,730,1412,0.4830028328611898
12262,2015-11-01,07T,576,863,1439,0.40027797081306465
12263,2015-11-01,07V,1182,1614,2796,0.4227467811158798
12264,2015-11-01,07W,1080,869,1949,0.5541303232426885
12265,2015-11-01,07X,1223,832,2055,0.5951338199513382
12266,2015-11-01,07Y,936,578,1514,0.618229854689564
12267,2015-11-01,08A,1106,687,1793,0.6168432794199665
12268,2015-11-01,08C,707,580,1287,0.5493395493395493
12269,2015-11-01,08D,908,659,1567,0.5794511805998723
12270,2015-11-01,08E,804,798,1602,0.50187265917603
12271,2015-11-01,08F,1556,715,2271,0.6851607221488332
12272,2015-11-01,08G,415,1428,1843,0.22517634291915356
12273,2015-11-01,08H,568,982,1550,0.3664516129032258
12274,2015-11-01,08J,919,555,1474,0.6234735413839891
12275,2015-11-01,08K,1050,979,2029,0.5174963035978315
12276,2015-11-01,08L,720,1521,2241,0.321285140562249
12277,2015-11-01,08M,1184,646,1830,0.6469945355191257
12278,2015-11-01,08N,1183,576,1759,0.672541216600341
12279,2015-11-01,08P,932,646,1578,0.5906210392902408
12280,2015-11-01,08Q,813,706,1519,0.5352205398288348
12281,2015-11-01,08R,846,500,1346,0.6285289747399703
12282,2015-11-01,08T,975,566,1541,0.6327060350421804
12283,2015-11-01,08V,1143,825,1968,0.5807926829268293
12284,2015-11-01,08W,1061,647,1708,0.6211943793911007
12285,2015-11-01,08X,1311,937,2248,0.583185053380783
12286,2015-11-01,08Y,666,633,1299,0.5127020785219399
12287,2015-11-01,09A,538,839,1377,0.39070442992011617
12288,2015-11-01,09C,597,596,1193,0.5004191114836547
12289,2015-11-01,09D,1258,1203,2461,0.5111743193823649
12290,2015-11-01,09E,1572,798,2370,0.6632911392405063
12291,2015-11-01,09F,1281,673,1954,0.6555783009211873
12292,2015-11-01,09G,3569,1929,5498,0.6491451436886141
12293,2015-11-01,09H,533,389,922,0.5780911062906724
12294,2015-11-01,09J,1553,1111,2664,0.5829579579579579
12295,2015-11-01,09L,847,555,1402,0.6041369472182596
12296,2015-11-01,09N,1027,770,1797,0.5715080690038954
12297,2015-11-01,09P,1150,816,1966,0.5849440488301119
12298,2015-11-01,09W,1442,993,2435,0.5921971252566736
12299,2015-11-01,09X,950,908,1858,0.511302475780409
12300,2015-11-01,09Y,1354,1501,2855,0.4742556917688266
12301,2015-11-01,10A,1290,814,2104,0.6131178707224335
12302,2015-11-01,10C,426,320,746,0.5710455764075067
12303,2015-11-01,10D,580,400,980,0.5918367346938775
12304,2015-11-01,10E,866,461,1327,0.6525998492840994
12305,2015-11-01,10G,732,427,1159,0.631578947368421
12306,2015-11-01,10H,1944,1392,3336,0.5827338129496403
12307,2015-11-01,10J,1130,942,2072,0.5453667953667953
12308,2015-11-01,10K,1349,718,2067,0.652636671504596
12309,2015-11-01,10L,922,369,1291,0.7141750580945004
12310,2015-11-01,10M,501,429,930,0.5387096774193548
12311,2015-11-01,10N,441,441,882,0.5
12312,2015-11-01,10Q,3378,3124,6502,0.5195324515533682
12313,2015-11-01,10R,1521,633,2154,0.7061281337047354
12314,2015-11-01,10T,624,336,960,0.65
12315,2015-11-01,10V,1405,810,2215,0.6343115124153499
12316,2015-11-01,10W,574,452,1026,0.5594541910331384
12317,2015-11-01,10X,1203,722,1925,0.6249350649350649
12318,2015-11-01,10Y,1241,926,2167,0.5726811259806184
12319,2015-11-01,11A,3211,1761,4972,0.6458165728077232
12320,2015-11-01,11C,921,422,1343,0.6857781087118392
12321,2015-11-01,11D,682,671,1353,0.5040650406504065
12322,2015-11-01,11E,1100,1068,2168,0.507380073800738
12323,2015-11-01,11H,2743,1613,4356,0.6297061524334252
12324,2015-11-01,11J,5435,2636,8071,0.6733985875356213
12325,2015-11-01,11M,4004,2115,6119,0.6543552868115705
12326,2015-11-01,11N,4095,1899,5994,0.6831831831831832
12327,2015-11-01,11T,1549,986,2535,0.6110453648915187
12328,2015-11-01,11X,3410,2143,5553,0.6140824779398524
12329,2015-11-01,12A,1585,863,2448,0.6474673202614379
12330,2015-11-01,12D,1070,963,2033,0.5263157894736842
12331,2015-11-01,12F,2169,931,3100,0.6996774193548387
12332,2015-11-01,13P,2421,3212,5633,0.4297887448961477
12333,2015-11-01,13T,3114,1615,4729,0.6584901670543455
12334,2015-11-01,14L,2874,2003,4877,0.5892966987902399
12335,2015-11-01,99A,2933,1247,4180,0.7016746411483253
12336,2015-11-01,99C,1538,838,2376,0.6473063973063973
12337,2015-11-01,99D,1103,834,1937,0.5694372741352607
12338,2015-11-01,99E,1606,675,2281,0.7040771591407278
12339,2015-11-01,99F,1191,419,1610,0.739751552795031
12340,2015-11-01,99G,1158,427,1585,0.7305993690851735
12341,2015-11-01,99H,1524,1180,2704,0.5636094674556213
12342,2015-11-01,99J,3045,2049,5094,0.5977620730270907
12343,2015-11-01,99K,973,791,1764,0.5515873015873016
12344,2015-11-01,99M,1053,904,1957,0.5380684721512519
12345,2015-11-01,99N,2961,2625,5586,0.5300751879699248
12346,2015-11-01,99P,6288,2702,8990,0.6994438264738598
12347,2015-11-01,99Q,1935,1019,2954,0.6550440081245769
12348,2015-12-01,00C,758,370,1128,0.6719858156028369
12349,2015-12-01,00D,2210,1165,3375,0.6548148148148148
12350,2015-12-01,00J,1780,863,2643,0.6734771093454408
12351,2015-12-01,00K,2230,1143,3373,0.6611325229765788
12352,2015-12-01,00L,2321,1462,3783,0.6135342320909332
12353,2015-12-01,00M,2338,1140,3478,0.672225416906268
12354,2015-12-01,00N,1172,652,1824,0.6425438596491229
12355,2015-12-01,00P,2021,905,2926,0.6907040328092959
12356,2015-12-01,00Q,1017,486,1503,0.6766467065868264
12357,2015-12-01,00R,1187,715,1902,0.6240799158780231
12358,2015-12-01,00T,1905,1153,3058,0.6229561805101373
12359,2015-12-01,00V,1152,984,2136,0.5393258426966292
12360,2015-12-01,00X,1080,418,1498,0.7209612817089452
12361,2015-12-01,00Y,1758,1273,3031,0.580006598482349
12362,2015-12-01,01A,2246,1423,3669,0.6121559007904062
12363,2015-12-01,01C,989,781,1770,0.5587570621468927
12364,2015-12-01,01D,1307,1037,2344,0.5575938566552902
12365,2015-12-01,01E,1067,351,1418,0.7524682651622003
12366,2015-12-01,01F,864,554,1418,0.609308885754584
12367,2015-12-01,01G,1354,1432,2786,0.48600143575017946
12368,2015-12-01,01H,2496,1085,3581,0.6970120078190449
12369,2015-12-01,01J,1026,688,1714,0.5985997666277713
12370,2015-12-01,01K,2067,1519,3586,0.5764082543223648
12371,2015-12-01,01R,872,817,1689,0.5162818235642392
12372,2015-12-01,01T,762,539,1301,0.5857033051498847
12373,2015-12-01,01V,889,464,1353,0.6570583887657059
12374,2015-12-01,01W,2205,1165,3370,0.6543026706231454
12375,2015-12-01,01X,1522,925,2447,0.6219861054352268
12376,2015-12-01,01Y,751,1358,2109,0.3560929350403035
12377,2015-12-01,02A,1324,692,2016,0.6567460317460317
12378,2015-12-01,02D,497,484,981,0.5066258919469928
12379,2015-12-01,02E,1326,753,2079,0.6378066378066378
12380,2015-12-01,02F,1075,1355,2430,0.44238683127572015
12381,2015-12-01,02G,717,418,1135,0.6317180616740088
12382,2015-12-01,02H,1420,1606,3026,0.46926635822868473
12383,2015-12-01,02M,1092,550,1642,0.6650426309378806
12384,2015-12-01,02N,1049,710,1759,0.5963615690733371
12385,2015-12-01,02P,1110,1602,2712,0.4092920353982301
12386,2015-12-01,02Q,657,501,1158,0.5673575129533679
12387,2015-12-01,02R,2086,1286,3372,0.6186239620403321
12388,2015-12-01,02T,1276,879,2155,0.5921113689095128
12389,2015-12-01,02V,844,1215,2059,0.4099077221952404
12390,2015-12-01,02W,501,384,885,0.5661016949152542
12391,2015-12-01,02X,1960,1057,3017,0.6496519721577726
12392,2015-12-01,02Y,2146,995,3141,0.6832219038522763
12393,2015-12-01,03A,1309,925,2234,0.5859444941808415
12394,2015-12-01,03C,1193,1887,3080,0.3873376623376623
12395,2015-12-01,03D,781,593,1374,0.5684133915574964
12396,2015-12-01,03E,874,590,1464,0.5969945355191257
12397,2015-12-01,03F,1715,735,2450,0.7
12398,2015-12-01,03G,1221,1442,2663,0.4585054449868569
12399,2015-12-01,03H,1223,547,1770,0.6909604519774011
12400,2015-12-01,03J,1167,688,1855,0.6291105121293801
12401,2015-12-01,03K,981,454,1435,0.6836236933797909
12402,2015-12-01,03L,1045,1601,2646,0.3949357520786092
12403,2015-12-01,03M,853,504,1357,0.6285924834193073
12404,2015-12-01,03N,3585,1707,5292,0.677437641723356
12405,2015-12-01,03Q,2020,1105,3125,0.6464
12406,2015-12-01,03R,2478,1401,3879,0.6388244392884764
12407,2015-12-01,03T,1910,840,2750,0.6945454545454546
12408,2015-12-01,03V,467,342,809,0.5772558714462299
12409,2015-12-01,03W,2345,1248,3593,0.652657946006123
12410,2015-12-01,03X,373,421,794,0.46977329974811083
12411,2015-12-01,03Y,746,507,1253,0.5953711093375897
12412,2015-12-01,04C,2069,822,2891,0.7156693185748876
12413,2015-12-01,04D,1393,846,2239,0.6221527467619473
12414,2015-12-01,04E,678,1160,1838,0.36887921653971706
12415,2015-12-01,04F,1586,1100,2686,0.5904690990320178
12416,2015-12-01,04G,4318,2990,7308,0.5908593322386426
12417,2015-12-01,04H,396,752,1148,0.34494773519163763
12418,2015-12-01,04J,1870,1615,3485,0.5365853658536586
12419,2015-12-01,04K,780,1610,2390,0.3263598326359833
12420,2015-12-01,04L,470,863,1333,0.35258814703675917
12421,2015-12-01,04M,280,515,795,0.3522012578616352
12422,2015-12-01,04N,315,762,1077,0.2924791086350975
12423,2015-12-01,04Q,782,482,1264,0.6186708860759493
12424,2015-12-01,04R,2263,1832,4095,0.5526251526251527
12425,2015-12-01,04V,2438,1284,3722,0.6550241805480924
12426,2015-12-01,04X,1190,1363,2553,0.46611829220524875
12427,2015-12-01,04Y,999,437,1436,0.6956824512534819
12428,2015-12-01,05A,2740,1742,4482,0.6113342257920571
12429,2015-12-01,05C,1265,1940,3205,0.39469578783151327
12430,2015-12-01,05D,1020,472,1492,0.6836461126005362
12431,2015-12-01,05F,1125,936,2061,0.5458515283842795
12432,2015-12-01,05G,1707,798,2505,0.681437125748503
12433,2015-12-01,05H,1152,678,1830,0.6295081967213115
12434,2015-12-01,05J,1458,721,2179,0.6691142726021111
12435,2015-12-01,05L,2319,1963,4282,0.5415693601120971
12436,2015-12-01,05N,2409,1114,3523,0.68379222253761
12437,2015-12-01,05P,1010,1185,2195,0.4601366742596811
12438,2015-12-01,05Q,1448,877,2325,0.6227956989247312
12439,2015-12-01,05R,1738,1404,3142,0.5531508593252705
12440,2015-12-01,05T,2207,1395,3602,0.6127151582454192
12441,2015-12-01,05V,1099,627,1726,0.6367323290845887
12442,2015-12-01,05W,1914,867,2781,0.6882416396979504
12443,2015-12-01,05X,980,729,1709,0.5734347571679345
12444,2015-12-01,05Y,1709,1198,2907,0.587891296869625
12445,2015-12-01,06A,1558,827,2385,0.6532494758909854
12446,2015-12-01,06D,917,604,1521,0.6028928336620645
12447,2015-12-01,06F,1915,2504,4419,0.43335596288753114
12448,2015-12-01,06H,5589,3340,8929,0.6259379549781611
12449,2015-12-01,06K,3230,3271,6501,0.4968466389786187
12450,2015-12-01,06L,2644,1030,3674,0.7196516058791508
12451,2015-12-01,06M,1911,973,2884,0.662621359223301
12452,2015-12-01,06N,3152,3153,6305,0.4999206978588422
12453,2015-12-01,06P,921,958,1879,0.4901543374135178
12454,2015-12-01,06Q,2432,1299,3731,0.6518359689091396
12455,2015-12-01,06T,2209,1580,3789,0.5830034309844286
12456,2015-12-01,06V,1491,802,2293,0.6502398604448321
12457,2015-12-01,06W,1472,816,2288,0.6433566433566433
12458,2015-12-01,06Y,1343,837,2180,0.6160550458715597
12459,2015-12-01,07G,942,416,1358,0.6936671575846833
12460,2015-12-01,07H,1916,1275,3191,0.600438733939204
12461,2015-12-01,07J,994,702,1696,0.5860849056603774
12462,2015-12-01,07K,1650,744,2394,0.6892230576441103
12463,2015-12-01,07L,816,398,1214,0.6721581548599671
12464,2015-12-01,07M,1283,1292,2575,0.498252427184466
12465,2015-12-01,07N,1594,860,2454,0.6495517522412388
12466,2015-12-01,07P,926,789,1715,0.5399416909620991
12467,2015-12-01,07Q,1751,948,2699,0.6487587995553908
12468,2015-12-01,07R,659,728,1387,0.47512617159336695
12469,2015-12-01,07T,522,835,1357,0.3846720707442889
12470,2015-12-01,07V,1146,1589,2735,0.4190127970749543
12471,2015-12-01,07W,1188,947,2135,0.556440281030445
12472,2015-12-01,07X,1221,811,2032,0.6008858267716536
12473,2015-12-01,07Y,883,615,1498,0.589452603471295
12474,2015-12-01,08A,1043,701,1744,0.5980504587155964
12475,2015-12-01,08C,748,545,1293,0.5784996133023975
12476,2015-12-01,08D,838,663,1501,0.558294470353098
12477,2015-12-01,08E,869,759,1628,0.5337837837837838
12478,2015-12-01,08F,1447,758,2205,0.6562358276643991
12479,2015-12-01,08G,465,1412,1877,0.2477357485348961
12480,2015-12-01,08H,550,889,1439,0.3822098679638638
12481,2015-12-01,08J,878,582,1460,0.6013698630136987
12482,2015-12-01,08K,991,893,1884,0.5260084925690022
12483,2015-12-01,08L,680,1489,2169,0.3135085292761641
12484,2015-12-01,08M,1144,631,1775,0.6445070422535212
12485,2015-12-01,08N,1214,593,1807,0.6718317653569452
12486,2015-12-01,08P,959,640,1599,0.5997498436522827
12487,2015-12-01,08Q,709,761,1470,0.482312925170068
12488,2015-12-01,08R,933,573,1506,0.6195219123505976
12489,2015-12-01,08T,1071,679,1750,0.612
12490,2015-12-01,08V,1056,819,1875,0.5632
12491,2015-12-01,08W,1057,697,1754,0.6026225769669328
12492,2015-12-01,08X,1309,936,2245,0.5830734966592428
12493,2015-12-01,08Y,633,589,1222,0.5180032733224222
12494,2015-12-01,09A,487,694,1181,0.4123624047417443
12495,2015-12-01,09C,695,620,1315,0.5285171102661597
12496,2015-12-01,09D,1253,1307,2560,0.489453125
12497,2015-12-01,09E,1621,891,2512,0.6453025477707006
12498,2015-12-01,09F,1388,780,2168,0.6402214022140221
12499,2015-12-01,09G,3914,2274,6188,0.6325145442792501
12500,2015-12-01,09H,535,406,941,0.5685441020191286
12501,2015-12-01,09J,1602,1197,2799,0.572347266881029
12502,2015-12-01,09L,1043,643,1686,0.6186239620403321
12503,2015-12-01,09N,1035,844,1879,0.5508249068653539
12504,2015-12-01,09P,1177,874,2051,0.5738664066309117
12505,2015-12-01,09W,1428,1010,2438,0.5857260049220673
12506,2015-12-01,09X,1124,920,2044,0.5499021526418787
12507,2015-12-01,09Y,1455,1489,2944,0.49422554347826086
12508,2015-12-01,10A,1418,885,2303,0.6157186278766826
12509,2015-12-01,10C,524,422,946,0.5539112050739958
12510,2015-12-01,10D,611,426,1037,0.5891996142719382
12511,2015-12-01,10E,876,469,1345,0.6513011152416357
12512,2015-12-01,10G,700,430,1130,0.6194690265486725
12513,2015-12-01,10H,2102,1450,3552,0.5917792792792793
12514,2015-12-01,10J,1124,960,2084,0.5393474088291746
12515,2015-12-01,10K,1399,737,2136,0.6549625468164794
12516,2015-12-01,10L,1018,454,1472,0.6915760869565217
12517,2015-12-01,10M,562,489,1051,0.5347288296860133
12518,2015-12-01,10N,490,494,984,0.49796747967479676
12519,2015-12-01,10Q,3650,3123,6773,0.5389044736453565
12520,2015-12-01,10R,1452,662,2114,0.6868495742667928
12521,2015-12-01,10T,629,418,1047,0.600764087870105
12522,2015-12-01,10V,1501,787,2288,0.6560314685314685
12523,2015-12-01,10W,560,473,1033,0.542110358180058
12524,2015-12-01,10X,1238,820,2058,0.6015549076773566
12525,2015-12-01,10Y,1308,1070,2378,0.5500420521446594
12526,2015-12-01,11A,3720,2094,5814,0.6398348813209495
12527,2015-12-01,11C,876,462,1338,0.6547085201793722
12528,2015-12-01,11D,677,679,1356,0.49926253687315636
12529,2015-12-01,11E,1120,1109,2229,0.5024674742036788
12530,2015-12-01,11H,2861,1724,4585,0.6239912758996728
12531,2015-12-01,11J,5522,2686,8208,0.6727582846003899
12532,2015-12-01,11M,4274,2180,6454,0.6622249767585994
12533,2015-12-01,11N,4064,2333,6397,0.6352977958418008
12534,2015-12-01,11T,1665,1000,2665,0.624765478424015
12535,2015-12-01,11X,3535,2216,5751,0.6146757085724222
12536,2015-12-01,12A,1646,951,2597,0.6338082402772429
12537,2015-12-01,12D,1174,1007,2181,0.5382851902796882
12538,2015-12-01,12F,2374,966,3340,0.7107784431137725
12539,2015-12-01,13P,2376,3144,5520,0.43043478260869567
12540,2015-12-01,13T,3278,1706,4984,0.6577046548956661
12541,2015-12-01,14L,2860,2060,4920,0.5813008130081301
12542,2015-12-01,99A,2852,1437,4289,0.6649568664024248
12543,2015-12-01,99C,1607,850,2457,0.6540496540496541
12544,2015-12-01,99D,1117,876,1993,0.5604616156547918
12545,2015-12-01,99E,1718,726,2444,0.7029459901800328
12546,2015-12-01,99F,1256,447,1703,0.7375220199647681
12547,2015-12-01,99G,1243,507,1750,0.7102857142857143
12548,2015-12-01,99H,1566,1154,2720,0.575735294117647
12549,2015-12-01,99J,3109,1979,5088,0.6110455974842768
12550,2015-12-01,99K,1018,787,1805,0.56398891966759
12551,2015-12-01,99M,1121,992,2113,0.5305253194510176
12552,2015-12-01,99N,3142,2809,5951,0.5279784910099143
12553,2015-12-01,99P,6719,3027,9746,0.6894110404268418
12554,2015-12-01,99Q,2204,1081,3285,0.6709284627092846
12555,2016-01-01,00C,749,259,1008,0.7430555555555556
12556,2016-01-01,00D,2123,1068,3191,0.6653086806643685
12557,2016-01-01,00J,1732,769,2501,0.6925229908036785
12558,2016-01-01,00K,2060,998,3058,0.6736429038587312
12559,2016-01-01,00L,2095,1241,3336,0.6279976019184652
12560,2016-01-01,00M,2193,1060,3253,0.6741469412849678
12561,2016-01-01,00N,1138,614,1752,0.6495433789954338
12562,2016-01-01,00P,1909,807,2716,0.7028718703976435
12563,2016-01-01,00Q,1013,438,1451,0.6981392143349414
12564,2016-01-01,00R,1092,705,1797,0.6076794657762938
12565,2016-01-01,00T,1768,998,2766,0.6391901663051338
12566,2016-01-01,00V,1012,895,1907,0.5306764551651809
12567,2016-01-01,00X,978,345,1323,0.7392290249433107
12568,2016-01-01,00Y,1707,1101,2808,0.6079059829059829
12569,2016-01-01,01A,2245,1277,3522,0.6374219193639977
12570,2016-01-01,01C,864,692,1556,0.5552699228791774
12571,2016-01-01,01D,1238,950,2188,0.5658135283363802
12572,2016-01-01,01E,1005,377,1382,0.7272069464544139
12573,2016-01-01,01F,836,524,1360,0.6147058823529412
12574,2016-01-01,01G,1155,1310,2465,0.4685598377281947
12575,2016-01-01,01H,2420,1019,3439,0.7036929339924397
12576,2016-01-01,01J,830,683,1513,0.5485789821546596
12577,2016-01-01,01K,1891,1454,3345,0.565321375186846
12578,2016-01-01,01R,754,701,1455,0.518213058419244
12579,2016-01-01,01T,724,608,1332,0.5435435435435435
12580,2016-01-01,01V,772,450,1222,0.6317512274959084
12581,2016-01-01,01W,2075,971,3046,0.6812212738017072
12582,2016-01-01,01X,1493,822,2315,0.6449244060475162
12583,2016-01-01,01Y,691,1283,1974,0.35005065856129686
12584,2016-01-01,02A,1200,645,1845,0.6504065040650406
12585,2016-01-01,02D,463,407,870,0.532183908045977
12586,2016-01-01,02E,1163,706,1869,0.6222578919208133
12587,2016-01-01,02F,1074,1280,2354,0.4562446898895497
12588,2016-01-01,02G,609,466,1075,0.5665116279069767
12589,2016-01-01,02H,1446,1526,2972,0.48654104979811574
12590,2016-01-01,02M,1072,507,1579,0.6789107029765674
12591,2016-01-01,02N,906,673,1579,0.5737808739708676
12592,2016-01-01,02P,1000,1460,2460,0.4065040650406504
12593,2016-01-01,02Q,629,485,1114,0.5646319569120287
12594,2016-01-01,02R,1949,1211,3160,0.6167721518987341
12595,2016-01-01,02T,1231,862,2093,0.5881509794553272
12596,2016-01-01,02V,747,1090,1837,0.4066412629286881
12597,2016-01-01,02W,534,361,895,0.5966480446927375
12598,2016-01-01,02X,1820,972,2792,0.6518624641833811
12599,2016-01-01,02Y,2071,966,3037,0.6819229502798815
12600,2016-01-01,03A,1329,909,2238,0.5938337801608579
12601,2016-01-01,03C,1160,1836,2996,0.3871829105473965
12602,2016-01-01,03D,794,546,1340,0.5925373134328358
12603,2016-01-01,03E,786,562,1348,0.5830860534124629
12604,2016-01-01,03F,1646,703,2349,0.7007237122179651
12605,2016-01-01,03G,1052,1325,2377,0.44257467395877154
12606,2016-01-01,03H,1228,471,1699,0.7227781047675103
12607,2016-01-01,03J,1082,648,1730,0.6254335260115607
12608,2016-01-01,03K,946,390,1336,0.7080838323353293
12609,2016-01-01,03L,974,1552,2526,0.38558986539984164
12610,2016-01-01,03M,864,405,1269,0.6808510638297872
12611,2016-01-01,03N,3191,1388,4579,0.6968770473902599
12612,2016-01-01,03Q,1942,1065,3007,0.645826405054872
12613,2016-01-01,03R,2186,1279,3465,0.6308802308802309
12614,2016-01-01,03T,1670,790,2460,0.6788617886178862
12615,2016-01-01,03V,444,316,760,0.5842105263157895
12616,2016-01-01,03W,2265,1140,3405,0.6651982378854625
12617,2016-01-01,03X,323,379,702,0.4601139601139601
12618,2016-01-01,03Y,636,435,1071,0.5938375350140056
12619,2016-01-01,04C,2100,799,2899,0.724387719903415
12620,2016-01-01,04D,1294,759,2053,0.6302971261568436
12621,2016-01-01,04E,704,1182,1886,0.37327677624602335
12622,2016-01-01,04F,1502,1002,2504,0.5998402555910544
12623,2016-01-01,04G,3885,2707,6592,0.5893507281553398
12624,2016-01-01,04H,341,727,1068,0.3192883895131086
12625,2016-01-01,04J,1716,1279,2995,0.5729549248747913
12626,2016-01-01,04K,812,1588,2400,0.3383333333333333
12627,2016-01-01,04L,368,806,1174,0.313458262350937
12628,2016-01-01,04M,244,417,661,0.3691376701966717
12629,2016-01-01,04N,284,684,968,0.29338842975206614
12630,2016-01-01,04Q,712,401,1113,0.6397124887690926
12631,2016-01-01,04R,2029,1736,3765,0.5389110225763613
12632,2016-01-01,04V,2385,1167,3552,0.6714527027027027
12633,2016-01-01,04X,1097,1317,2414,0.4544324772162386
12634,2016-01-01,04Y,945,407,1352,0.6989644970414202
12635,2016-01-01,05A,2498,1638,4136,0.6039651837524178
12636,2016-01-01,05C,1223,1812,3035,0.4029654036243822
12637,2016-01-01,05D,1025,431,1456,0.7039835164835165
12638,2016-01-01,05F,1146,946,2092,0.5478011472275335
12639,2016-01-01,05G,1607,662,2269,0.7082415160863816
12640,2016-01-01,05H,1045,601,1646,0.6348724179829891
12641,2016-01-01,05J,1354,670,2024,0.6689723320158103
12642,2016-01-01,05L,2204,1840,4044,0.5450049455984174
12643,2016-01-01,05N,2191,987,3178,0.6894273127753304
12644,2016-01-01,05P,999,1156,2155,0.46357308584686774
12645,2016-01-01,05Q,1333,816,2149,0.6202885062819916
12646,2016-01-01,05R,1644,1264,2908,0.5653370013755158
12647,2016-01-01,05T,2022,1145,3167,0.6384591095674139
12648,2016-01-01,05V,1018,603,1621,0.6280074028377545
12649,2016-01-01,05W,1927,788,2715,0.7097605893186004
12650,2016-01-01,05X,981,567,1548,0.6337209302325582
12651,2016-01-01,05Y,1588,1160,2748,0.5778748180494906
12652,2016-01-01,06A,1493,826,2319,0.64381198792583
12653,2016-01-01,06D,846,490,1336,0.6332335329341318
12654,2016-01-01,06F,1743,2304,4047,0.4306893995552261
12655,2016-01-01,06H,5207,3036,8243,0.6316874924178091
12656,2016-01-01,06K,3134,3049,6183,0.5068736859129872
12657,2016-01-01,06L,2441,994,3435,0.7106259097525474
12658,2016-01-01,06M,1755,991,2746,0.6391114348142753
12659,2016-01-01,06N,2938,2865,5803,0.5062898500775461
12660,2016-01-01,06P,897,811,1708,0.525175644028103
12661,2016-01-01,06Q,2306,1245,3551,0.6493945367502112
12662,2016-01-01,06T,2004,1555,3559,0.5630795167181792
12663,2016-01-01,06V,1351,717,2068,0.6532882011605415
12664,2016-01-01,06W,1504,804,2308,0.6516464471403813
12665,2016-01-01,06Y,1210,784,1994,0.6068204613841525
12666,2016-01-01,07G,890,371,1261,0.7057890563045203
12667,2016-01-01,07H,1696,1121,2817,0.6020589279375221
12668,2016-01-01,07J,968,628,1596,0.606516290726817
12669,2016-01-01,07K,1468,672,2140,0.685981308411215
12670,2016-01-01,07L,749,306,1055,0.7099526066350711
12671,2016-01-01,07M,1225,1124,2349,0.5214985100042572
12672,2016-01-01,07N,1511,762,2273,0.6647602287725473
12673,2016-01-01,07P,877,675,1552,0.5650773195876289
12674,2016-01-01,07Q,1576,818,2394,0.658312447786132
12675,2016-01-01,07R,669,720,1389,0.4816414686825054
12676,2016-01-01,07T,553,791,1344,0.4114583333333333
12677,2016-01-01,07V,1197,1539,2736,0.4375
12678,2016-01-01,07W,1150,802,1952,0.5891393442622951
12679,2016-01-01,07X,1238,753,1991,0.6217980914113511
12680,2016-01-01,07Y,955,498,1453,0.6572608396421198
12681,2016-01-01,08A,1010,654,1664,0.6069711538461539
12682,2016-01-01,08C,733,510,1243,0.589702333065165
12683,2016-01-01,08D,844,623,1467,0.5753237900477164
12684,2016-01-01,08E,855,683,1538,0.5559167750325098
12685,2016-01-01,08F,1429,696,2125,0.6724705882352942
12686,2016-01-01,08G,430,1253,1683,0.25549613784907904
12687,2016-01-01,08H,529,750,1279,0.41360437842064113
12688,2016-01-01,08J,856,541,1397,0.6127415891195419
12689,2016-01-01,08K,1084,892,1976,0.548582995951417
12690,2016-01-01,08L,708,1325,2033,0.34825381210034434
12691,2016-01-01,08M,1184,579,1763,0.6715825297787862
12692,2016-01-01,08N,1138,567,1705,0.6674486803519062
12693,2016-01-01,08P,896,621,1517,0.5906394199077126
12694,2016-01-01,08Q,792,658,1450,0.5462068965517242
12695,2016-01-01,08R,893,510,1403,0.6364932287954383
12696,2016-01-01,08T,1003,599,1602,0.6260923845193508
12697,2016-01-01,08V,1153,865,2018,0.5713577799801784
12698,2016-01-01,08W,969,651,1620,0.5981481481481481
12699,2016-01-01,08X,1358,913,2271,0.5979744605900484
12700,2016-01-01,08Y,677,498,1175,0.5761702127659575
12701,2016-01-01,09A,545,610,1155,0.47186147186147187
12702,2016-01-01,09C,631,580,1211,0.5210569777043765
12703,2016-01-01,09D,1127,1144,2271,0.496257155438133
12704,2016-01-01,09E,1492,856,2348,0.6354344122657581
12705,2016-01-01,09F,1251,678,1929,0.6485225505443235
12706,2016-01-01,09G,3583,1942,5525,0.6485067873303167
12707,2016-01-01,09H,564,400,964,0.5850622406639004
12708,2016-01-01,09J,1445,1113,2558,0.5648944487881157
12709,2016-01-01,09L,897,581,1478,0.6069012178619756
12710,2016-01-01,09N,1059,752,1811,0.5847598012147984
12711,2016-01-01,09P,1074,893,1967,0.5460091509913574
12712,2016-01-01,09W,1437,908,2345,0.6127931769722814
12713,2016-01-01,09X,1029,786,1815,0.5669421487603306
12714,2016-01-01,09Y,1337,1322,2659,0.5028206092515983
12715,2016-01-01,10A,1159,806,1965,0.5898218829516539
12716,2016-01-01,10C,471,337,808,0.5829207920792079
12717,2016-01-01,10D,585,380,965,0.6062176165803109
12718,2016-01-01,10E,881,445,1326,0.6644042232277526
12719,2016-01-01,10G,698,405,1103,0.6328195829555757
12720,2016-01-01,10H,1959,1323,3282,0.596892138939671
12721,2016-01-01,10J,1095,805,1900,0.5763157894736842
12722,2016-01-01,10K,1311,656,1967,0.6664972038637519
12723,2016-01-01,10L,899,402,1301,0.6910069177555727
12724,2016-01-01,10M,514,406,920,0.558695652173913
12725,2016-01-01,10N,441,439,880,0.5011363636363636
12726,2016-01-01,10Q,3429,2748,6177,0.5551238465274405
12727,2016-01-01,10R,1382,581,1963,0.7040244523688233
12728,2016-01-01,10T,585,327,912,0.6414473684210527
12729,2016-01-01,10V,1298,728,2026,0.6406712734452122
12730,2016-01-01,10W,549,359,908,0.6046255506607929
12731,2016-01-01,10X,1172,720,1892,0.6194503171247357
12732,2016-01-01,10Y,1212,937,2149,0.563983248022336
12733,2016-01-01,11A,3238,1742,4980,0.6502008032128515
12734,2016-01-01,11C,848,404,1252,0.6773162939297125
12735,2016-01-01,11D,728,589,1317,0.5527714502657555
12736,2016-01-01,11E,1077,909,1986,0.5422960725075529
12737,2016-01-01,11H,2753,1579,4332,0.6355032317636196
12738,2016-01-01,11J,5227,2526,7753,0.6741906358828841
12739,2016-01-01,11M,4001,2014,6015,0.6651704073150457
12740,2016-01-01,11N,3384,2467,5851,0.5783626730473423
12741,2016-01-01,11T,1446,883,2329,0.6208673250322027
12742,2016-01-01,11X,3315,1905,5220,0.6350574712643678
12743,2016-01-01,12A,1464,816,2280,0.6421052631578947
12744,2016-01-01,12D,1132,885,2017,0.5612295488349033
12745,2016-01-01,12F,2323,805,3128,0.7426470588235294
12746,2016-01-01,13P,2455,3094,5549,0.4424220580284736
12747,2016-01-01,13T,3048,1513,4561,0.668274501205876
12748,2016-01-01,14L,2744,1927,4671,0.587454506529651
12749,2016-01-01,99A,2517,1472,3989,0.6309852093256455
12750,2016-01-01,99C,1545,663,2208,0.6997282608695652
12751,2016-01-01,99D,1132,828,1960,0.5775510204081633
12752,2016-01-01,99E,1573,625,2198,0.7156505914467698
12753,2016-01-01,99F,1225,466,1691,0.7244234180958014
12754,2016-01-01,99G,1150,452,1602,0.717852684144819
12755,2016-01-01,99H,1467,1054,2521,0.5819119397064657
12756,2016-01-01,99J,3050,1860,4910,0.6211812627291242
12757,2016-01-01,99K,925,763,1688,0.5479857819905213
12758,2016-01-01,99M,1154,900,2054,0.5618305744888024
12759,2016-01-01,99N,2879,2445,5324,0.5407588279489106
12760,2016-01-01,99P,6071,2600,8671,0.7001499250374813
12761,2016-01-01,99Q,1915,934,2849,0.6721656721656721
12762,2016-02-01,00C,691,315,1006,0.6868787276341949
12763,2016-02-01,00D,2062,1020,3082,0.6690460739779364
12764,2016-02-01,00J,1691,798,2489,0.6793893129770993
12765,2016-02-01,00K,2069,1044,3113,0.6646321876003854
12766,2016-02-01,00L,2001,1208,3209,0.6235587410408227
12767,2016-02-01,00M,2173,1109,3282,0.662096282754418
12768,2016-02-01,00N,1052,521,1573,0.6687857596948507
12769,2016-02-01,00P,1866,759,2625,0.7108571428571429
12770,2016-02-01,00Q,964,444,1408,0.6846590909090909
12771,2016-02-01,00R,1055,696,1751,0.6025128498001142
12772,2016-02-01,00T,1743,1029,2772,0.6287878787878788
12773,2016-02-01,00V,1070,869,1939,0.5518308406395049
12774,2016-02-01,00X,1001,392,1393,0.7185929648241206
12775,2016-02-01,00Y,1557,1154,2711,0.5743268166728145
12776,2016-02-01,01A,2194,1227,3421,0.6413329435837475
12777,2016-02-01,01C,877,655,1532,0.5724543080939948
12778,2016-02-01,01D,1245,923,2168,0.5742619926199262
12779,2016-02-01,01E,992,373,1365,0.7267399267399267
12780,2016-02-01,01F,826,513,1339,0.6168782673637042
12781,2016-02-01,01G,1159,1237,2396,0.4837228714524207
12782,2016-02-01,01H,2193,1010,3203,0.6846706212925382
12783,2016-02-01,01J,912,641,1553,0.5872504829362524
12784,2016-02-01,01K,1785,1458,3243,0.5504162812210915
12785,2016-02-01,01R,778,645,1423,0.5467322557976106
12786,2016-02-01,01T,669,576,1245,0.5373493975903615
12787,2016-02-01,01V,677,504,1181,0.5732430143945809
12788,2016-02-01,01W,2007,1026,3033,0.6617210682492581
12789,2016-02-01,01X,1509,841,2350,0.642127659574468
12790,2016-02-01,01Y,704,1199,1903,0.3699421965317919
12791,2016-02-01,02A,1043,661,1704,0.6120892018779343
12792,2016-02-01,02D,446,407,853,0.5228604923798359
12793,2016-02-01,02E,1106,693,1799,0.6147859922178989
12794,2016-02-01,02F,1099,1195,2294,0.479075850043592
12795,2016-02-01,02G,599,429,1028,0.5826848249027238
12796,2016-02-01,02H,1451,1448,2899,0.500517419799931
12797,2016-02-01,02M,1031,517,1548,0.6660206718346253
12798,2016-02-01,02N,915,620,1535,0.5960912052117264
12799,2016-02-01,02P,1048,1503,2551,0.41081928655429245
12800,2016-02-01,02Q,570,535,1105,0.5158371040723982
12801,2016-02-01,02R,1940,1144,3084,0.62905317769131
12802,2016-02-01,02T,1180,765,1945,0.6066838046272494
12803,2016-02-01,02V,662,1090,1752,0.3778538812785388
12804,2016-02-01,02W,563,379,942,0.5976645435244161
12805,2016-02-01,02X,1866,898,2764,0.6751085383502171
12806,2016-02-01,02Y,1952,877,2829,0.6899964651820432
12807,2016-02-01,03A,1308,823,2131,0.6137963397465979
12808,2016-02-01,03C,1141,1805,2946,0.38730482009504413
12809,2016-02-01,03D,771,489,1260,0.611904761904762
12810,2016-02-01,03E,819,540,1359,0.6026490066225165
12811,2016-02-01,03F,1625,609,2234,0.7273948075201433
12812,2016-02-01,03G,1124,1370,2494,0.45068163592622296
12813,2016-02-01,03H,1228,481,1709,0.7185488589818607
12814,2016-02-01,03J,986,619,1605,0.6143302180685358
12815,2016-02-01,03K,930,369,1299,0.7159353348729792
12816,2016-02-01,03L,866,1567,2433,0.35593916974928075
12817,2016-02-01,03M,864,391,1255,0.6884462151394423
12818,2016-02-01,03N,3214,1507,4721,0.6807879686507096
12819,2016-02-01,03Q,1910,1050,2960,0.6452702702702703
12820,2016-02-01,03R,2137,1218,3355,0.6369597615499255
12821,2016-02-01,03T,1743,856,2599,0.6706425548287803
12822,2016-02-01,03V,368,305,673,0.5468053491827637
12823,2016-02-01,03W,2128,1131,3259,0.6529610309911016
12824,2016-02-01,03X,327,345,672,0.48660714285714285
12825,2016-02-01,03Y,632,465,1097,0.5761166818596172
12826,2016-02-01,04C,1926,798,2724,0.7070484581497798
12827,2016-02-01,04D,1277,742,2019,0.6324913323427439
12828,2016-02-01,04E,616,1116,1732,0.3556581986143187
12829,2016-02-01,04F,1434,977,2411,0.5947739527167151
12830,2016-02-01,04G,3717,2691,6408,0.5800561797752809
12831,2016-02-01,04H,369,684,1053,0.3504273504273504
12832,2016-02-01,04J,1713,1301,3014,0.5683477106834771
12833,2016-02-01,04K,730,1714,2444,0.2986906710310966
12834,2016-02-01,04L,358,831,1189,0.3010933557611438
12835,2016-02-01,04M,233,384,617,0.37763371150729336
12836,2016-02-01,04N,280,658,938,0.29850746268656714
12837,2016-02-01,04Q,715,476,1191,0.600335852225021
12838,2016-02-01,04R,1971,1746,3717,0.5302663438256658
12839,2016-02-01,04V,2309,1148,3457,0.6679201619901649
12840,2016-02-01,04X,1160,1338,2498,0.4643714971977582
12841,2016-02-01,04Y,959,405,1364,0.7030791788856305
12842,2016-02-01,05A,2380,1665,4045,0.588380716934487
12843,2016-02-01,05C,1063,1819,2882,0.3688410825815406
12844,2016-02-01,05D,966,470,1436,0.6727019498607242
12845,2016-02-01,05F,1078,903,1981,0.5441696113074205
12846,2016-02-01,05G,1551,667,2218,0.6992786293958522
12847,2016-02-01,05H,1110,619,1729,0.6419895893580104
12848,2016-02-01,05J,1430,750,2180,0.6559633027522935
12849,2016-02-01,05L,2292,1892,4184,0.5478011472275335
12850,2016-02-01,05N,2105,1018,3123,0.6740313800832533
12851,2016-02-01,05P,883,1093,1976,0.44686234817813764
12852,2016-02-01,05Q,1345,736,2081,0.6463238827486785
12853,2016-02-01,05R,1578,1163,2741,0.5757022984312294
12854,2016-02-01,05T,1950,1185,3135,0.6220095693779905
12855,2016-02-01,05V,910,564,1474,0.6173677069199457
12856,2016-02-01,05W,1916,844,2760,0.6942028985507246
12857,2016-02-01,05X,955,598,1553,0.6149388280746941
12858,2016-02-01,05Y,1496,1092,2588,0.5780525502318392
12859,2016-02-01,06A,1330,806,2136,0.6226591760299626
12860,2016-02-01,06D,842,541,1383,0.6088214027476501
12861,2016-02-01,06F,1710,2213,3923,0.43589089982156515
12862,2016-02-01,06H,5093,2954,8047,0.6329066732943954
12863,2016-02-01,06K,2927,2958,5885,0.4973661852166525
12864,2016-02-01,06L,2455,937,3392,0.7237617924528302
12865,2016-02-01,06M,1812,906,2718,0.6666666666666666
12866,2016-02-01,06N,2936,2770,5706,0.514546091833158
12867,2016-02-01,06P,861,828,1689,0.5097690941385435
12868,2016-02-01,06Q,2248,1177,3425,0.6563503649635036
12869,2016-02-01,06T,2054,1471,3525,0.5826950354609929
12870,2016-02-01,06V,1388,651,2039,0.6807258460029426
12871,2016-02-01,06W,1365,767,2132,0.6402439024390244
12872,2016-02-01,06Y,1171,722,1893,0.618594823032224
12873,2016-02-01,07G,862,374,1236,0.6974110032362459
12874,2016-02-01,07H,1659,1084,2743,0.6048122493620124
12875,2016-02-01,07J,928,581,1509,0.6149768058316766
12876,2016-02-01,07K,1415,645,2060,0.6868932038834952
12877,2016-02-01,07L,663,336,999,0.6636636636636637
12878,2016-02-01,07M,1207,1138,2345,0.5147121535181237
12879,2016-02-01,07N,1427,761,2188,0.6521937842778793
12880,2016-02-01,07P,889,733,1622,0.5480887792848336
12881,2016-02-01,07Q,1627,862,2489,0.6536761751707513
12882,2016-02-01,07R,662,703,1365,0.484981684981685
12883,2016-02-01,07T,586,728,1314,0.4459665144596651
12884,2016-02-01,07V,1129,1532,2661,0.42427658774896654
12885,2016-02-01,07W,1081,824,1905,0.5674540682414698
12886,2016-02-01,07X,1248,786,2034,0.6135693215339233
12887,2016-02-01,07Y,891,530,1421,0.6270232230823364
12888,2016-02-01,08A,1072,647,1719,0.6236183827806865
12889,2016-02-01,08C,670,507,1177,0.5692438402718777
12890,2016-02-01,08D,848,532,1380,0.6144927536231884
12891,2016-02-01,08E,820,665,1485,0.5521885521885522
12892,2016-02-01,08F,1358,737,2095,0.6482100238663484
12893,2016-02-01,08G,445,1429,1874,0.23745997865528282
12894,2016-02-01,08H,559,797,1356,0.41224188790560473
12895,2016-02-01,08J,786,567,1353,0.5809312638580931
12896,2016-02-01,08K,1119,850,1969,0.5683087861858812
12897,2016-02-01,08L,640,1264,1904,0.33613445378151263
12898,2016-02-01,08M,1155,651,1806,0.6395348837209303
12899,2016-02-01,08N,1098,581,1679,0.653960690887433
12900,2016-02-01,08P,853,620,1473,0.5790902919212492
12901,2016-02-01,08Q,757,687,1444,0.5242382271468145
12902,2016-02-01,08R,850,537,1387,0.6128334534967556
12903,2016-02-01,08T,1000,597,1597,0.6261740763932373
12904,2016-02-01,08V,1074,812,1886,0.5694591728525981
12905,2016-02-01,08W,986,671,1657,0.5950512975256488
12906,2016-02-01,08X,1225,935,2160,0.5671296296296297
12907,2016-02-01,08Y,717,468,1185,0.6050632911392405
12908,2016-02-01,09A,533,638,1171,0.4551665243381725
12909,2016-02-01,09C,628,582,1210,0.5190082644628099
12910,2016-02-01,09D,1178,1189,2367,0.49767638360794253
12911,2016-02-01,09E,1472,808,2280,0.6456140350877193
12912,2016-02-01,09F,1268,648,1916,0.6617954070981211
12913,2016-02-01,09G,3503,1979,5482,0.6390003648303539
12914,2016-02-01,09H,539,348,887,0.6076662908680946
12915,2016-02-01,09J,1570,1133,2703,0.5808361080281169
12916,2016-02-01,09L,837,609,1446,0.578838174273859
12917,2016-02-01,09N,960,743,1703,0.5637110980622431
12918,2016-02-01,09P,1051,857,1908,0.55083857442348
12919,2016-02-01,09W,1341,951,2292,0.5850785340314136
12920,2016-02-01,09X,994,770,1764,0.5634920634920635
12921,2016-02-01,09Y,1275,1328,2603,0.4898194391087207
12922,2016-02-01,10A,1180,819,1999,0.5902951475737869
12923,2016-02-01,10C,473,344,817,0.5789473684210527
12924,2016-02-01,10D,579,404,983,0.5890132248219736
12925,2016-02-01,10E,756,431,1187,0.636899747262005
12926,2016-02-01,10G,707,394,1101,0.6421435059037239
12927,2016-02-01,10H,1809,1250,3059,0.5913697286694999
12928,2016-02-01,10J,1075,838,1913,0.5619445896497648
12929,2016-02-01,10K,1354,621,1975,0.6855696202531646
12930,2016-02-01,10L,972,441,1413,0.6878980891719745
12931,2016-02-01,10M,501,407,908,0.551762114537445
12932,2016-02-01,10N,445,444,889,0.500562429696288
12933,2016-02-01,10Q,3366,2759,6125,0.5495510204081633
12934,2016-02-01,10R,1401,559,1960,0.7147959183673469
12935,2016-02-01,10T,582,355,937,0.6211312700106724
12936,2016-02-01,10V,1266,705,1971,0.6423135464231354
12937,2016-02-01,10W,499,377,876,0.569634703196347
12938,2016-02-01,10X,1123,751,1874,0.5992529348986126
12939,2016-02-01,10Y,1147,984,2131,0.5382449554199906
12940,2016-02-01,11A,3101,1741,4842,0.6404378356051218
12941,2016-02-01,11C,834,393,1227,0.6797066014669927
12942,2016-02-01,11D,658,591,1249,0.5268214571657326
12943,2016-02-01,11E,925,983,1908,0.48480083857442346
12944,2016-02-01,11H,2643,1555,4198,0.6295855169128156
12945,2016-02-01,11J,5187,2559,7746,0.6696359411309063
12946,2016-02-01,11M,3827,1990,5817,0.6578992607873474
12947,2016-02-01,11N,3220,2649,5869,0.548645425115011
12948,2016-02-01,11T,1500,823,2323,0.6457167455876023
12949,2016-02-01,11X,3198,2014,5212,0.613584036838066
12950,2016-02-01,12A,1451,856,2307,0.6289553532726485
12951,2016-02-01,12D,1234,924,2158,0.571825764596849
12952,2016-02-01,12F,2207,902,3109,0.7098745577356063
12953,2016-02-01,13P,2327,3053,5380,0.4325278810408922
12954,2016-02-01,13T,3039,1541,4580,0.6635371179039301
12955,2016-02-01,14L,2744,2030,4774,0.5747800586510264
12956,2016-02-01,99A,2381,1652,4033,0.5903793701958839
12957,2016-02-01,99C,1420,726,2146,0.6616961789375583
12958,2016-02-01,99D,1055,815,1870,0.5641711229946524
12959,2016-02-01,99E,1555,664,2219,0.7007661108607481
12960,2016-02-01,99F,1028,376,1404,0.7321937321937322
12961,2016-02-01,99G,1080,435,1515,0.7128712871287128
12962,2016-02-01,99H,1488,1067,2555,0.5823874755381605
12963,2016-02-01,99J,2835,1832,4667,0.6074566102421256
12964,2016-02-01,99K,937,768,1705,0.5495601173020528
12965,2016-02-01,99M,979,862,1841,0.5317762085822922
12966,2016-02-01,99N,2731,2441,5172,0.5280355761794276
12967,2016-02-01,99P,5871,2594,8465,0.6935617247489664
12968,2016-02-01,99Q,1836,885,2721,0.6747519294377067
12969,2016-03-01,00C,792,294,1086,0.7292817679558011
12970,2016-03-01,00D,2182,1121,3303,0.6606115652437178
12971,2016-03-01,00J,1706,857,2563,0.6656262192742879
12972,2016-03-01,00K,2269,1093,3362,0.6748958953004164
12973,2016-03-01,00L,2098,1349,3447,0.6086451987235277
12974,2016-03-01,00M,2153,1091,3244,0.6636868064118372
12975,2016-03-01,00N,1159,594,1753,0.6611523103251569
12976,2016-03-01,00P,2035,834,2869,0.7093063785291042
12977,2016-03-01,00Q,1000,469,1469,0.6807351940095303
12978,2016-03-01,00R,1066,720,1786,0.5968645016797313
12979,2016-03-01,00T,1900,1154,3054,0.6221349050425671
12980,2016-03-01,00V,1096,882,1978,0.5540950455005056
12981,2016-03-01,00X,1007,363,1370,0.7350364963503649
12982,2016-03-01,00Y,1537,1201,2738,0.5613586559532505
12983,2016-03-01,01A,2209,1233,3442,0.6417780360255665
12984,2016-03-01,01C,880,765,1645,0.5349544072948328
12985,2016-03-01,01D,1210,906,2116,0.5718336483931947
12986,2016-03-01,01E,1023,382,1405,0.7281138790035587
12987,2016-03-01,01F,791,552,1343,0.5889798957557707
12988,2016-03-01,01G,1200,1371,2571,0.46674445740956827
12989,2016-03-01,01H,2341,1030,3371,0.6944526846633047
12990,2016-03-01,01J,970,749,1719,0.564281559045957
12991,2016-03-01,01K,1811,1552,3363,0.5385072851620577
12992,2016-03-01,01R,802,748,1550,0.5174193548387097
12993,2016-03-01,01T,736,605,1341,0.5488441461595824
12994,2016-03-01,01V,698,457,1155,0.6043290043290044
12995,2016-03-01,01W,1983,1014,2997,0.6616616616616616
12996,2016-03-01,01X,1406,874,2280,0.6166666666666667
12997,2016-03-01,01Y,800,1251,2051,0.3900536323744515
12998,2016-03-01,02A,1179,685,1864,0.6325107296137339
12999,2016-03-01,02D,500,440,940,0.5319148936170213
13000,2016-03-01,02E,1151,796,1947,0.591165896250642
13001,2016-03-01,02F,1096,1208,2304,0.4756944444444444
13002,2016-03-01,02G,590,518,1108,0.5324909747292419
13003,2016-03-01,02H,1534,1467,3001,0.5111629456847717
13004,2016-03-01,02M,1026,549,1575,0.6514285714285715
13005,2016-03-01,02N,980,654,1634,0.5997552019583844
13006,2016-03-01,02P,961,1492,2453,0.3917651854871586
13007,2016-03-01,02Q,589,538,1127,0.5226264418811003
13008,2016-03-01,02R,2008,1300,3308,0.6070133010882709
13009,2016-03-01,02T,1279,827,2106,0.6073124406457739
13010,2016-03-01,02V,670,1092,1762,0.38024971623155507
13011,2016-03-01,02W,552,395,947,0.5828933474128828
13012,2016-03-01,02X,1905,998,2903,0.6562177058215639
13013,2016-03-01,02Y,2037,980,3017,0.6751740139211136
13014,2016-03-01,03A,1320,834,2154,0.6128133704735376
13015,2016-03-01,03C,1179,1809,2988,0.39457831325301207
13016,2016-03-01,03D,834,537,1371,0.6083150984682714
13017,2016-03-01,03E,824,506,1330,0.6195488721804512
13018,2016-03-01,03F,1742,682,2424,0.7186468646864687
13019,2016-03-01,03G,999,1334,2333,0.428204029147021
13020,2016-03-01,03H,1258,480,1738,0.7238204833141542
13021,2016-03-01,03J,1011,633,1644,0.614963503649635
13022,2016-03-01,03K,950,403,1353,0.7021433850702143
13023,2016-03-01,03L,979,1687,2666,0.36721680420105024
13024,2016-03-01,03M,859,427,1286,0.6679626749611197
13025,2016-03-01,03N,3154,1436,4590,0.6871459694989107
13026,2016-03-01,03Q,1936,1081,3017,0.6416970500497182
13027,2016-03-01,03R,2255,1309,3564,0.6327160493827161
13028,2016-03-01,03T,1811,893,2704,0.6697485207100592
13029,2016-03-01,03V,390,272,662,0.5891238670694864
13030,2016-03-01,03W,2198,1151,3349,0.6563153180053748
13031,2016-03-01,03X,324,431,755,0.4291390728476821
13032,2016-03-01,03Y,728,507,1235,0.5894736842105263
13033,2016-03-01,04C,2095,860,2955,0.7089678510998308
13034,2016-03-01,04D,1331,797,2128,0.6254699248120301
13035,2016-03-01,04E,650,1257,1907,0.34084950183534346
13036,2016-03-01,04F,1477,1065,2542,0.5810385523210071
13037,2016-03-01,04G,3877,2842,6719,0.577020389938979
13038,2016-03-01,04H,413,716,1129,0.36581045172719223
13039,2016-03-01,04J,1755,1369,3124,0.5617797695262484
13040,2016-03-01,04K,795,1758,2553,0.31139835487661577
13041,2016-03-01,04L,380,786,1166,0.3259005145797599
13042,2016-03-01,04M,242,462,704,0.34375
13043,2016-03-01,04N,274,734,1008,0.2718253968253968
13044,2016-03-01,04Q,717,494,1211,0.5920726672171759
13045,2016-03-01,04R,2099,1981,4080,0.5144607843137254
13046,2016-03-01,04V,2343,1238,3581,0.6542865121474448
13047,2016-03-01,04X,1132,1368,2500,0.4528
13048,2016-03-01,04Y,948,428,1376,0.688953488372093
13049,2016-03-01,05A,2407,1713,4120,0.5842233009708738
13050,2016-03-01,05C,1150,1926,3076,0.37386215864759426
13051,2016-03-01,05D,1031,439,1470,0.7013605442176871
13052,2016-03-01,05F,1086,1011,2097,0.5178826895565093
13053,2016-03-01,05G,1625,744,2369,0.6859434360489658
13054,2016-03-01,05H,1133,643,1776,0.6379504504504504
13055,2016-03-01,05J,1351,654,2005,0.6738154613466334
13056,2016-03-01,05L,2259,1885,4144,0.5451254826254827
13057,2016-03-01,05N,2093,1112,3205,0.6530421216848674
13058,2016-03-01,05P,945,1073,2018,0.4682854311199207
13059,2016-03-01,05Q,1401,762,2163,0.6477115117891817
13060,2016-03-01,05R,1585,1279,2864,0.5534217877094972
13061,2016-03-01,05T,2030,1249,3279,0.619091186337298
13062,2016-03-01,05V,957,581,1538,0.6222366710013004
13063,2016-03-01,05W,1888,818,2706,0.6977087952697709
13064,2016-03-01,05X,991,655,1646,0.6020656136087484
13065,2016-03-01,05Y,1567,1160,2727,0.5746241290795746
13066,2016-03-01,06A,1418,895,2313,0.61305663640294
13067,2016-03-01,06D,809,517,1326,0.610105580693816
13068,2016-03-01,06F,1719,2428,4147,0.41451651796479383
13069,2016-03-01,06H,5107,2926,8033,0.6357525208514876
13070,2016-03-01,06K,3087,3099,6186,0.49903006789524734
13071,2016-03-01,06L,2452,1018,3470,0.7066282420749279
13072,2016-03-01,06M,1899,973,2872,0.6612116991643454
13073,2016-03-01,06N,2878,2848,5726,0.5026196297589941
13074,2016-03-01,06P,891,879,1770,0.5033898305084745
13075,2016-03-01,06Q,2281,1227,3508,0.6502280501710376
13076,2016-03-01,06T,2091,1587,3678,0.5685154975530179
13077,2016-03-01,06V,1275,708,1983,0.642965204236006
13078,2016-03-01,06W,1350,829,2179,0.6195502524093621
13079,2016-03-01,06Y,1230,703,1933,0.636316606311433
13080,2016-03-01,07G,859,405,1264,0.6795886075949367
13081,2016-03-01,07H,1768,1210,2978,0.5936870382807253
13082,2016-03-01,07J,947,662,1609,0.5885643256681169
13083,2016-03-01,07K,1475,727,2202,0.6698455949137148
13084,2016-03-01,07L,698,377,1075,0.6493023255813953
13085,2016-03-01,07M,1327,1201,2528,0.5249208860759493
13086,2016-03-01,07N,1423,768,2191,0.6494751255134642
13087,2016-03-01,07P,848,801,1649,0.5142510612492419
13088,2016-03-01,07Q,1534,861,2395,0.6405010438413361
13089,2016-03-01,07R,617,693,1310,0.47099236641221376
13090,2016-03-01,07T,546,798,1344,0.40625
13091,2016-03-01,07V,1204,1615,2819,0.4271018091521816
13092,2016-03-01,07W,1136,886,2022,0.5618199802176064
13093,2016-03-01,07X,1269,805,2074,0.6118611378977821
13094,2016-03-01,07Y,954,535,1489,0.6406984553391538
13095,2016-03-01,08A,1149,692,1841,0.6241173275393808
13096,2016-03-01,08C,666,502,1168,0.5702054794520548
13097,2016-03-01,08D,873,608,1481,0.5894665766374072
13098,2016-03-01,08E,819,760,1579,0.5186827105763141
13099,2016-03-01,08F,1459,693,2152,0.6779739776951673
13100,2016-03-01,08G,479,1402,1881,0.25465178096757046
13101,2016-03-01,08H,556,818,1374,0.40465793304221254
13102,2016-03-01,08J,745,565,1310,0.5687022900763359
13103,2016-03-01,08K,1065,890,1955,0.5447570332480819
13104,2016-03-01,08L,632,1262,1894,0.33368532206969376
13105,2016-03-01,08M,1114,643,1757,0.6340352874217416
13106,2016-03-01,08N,1093,573,1666,0.656062424969988
13107,2016-03-01,08P,906,581,1487,0.609280430396772
13108,2016-03-01,08Q,731,665,1396,0.5236389684813754
13109,2016-03-01,08R,857,491,1348,0.6357566765578635
13110,2016-03-01,08T,941,616,1557,0.6043673731535003
13111,2016-03-01,08V,1130,815,1945,0.5809768637532133
13112,2016-03-01,08W,950,682,1632,0.5821078431372549
13113,2016-03-01,08X,1192,959,2151,0.5541608554160855
13114,2016-03-01,08Y,717,533,1250,0.5736
13115,2016-03-01,09A,530,634,1164,0.45532646048109965
13116,2016-03-01,09C,633,589,1222,0.5180032733224222
13117,2016-03-01,09D,1186,1159,2345,0.5057569296375266
13118,2016-03-01,09E,1469,851,2320,0.6331896551724138
13119,2016-03-01,09F,1296,693,1989,0.6515837104072398
13120,2016-03-01,09G,3484,1897,5381,0.6474632967849842
13121,2016-03-01,09H,483,361,844,0.5722748815165877
13122,2016-03-01,09J,1622,1138,2760,0.5876811594202899
13123,2016-03-01,09L,848,590,1438,0.5897079276773296
13124,2016-03-01,09N,909,811,1720,0.5284883720930232
13125,2016-03-01,09P,1037,878,1915,0.5415143603133159
13126,2016-03-01,09W,1351,929,2280,0.5925438596491228
13127,2016-03-01,09X,985,809,1794,0.5490523968784838
13128,2016-03-01,09Y,1384,1419,2803,0.4937566892615055
13129,2016-03-01,10A,1147,805,1952,0.5876024590163934
13130,2016-03-01,10C,508,372,880,0.5772727272727273
13131,2016-03-01,10D,594,396,990,0.6
13132,2016-03-01,10E,779,473,1252,0.6222044728434505
13133,2016-03-01,10G,628,438,1066,0.5891181988742964
13134,2016-03-01,10H,1969,1301,3270,0.6021406727828746
13135,2016-03-01,10J,1111,870,1981,0.5608278647147905
13136,2016-03-01,10K,1288,703,1991,0.646911099949774
13137,2016-03-01,10L,1021,412,1433,0.7124912770411723
13138,2016-03-01,10M,466,373,839,0.5554231227651967
13139,2016-03-01,10N,425,448,873,0.4868270332187858
13140,2016-03-01,10Q,3455,2873,6328,0.5459860935524652
13141,2016-03-01,10R,1342,601,1943,0.6906845084920227
13142,2016-03-01,10T,636,361,997,0.6379137412236711
13143,2016-03-01,10V,1371,769,2140,0.6406542056074767
13144,2016-03-01,10W,577,375,952,0.6060924369747899
13145,2016-03-01,10X,1151,702,1853,0.6211548839719374
13146,2016-03-01,10Y,1260,864,2124,0.5932203389830508
13147,2016-03-01,11A,3232,1814,5046,0.6405073325406262
13148,2016-03-01,11C,889,420,1309,0.679144385026738
13149,2016-03-01,11D,682,608,1290,0.5286821705426357
13150,2016-03-01,11E,963,885,1848,0.5211038961038961
13151,2016-03-01,11H,2595,1599,4194,0.6187410586552218
13152,2016-03-01,11J,4953,2461,7414,0.6680604262206636
13153,2016-03-01,11M,3746,2066,5812,0.6445285615966965
13154,2016-03-01,11N,3099,2707,5806,0.5337581811918705
13155,2016-03-01,11T,1486,895,2381,0.624107517849643
13156,2016-03-01,11X,3236,1927,5163,0.6267673833042805
13157,2016-03-01,12A,1452,839,2291,0.6337843736359668
13158,2016-03-01,12D,1145,860,2005,0.571072319201995
13159,2016-03-01,12F,2239,954,3193,0.7012214218603194
13160,2016-03-01,13P,2296,3214,5510,0.4166969147005445
13161,2016-03-01,13T,3216,1621,4837,0.6648749224726069
13162,2016-03-01,14L,2843,2124,4967,0.5723776927722971
13163,2016-03-01,99A,2419,1832,4251,0.5690425782168902
13164,2016-03-01,99C,1590,789,2379,0.6683480453972257
13165,2016-03-01,99D,1071,823,1894,0.5654699049630412
13166,2016-03-01,99E,1643,741,2384,0.6891778523489933
13167,2016-03-01,99F,1163,460,1623,0.7165742452248922
13168,2016-03-01,99G,1207,426,1633,0.7391304347826086
13169,2016-03-01,99H,1459,1112,2571,0.5674834694671335
13170,2016-03-01,99J,2956,1846,4802,0.6155768429820908
13171,2016-03-01,99K,953,811,1764,0.5402494331065759
13172,2016-03-01,99M,1058,846,1904,0.555672268907563
13173,2016-03-01,99N,2859,2459,5318,0.5376081233546446
13174,2016-03-01,99P,6026,2767,8793,0.6853178664847037
13175,2016-03-01,99Q,1896,969,2865,0.6617801047120419
13176,2016-04-01,00C,776,295,1071,0.7245564892623716
13177,2016-04-01,00D,2118,1006,3124,0.6779769526248399
13178,2016-04-01,00J,1743,780,2523,0.6908442330558858
13179,2016-04-01,00K,2101,1011,3112,0.6751285347043702
13180,2016-04-01,00L,2161,1345,3506,0.6163719338277239
13181,2016-04-01,00M,2246,1127,3373,0.6658760747109398
13182,2016-04-01,00N,1098,607,1705,0.6439882697947215
13183,2016-04-01,00P,2012,844,2856,0.7044817927170869
13184,2016-04-01,00Q,1016,491,1507,0.6741871267418713
13185,2016-04-01,00R,1083,742,1825,0.5934246575342466
13186,2016-04-01,00T,1813,1028,2841,0.6381555790214714
13187,2016-04-01,00V,1124,944,2068,0.5435203094777563
13188,2016-04-01,00X,941,400,1341,0.7017151379567487
13189,2016-04-01,00Y,1589,1168,2757,0.5763511062749366
13190,2016-04-01,01A,2187,1345,3532,0.6191959229898075
13191,2016-04-01,01C,865,771,1636,0.5287286063569682
13192,2016-04-01,01D,1145,923,2068,0.5536750483558994
13193,2016-04-01,01E,927,381,1308,0.7087155963302753
13194,2016-04-01,01F,788,575,1363,0.578136463683052
13195,2016-04-01,01G,1215,1322,2537,0.4789121009065826
13196,2016-04-01,01H,2348,1038,3386,0.6934435912581217
13197,2016-04-01,01J,952,681,1633,0.5829761175750153
13198,2016-04-01,01K,1770,1592,3362,0.5264723378941106
13199,2016-04-01,01R,728,715,1443,0.5045045045045045
13200,2016-04-01,01T,657,615,1272,0.5165094339622641
13201,2016-04-01,01V,717,588,1305,0.5494252873563218
13202,2016-04-01,01W,1976,1010,2986,0.6617548559946417
13203,2016-04-01,01X,1376,913,2289,0.601135867190913
13204,2016-04-01,01Y,744,1243,1987,0.3744338198288878
13205,2016-04-01,02A,1176,729,1905,0.6173228346456693
13206,2016-04-01,02D,426,398,824,0.5169902912621359
13207,2016-04-01,02E,1144,781,1925,0.5942857142857143
13208,2016-04-01,02F,1062,1182,2244,0.4732620320855615
13209,2016-04-01,02G,593,500,1093,0.5425434583714547
13210,2016-04-01,02H,1449,1459,2908,0.4982806052269601
13211,2016-04-01,02M,1053,538,1591,0.661847894406034
13212,2016-04-01,02N,967,631,1598,0.6051314142678348
13213,2016-04-01,02P,1000,1588,2588,0.38639876352395675
13214,2016-04-01,02Q,549,513,1062,0.5169491525423728
13215,2016-04-01,02R,2018,1284,3302,0.61114476075106
13216,2016-04-01,02T,1225,889,2114,0.5794701986754967
13217,2016-04-01,02V,655,1137,1792,0.36551339285714285
13218,2016-04-01,02W,563,391,954,0.590146750524109
13219,2016-04-01,02X,1908,1081,2989,0.6383405821344932
13220,2016-04-01,02Y,2000,993,2993,0.6682258603407952
13221,2016-04-01,03A,1308,877,2185,0.5986270022883295
13222,2016-04-01,03C,1139,1747,2886,0.3946638946638947
13223,2016-04-01,03D,787,541,1328,0.5926204819277109
13224,2016-04-01,03E,824,578,1402,0.5877318116975749
13225,2016-04-01,03F,1709,653,2362,0.7235393734123624
13226,2016-04-01,03G,1023,1437,2460,0.41585365853658535
13227,2016-04-01,03H,1311,555,1866,0.702572347266881
13228,2016-04-01,03J,1041,632,1673,0.6222355050806934
13229,2016-04-01,03K,944,407,1351,0.698741672834937
13230,2016-04-01,03L,986,1750,2736,0.3603801169590643
13231,2016-04-01,03M,798,407,1205,0.6622406639004149
13232,2016-04-01,03N,3232,1660,4892,0.660670482420278
13233,2016-04-01,03Q,1885,1056,2941,0.6409384563073784
13234,2016-04-01,03R,2239,1400,3639,0.6152789227809838
13235,2016-04-01,03T,1802,919,2721,0.6622565233370085
13236,2016-04-01,03V,375,300,675,0.5555555555555556
13237,2016-04-01,03W,2178,1159,3337,0.6526820497452802
13238,2016-04-01,03X,317,414,731,0.43365253077975374
13239,2016-04-01,03Y,628,515,1143,0.5494313210848644
13240,2016-04-01,04C,2012,838,2850,0.7059649122807018
13241,2016-04-01,04D,1365,839,2204,0.6193284936479129
13242,2016-04-01,04E,671,1266,1937,0.3464119772844605
13243,2016-04-01,04F,1453,1041,2494,0.582598235765838
13244,2016-04-01,04G,3949,2994,6943,0.5687743050554516
13245,2016-04-01,04H,364,812,1176,0.30952380952380953
13246,2016-04-01,04J,1718,1444,3162,0.5433270082226439
13247,2016-04-01,04K,712,1634,2346,0.3034953111679454
13248,2016-04-01,04L,326,881,1207,0.27009113504556753
13249,2016-04-01,04M,209,490,699,0.2989985693848355
13250,2016-04-01,04N,269,709,978,0.27505112474437626
13251,2016-04-01,04Q,736,482,1218,0.6042692939244664
13252,2016-04-01,04R,2111,1969,4080,0.5174019607843138
13253,2016-04-01,04V,2326,1220,3546,0.6559503666102651
13254,2016-04-01,04X,1231,1399,2630,0.46806083650190117
13255,2016-04-01,04Y,971,394,1365,0.7113553113553114
13256,2016-04-01,05A,2428,1667,4095,0.5929181929181929
13257,2016-04-01,05C,1138,1931,3069,0.37080482241772567
13258,2016-04-01,05D,1022,442,1464,0.6980874316939891
13259,2016-04-01,05F,976,971,1947,0.5012840267077555
13260,2016-04-01,05G,1598,806,2404,0.6647254575707154
13261,2016-04-01,05H,1084,654,1738,0.6237054085155351
13262,2016-04-01,05J,1324,688,2012,0.658051689860835
13263,2016-04-01,05L,2228,1982,4210,0.5292161520190024
13264,2016-04-01,05N,2014,1172,3186,0.6321406151914627
13265,2016-04-01,05P,896,1133,2029,0.4415968457368162
13266,2016-04-01,05Q,1333,854,2187,0.6095107453132145
13267,2016-04-01,05R,1571,1259,2830,0.5551236749116608
13268,2016-04-01,05T,2002,1256,3258,0.614487415592388
13269,2016-04-01,05V,862,601,1463,0.5892002734107997
13270,2016-04-01,05W,1894,893,2787,0.679583781844277
13271,2016-04-01,05X,908,645,1553,0.5846748229233741
13272,2016-04-01,05Y,1593,1178,2771,0.574882713821725
13273,2016-04-01,06A,1456,875,2331,0.6246246246246246
13274,2016-04-01,06D,825,581,1406,0.5867709815078236
13275,2016-04-01,06F,1676,2376,4052,0.4136229022704837
13276,2016-04-01,06H,5079,3177,8256,0.6151889534883721
13277,2016-04-01,06K,3023,3163,6186,0.4886841254445522
13278,2016-04-01,06L,2437,1130,3567,0.6832071768993552
13279,2016-04-01,06M,1855,973,2828,0.655940594059406
13280,2016-04-01,06N,2875,2785,5660,0.5079505300353356
13281,2016-04-01,06P,916,870,1786,0.5128779395296752
13282,2016-04-01,06Q,2280,1217,3497,0.6519874177866742
13283,2016-04-01,06T,2104,1587,3691,0.5700352208073692
13284,2016-04-01,06V,1406,723,2129,0.660403945514326
13285,2016-04-01,06W,1414,842,2256,0.62677304964539
13286,2016-04-01,06Y,1191,739,1930,0.6170984455958549
13287,2016-04-01,07G,925,384,1309,0.706646294881589
13288,2016-04-01,07H,1598,1216,2814,0.5678749111584932
13289,2016-04-01,07J,946,664,1610,0.5875776397515527
13290,2016-04-01,07K,1455,701,2156,0.674860853432282
13291,2016-04-01,07L,762,393,1155,0.6597402597402597
13292,2016-04-01,07M,1220,1197,2417,0.5047579644187009
13293,2016-04-01,07N,1466,739,2205,0.6648526077097505
13294,2016-04-01,07P,791,774,1565,0.5054313099041533
13295,2016-04-01,07Q,1633,868,2501,0.6529388244702119
13296,2016-04-01,07R,631,726,1357,0.46499631540162123
13297,2016-04-01,07T,496,826,1322,0.3751891074130106
13298,2016-04-01,07V,1158,1548,2706,0.4279379157427938
13299,2016-04-01,07W,1101,883,1984,0.5549395161290323
13300,2016-04-01,07X,1202,786,1988,0.6046277665995976
13301,2016-04-01,07Y,929,583,1512,0.6144179894179894
13302,2016-04-01,08A,1041,679,1720,0.6052325581395349
13303,2016-04-01,08C,667,506,1173,0.5686274509803921
13304,2016-04-01,08D,735,595,1330,0.5526315789473685
13305,2016-04-01,08E,836,775,1611,0.5189323401613904
13306,2016-04-01,08F,1477,734,2211,0.6680235187697874
13307,2016-04-01,08G,461,1294,1755,0.26267806267806265
13308,2016-04-01,08H,498,851,1349,0.36916234247590807
13309,2016-04-01,08J,766,626,1392,0.5502873563218391
13310,2016-04-01,08K,1032,979,2011,0.5131775236200895
13311,2016-04-01,08L,596,1418,2014,0.2959285004965243
13312,2016-04-01,08M,1158,711,1869,0.6195826645264848
13313,2016-04-01,08N,1155,617,1772,0.6518058690744921
13314,2016-04-01,08P,834,662,1496,0.5574866310160428
13315,2016-04-01,08Q,768,734,1502,0.511318242343542
13316,2016-04-01,08R,869,521,1390,0.625179856115108
13317,2016-04-01,08T,942,635,1577,0.5973367152821814
13318,2016-04-01,08V,1087,854,1941,0.5600206079340546
13319,2016-04-01,08W,943,636,1579,0.597213426219126
13320,2016-04-01,08X,1199,926,2125,0.5642352941176471
13321,2016-04-01,08Y,690,555,1245,0.5542168674698795
13322,2016-04-01,09A,527,613,1140,0.46228070175438596
13323,2016-04-01,09C,626,545,1171,0.5345858240819812
13324,2016-04-01,09D,1134,1238,2372,0.47807757166947723
13325,2016-04-01,09E,1524,863,2387,0.6384583158776708
13326,2016-04-01,09F,1231,707,1938,0.6351909184726522
13327,2016-04-01,09G,3606,1972,5578,0.6464682681964862
13328,2016-04-01,09H,570,358,928,0.6142241379310345
13329,2016-04-01,09J,1588,1075,2663,0.5963199399173864
13330,2016-04-01,09L,769,572,1341,0.5734526472781506
13331,2016-04-01,09N,994,792,1786,0.5565509518477044
13332,2016-04-01,09P,1118,926,2044,0.5469667318982387
13333,2016-04-01,09W,1309,973,2282,0.5736196319018405
13334,2016-04-01,09X,1006,822,1828,0.550328227571116
13335,2016-04-01,09Y,1267,1326,2593,0.4886232163517162
13336,2016-04-01,10A,1218,792,2010,0.6059701492537314
13337,2016-04-01,10C,430,345,775,0.5548387096774193
13338,2016-04-01,10D,562,399,961,0.5848074921956296
13339,2016-04-01,10E,830,488,1318,0.629742033383915
13340,2016-04-01,10G,678,414,1092,0.6208791208791209
13341,2016-04-01,10H,1877,1344,3221,0.5827382800372555
13342,2016-04-01,10J,989,890,1879,0.5263437998935604
13343,2016-04-01,10K,1313,705,2018,0.6506442021803767
13344,2016-04-01,10L,996,498,1494,0.6666666666666666
13345,2016-04-01,10M,508,436,944,0.538135593220339
13346,2016-04-01,10N,417,461,878,0.47494305239179957
13347,2016-04-01,10Q,3220,2885,6105,0.5274365274365275
13348,2016-04-01,10R,1442,614,2056,0.7013618677042801
13349,2016-04-01,10T,578,413,991,0.5832492431886983
13350,2016-04-01,10V,1327,703,2030,0.6536945812807882
13351,2016-04-01,10W,572,403,975,0.5866666666666667
13352,2016-04-01,10X,1148,718,1866,0.6152197213290461
13353,2016-04-01,10Y,1187,1032,2219,0.5349256421811627
13354,2016-04-01,11A,3225,1808,5033,0.6407709119809258
13355,2016-04-01,11C,825,402,1227,0.6723716381418093
13356,2016-04-01,11D,673,617,1290,0.5217054263565891
13357,2016-04-01,11E,936,958,1894,0.4941921858500528
13358,2016-04-01,11H,2608,1643,4251,0.6135027052458245
13359,2016-04-01,11J,5087,2609,7696,0.6609927234927235
13360,2016-04-01,11M,3813,2072,5885,0.6479184367034835
13361,2016-04-01,11N,2929,2716,5645,0.5188662533215235
13362,2016-04-01,11T,1441,906,2347,0.613975287601193
13363,2016-04-01,11X,3142,2041,5183,0.6062126181748022
13364,2016-04-01,12A,1422,832,2254,0.6308784383318545
13365,2016-04-01,12D,1237,931,2168,0.5705719557195572
13366,2016-04-01,12F,2182,948,3130,0.6971246006389776
13367,2016-04-01,13P,2242,3297,5539,0.40476620328579166
13368,2016-04-01,13T,3073,1680,4753,0.646539027982327
13369,2016-04-01,14L,2833,2094,4927,0.5749949259184087
13370,2016-04-01,99A,2283,1730,4013,0.5689010715175679
13371,2016-04-01,99C,1525,826,2351,0.648660144619311
13372,2016-04-01,99D,1087,888,1975,0.550379746835443
13373,2016-04-01,99E,1593,701,2294,0.6944202266782912
13374,2016-04-01,99F,1082,407,1489,0.7266621893888516
13375,2016-04-01,99G,1115,422,1537,0.7254391672088484
13376,2016-04-01,99H,1482,1110,2592,0.5717592592592593
13377,2016-04-01,99J,2935,1907,4842,0.6061544816191656
13378,2016-04-01,99K,901,821,1722,0.5232288037166086
13379,2016-04-01,99M,1085,871,1956,0.5547034764826176
13380,2016-04-01,99N,2858,2576,5434,0.5259477364740522
13381,2016-04-01,99P,5872,2759,8631,0.6803383153748117
13382,2016-04-01,99Q,1822,1035,2857,0.6377318865943297
13383,2016-05-01,00C,644,309,953,0.6757607555089192
13384,2016-05-01,00D,2036,1041,3077,0.6616834579135522
13385,2016-05-01,00J,1566,780,2346,0.6675191815856778
13386,2016-05-01,00K,2038,1003,3041,0.6701742847747452
13387,2016-05-01,00L,1963,1198,3161,0.6210060107560899
13388,2016-05-01,00M,2051,1043,3094,0.6628959276018099
13389,2016-05-01,00N,1095,596,1691,0.6475458308693081
13390,2016-05-01,00P,1851,802,2653,0.6977007161703732
13391,2016-05-01,00Q,903,510,1413,0.6390658174097664
13392,2016-05-01,00R,1035,774,1809,0.572139303482587
13393,2016-05-01,00T,1693,1048,2741,0.6176577891280555
13394,2016-05-01,00V,1004,891,1895,0.5298153034300792
13395,2016-05-01,00X,952,369,1321,0.720666161998486
13396,2016-05-01,00Y,1455,1183,2638,0.5515542077331311
13397,2016-05-01,01A,2090,1298,3388,0.6168831168831169
13398,2016-05-01,01C,802,666,1468,0.5463215258855586
13399,2016-05-01,01D,1090,837,1927,0.5656460819927348
13400,2016-05-01,01E,918,362,1280,0.7171875
13401,2016-05-01,01F,731,564,1295,0.5644787644787644
13402,2016-05-01,01G,1174,1318,2492,0.471107544141252
13403,2016-05-01,01H,2189,1043,3232,0.6772896039603961
13404,2016-05-01,01J,784,691,1475,0.5315254237288135
13405,2016-05-01,01K,1640,1511,3151,0.5204696921612186
13406,2016-05-01,01R,679,717,1396,0.4863896848137536
13407,2016-05-01,01T,666,632,1298,0.5130970724191063
13408,2016-05-01,01V,616,576,1192,0.5167785234899329
13409,2016-05-01,01W,1767,964,2731,0.6470157451482973
13410,2016-05-01,01X,1333,846,2179,0.6117485084901331
13411,2016-05-01,01Y,736,1210,1946,0.37821171634121276
13412,2016-05-01,02A,993,811,1804,0.5504434589800443
13413,2016-05-01,02D,448,389,837,0.5352449223416965
13414,2016-05-01,02E,1037,752,1789,0.5796534376746786
13415,2016-05-01,02F,1095,1160,2255,0.48558758314855877
13416,2016-05-01,02G,528,538,1066,0.49530956848030017
13417,2016-05-01,02H,1366,1395,2761,0.4947482796088374
13418,2016-05-01,02M,969,507,1476,0.6565040650406504
13419,2016-05-01,02N,874,594,1468,0.5953678474114441
13420,2016-05-01,02P,850,1453,2303,0.36908380373425964
13421,2016-05-01,02Q,539,496,1035,0.5207729468599034
13422,2016-05-01,02R,1859,1217,3076,0.6043563068920677
13423,2016-05-01,02T,1224,811,2035,0.6014742014742015
13424,2016-05-01,02V,659,1088,1747,0.3772180881511162
13425,2016-05-01,02W,490,382,872,0.5619266055045872
13426,2016-05-01,02X,1758,967,2725,0.6451376146788991
13427,2016-05-01,02Y,1874,871,2745,0.682695810564663
13428,2016-05-01,03A,1249,826,2075,0.6019277108433735
13429,2016-05-01,03C,1115,1766,2881,0.3870183963901423
13430,2016-05-01,03D,750,503,1253,0.5985634477254589
13431,2016-05-01,03E,792,562,1354,0.5849335302806499
13432,2016-05-01,03F,1572,621,2193,0.7168262653898769
13433,2016-05-01,03G,945,1301,2246,0.4207479964381122
13434,2016-05-01,03H,1145,515,1660,0.6897590361445783
13435,2016-05-01,03J,991,603,1594,0.6217063989962359
13436,2016-05-01,03K,919,364,1283,0.7162899454403742
13437,2016-05-01,03L,950,1503,2453,0.38728088055442317
13438,2016-05-01,03M,765,401,1166,0.6560891938250428
13439,2016-05-01,03N,2954,1465,4419,0.6684770310024892
13440,2016-05-01,03Q,1909,985,2894,0.6596406357982032
13441,2016-05-01,03R,2098,1306,3404,0.6163337250293772
13442,2016-05-01,03T,1664,870,2534,0.6566692975532754
13443,2016-05-01,03V,383,275,658,0.5820668693009119
13444,2016-05-01,03W,1952,1156,3108,0.6280566280566281
13445,2016-05-01,03X,309,383,692,0.44653179190751446
13446,2016-05-01,03Y,598,507,1105,0.5411764705882353
13447,2016-05-01,04C,1952,832,2784,0.7011494252873564
13448,2016-05-01,04D,1226,779,2005,0.6114713216957606
13449,2016-05-01,04E,588,1192,1780,0.3303370786516854
13450,2016-05-01,04F,1367,984,2351,0.5814547001276053
13451,2016-05-01,04G,3711,2818,6529,0.568387195588911
13452,2016-05-01,04H,346,698,1044,0.3314176245210728
13453,2016-05-01,04J,1551,1446,2997,0.5175175175175175
13454,2016-05-01,04K,654,1781,2435,0.26858316221765915
13455,2016-05-01,04L,316,854,1170,0.27008547008547007
13456,2016-05-01,04M,196,451,647,0.3029366306027821
13457,2016-05-01,04N,240,653,893,0.2687569988801792
13458,2016-05-01,04Q,699,469,1168,0.598458904109589
13459,2016-05-01,04R,1817,1838,3655,0.4971272229822161
13460,2016-05-01,04V,2247,1166,3413,0.6583650747143276
13461,2016-05-01,04X,1107,1299,2406,0.4600997506234414
13462,2016-05-01,04Y,933,439,1372,0.6800291545189504
13463,2016-05-01,05A,2046,1832,3878,0.5275915420319752
13464,2016-05-01,05C,1097,1774,2871,0.38209683037269243
13465,2016-05-01,05D,958,442,1400,0.6842857142857143
13466,2016-05-01,05F,994,941,1935,0.5136950904392765
13467,2016-05-01,05G,1555,653,2208,0.7042572463768116
13468,2016-05-01,05H,1072,663,1735,0.6178674351585014
13469,2016-05-01,05J,1197,701,1898,0.6306638566912539
13470,2016-05-01,05L,2166,1869,4035,0.5368029739776952
13471,2016-05-01,05N,1968,1206,3174,0.6200378071833649
13472,2016-05-01,05P,854,1100,1954,0.43705220061412486
13473,2016-05-01,05Q,1329,732,2061,0.6448326055312955
13474,2016-05-01,05R,1426,1246,2672,0.5336826347305389
13475,2016-05-01,05T,1869,1191,3060,0.6107843137254902
13476,2016-05-01,05V,886,550,1436,0.616991643454039
13477,2016-05-01,05W,1773,811,2584,0.6861455108359134
13478,2016-05-01,05X,823,600,1423,0.5783555867884751
13479,2016-05-01,05Y,1541,962,2503,0.6156612065521374
13480,2016-05-01,06A,1217,830,2047,0.5945285784074255
13481,2016-05-01,06D,758,483,1241,0.6107977437550363
13482,2016-05-01,06F,1572,2330,3902,0.4028703229113275
13483,2016-05-01,06H,4677,2954,7631,0.61289477132748
13484,2016-05-01,06K,2785,2958,5743,0.4849381856172732
13485,2016-05-01,06L,2353,1042,3395,0.6930780559646539
13486,2016-05-01,06M,1753,940,2693,0.6509468993687337
13487,2016-05-01,06N,2592,2622,5214,0.49712313003452246
13488,2016-05-01,06P,807,843,1650,0.4890909090909091
13489,2016-05-01,06Q,2154,1244,3398,0.6339022954679223
13490,2016-05-01,06T,1976,1551,3527,0.5602495038276155
13491,2016-05-01,06V,1226,693,1919,0.6388744137571651
13492,2016-05-01,06W,1447,812,2259,0.6405489154493138
13493,2016-05-01,06Y,1176,755,1931,0.6090108751941999
13494,2016-05-01,07G,829,368,1197,0.6925647451963242
13495,2016-05-01,07H,1605,1082,2687,0.5973204317082248
13496,2016-05-01,07J,901,638,1539,0.5854450942170241
13497,2016-05-01,07K,1297,668,1965,0.6600508905852417
13498,2016-05-01,07L,677,385,1062,0.6374764595103578
13499,2016-05-01,07M,1136,1142,2278,0.4986830553116769
13500,2016-05-01,07N,1407,825,2232,0.6303763440860215
13501,2016-05-01,07P,757,678,1435,0.5275261324041812
13502,2016-05-01,07Q,1562,801,2363,0.6610241218789674
13503,2016-05-01,07R,594,712,1306,0.4548238897396631
13504,2016-05-01,07T,489,770,1259,0.38840349483717235
13505,2016-05-01,07V,1096,1548,2644,0.4145234493192133
13506,2016-05-01,07W,1053,879,1932,0.5450310559006211
13507,2016-05-01,07X,1116,825,1941,0.5749613601236476
13508,2016-05-01,07Y,837,481,1318,0.6350531107738998
13509,2016-05-01,08A,965,670,1635,0.5902140672782875
13510,2016-05-01,08C,602,515,1117,0.5389435989256938
13511,2016-05-01,08D,796,604,1400,0.5685714285714286
13512,2016-05-01,08E,788,706,1494,0.5274431057563588
13513,2016-05-01,08F,1383,702,2085,0.6633093525179856
13514,2016-05-01,08G,423,1236,1659,0.2549728752260398
13515,2016-05-01,08H,503,895,1398,0.3597997138769671
13516,2016-05-01,08J,734,530,1264,0.5806962025316456
13517,2016-05-01,08K,854,933,1787,0.4778959149412423
13518,2016-05-01,08L,633,1210,1843,0.3434617471513836
13519,2016-05-01,08M,1075,694,1769,0.607687959299039
13520,2016-05-01,08N,1087,625,1712,0.634929906542056
13521,2016-05-01,08P,824,663,1487,0.5541358439811701
13522,2016-05-01,08Q,658,709,1367,0.4813460131675201
13523,2016-05-01,08R,828,489,1317,0.6287015945330297
13524,2016-05-01,08T,956,668,1624,0.5886699507389163
13525,2016-05-01,08V,1078,882,1960,0.55
13526,2016-05-01,08W,883,646,1529,0.5775016350555919
13527,2016-05-01,08X,1148,945,2093,0.5484949832775919
13528,2016-05-01,08Y,628,531,1159,0.5418464193270061
13529,2016-05-01,09A,502,593,1095,0.45844748858447487
13530,2016-05-01,09C,552,563,1115,0.49506726457399103
13531,2016-05-01,09D,1081,1178,2259,0.4785303231518371
13532,2016-05-01,09E,1355,881,2236,0.6059928443649374
13533,2016-05-01,09F,1185,657,1842,0.6433224755700325
13534,2016-05-01,09G,3181,1947,5128,0.6203198127925117
13535,2016-05-01,09H,501,350,851,0.5887191539365453
13536,2016-05-01,09J,1378,1036,2414,0.5708367854183927
13537,2016-05-01,09L,757,558,1315,0.5756653992395437
13538,2016-05-01,09N,860,721,1581,0.5439595192915876
13539,2016-05-01,09P,948,831,1779,0.5328836424957841
13540,2016-05-01,09W,1245,903,2148,0.5796089385474861
13541,2016-05-01,09X,866,761,1627,0.5322679778733866
13542,2016-05-01,09Y,1171,1438,2609,0.4488309697201993
13543,2016-05-01,10A,1062,893,1955,0.5432225063938619
13544,2016-05-01,10C,401,330,731,0.5485636114911081
13545,2016-05-01,10D,561,366,927,0.6051779935275081
13546,2016-05-01,10E,817,436,1253,0.6520351157222666
13547,2016-05-01,10G,662,404,1066,0.6210131332082551
13548,2016-05-01,10H,1772,1377,3149,0.5627183232772308
13549,2016-05-01,10J,1005,771,1776,0.5658783783783784
13550,2016-05-01,10K,1146,665,1811,0.6327995582551077
13551,2016-05-01,10L,914,462,1376,0.6642441860465116
13552,2016-05-01,10M,471,431,902,0.5221729490022173
13553,2016-05-01,10N,369,444,813,0.45387453874538747
13554,2016-05-01,10Q,3261,2731,5992,0.5442256341789052
13555,2016-05-01,10R,1448,609,2057,0.70393777345649
13556,2016-05-01,10T,620,366,986,0.6288032454361054
13557,2016-05-01,10V,1210,682,1892,0.6395348837209303
13558,2016-05-01,10W,520,361,881,0.5902383654937571
13559,2016-05-01,10X,1174,728,1902,0.6172450052576236
13560,2016-05-01,10Y,1110,936,2046,0.5425219941348973
13561,2016-05-01,11A,2952,1647,4599,0.6418786692759295
13562,2016-05-01,11C,834,387,1221,0.683046683046683
13563,2016-05-01,11D,612,582,1194,0.5125628140703518
13564,2016-05-01,11E,885,915,1800,0.49166666666666664
13565,2016-05-01,11H,2322,1591,3913,0.5934065934065934
13566,2016-05-01,11J,4945,2474,7419,0.666531877611538
13567,2016-05-01,11M,3636,2034,5670,0.6412698412698413
13568,2016-05-01,11N,2877,2752,5629,0.5111032154912063
13569,2016-05-01,11T,1449,901,2350,0.6165957446808511
13570,2016-05-01,11X,2986,1902,4888,0.6108837970540099
13571,2016-05-01,12A,1228,778,2006,0.6121635094715853
13572,2016-05-01,12D,1108,918,2026,0.5468904244817374
13573,2016-05-01,12F,1982,894,2876,0.6891515994436718
13574,2016-05-01,13P,1952,3221,5173,0.37734390102455057
13575,2016-05-01,13T,2891,1531,4422,0.6537765716870194
13576,2016-05-01,14L,2586,2069,4655,0.555531686358754
13577,2016-05-01,99A,2198,1756,3954,0.5558927668184117
13578,2016-05-01,99C,1360,728,2088,0.6513409961685823
13579,2016-05-01,99D,1019,743,1762,0.5783200908059024
13580,2016-05-01,99E,1513,696,2209,0.6849253055681304
13581,2016-05-01,99F,993,400,1393,0.7128499641062455
13582,2016-05-01,99G,992,375,1367,0.7256766642282371
13583,2016-05-01,99H,1303,1042,2345,0.5556503198294243
13584,2016-05-01,99J,2740,1809,4549,0.602330182457683
13585,2016-05-01,99K,884,777,1661,0.5322095123419627
13586,2016-05-01,99M,974,876,1850,0.5264864864864864
13587,2016-05-01,99N,2818,2379,5197,0.5422359053299981
13588,2016-05-01,99P,5586,2765,8351,0.6689019279128248
13589,2016-05-01,99Q,1803,971,2774,0.6499639509733237
13590,2016-06-01,00C,799,329,1128,0.7083333333333334
13591,2016-06-01,00D,2105,1111,3216,0.6545398009950248
13592,2016-06-01,00J,1786,874,2660,0.6714285714285714
13593,2016-06-01,00K,2181,1000,3181,0.6856334486010689
13594,2016-06-01,00L,2100,1328,3428,0.6126021003500584
13595,2016-06-01,00M,2208,1115,3323,0.6644598254589227
13596,2016-06-01,00N,1164,668,1832,0.6353711790393013
13597,2016-06-01,00P,1958,885,2843,0.6887091100949702
13598,2016-06-01,00Q,990,565,1555,0.6366559485530546
13599,2016-06-01,00R,1123,788,1911,0.587650444793302
13600,2016-06-01,00T,1713,1089,2802,0.6113490364025695
13601,2016-06-01,00V,980,921,1901,0.5155181483429774
13602,2016-06-01,00X,948,394,1342,0.706408345752608
13603,2016-06-01,00Y,1559,1234,2793,0.5581811672037236
13604,2016-06-01,01A,2130,1318,3448,0.6177494199535963
13605,2016-06-01,01C,831,817,1648,0.504247572815534
13606,2016-06-01,01D,1119,904,2023,0.5531389026198715
13607,2016-06-01,01E,960,382,1342,0.7153502235469449
13608,2016-06-01,01F,769,605,1374,0.5596797671033479
13609,2016-06-01,01G,1239,1368,2607,0.475258918296893
13610,2016-06-01,01H,2221,1012,3233,0.68697803897309
13611,2016-06-01,01J,829,723,1552,0.5341494845360825
13612,2016-06-01,01K,1749,1677,3426,0.510507880910683
13613,2016-06-01,01R,704,685,1389,0.5068394528437725
13614,2016-06-01,01T,604,746,1350,0.4474074074074074
13615,2016-06-01,01V,660,619,1279,0.5160281469898358
13616,2016-06-01,01W,1891,1074,2965,0.6377740303541315
13617,2016-06-01,01X,1379,879,2258,0.6107174490699734
13618,2016-06-01,01Y,800,1309,2109,0.3793266951161688
13619,2016-06-01,02A,1041,1017,2058,0.5058309037900874
13620,2016-06-01,02D,471,430,901,0.5227524972253053
13621,2016-06-01,02E,1075,799,1874,0.5736392742796158
13622,2016-06-01,02F,1064,1263,2327,0.45724108293940696
13623,2016-06-01,02G,528,536,1064,0.49624060150375937
13624,2016-06-01,02H,1444,1625,3069,0.4705115672857608
13625,2016-06-01,02M,998,540,1538,0.6488946684005201
13626,2016-06-01,02N,945,625,1570,0.6019108280254777
13627,2016-06-01,02P,915,1677,2592,0.35300925925925924
13628,2016-06-01,02Q,631,534,1165,0.5416309012875536
13629,2016-06-01,02R,1969,1265,3234,0.608843537414966
13630,2016-06-01,02T,1277,915,2192,0.5825729927007299
13631,2016-06-01,02V,694,1118,1812,0.3830022075055188
13632,2016-06-01,02W,582,392,974,0.5975359342915811
13633,2016-06-01,02X,1805,1081,2886,0.6254331254331255
13634,2016-06-01,02Y,2082,965,3047,0.6832950443058746
13635,2016-06-01,03A,1315,950,2265,0.5805739514348786
13636,2016-06-01,03C,1061,1827,2888,0.36738227146814406
13637,2016-06-01,03D,780,569,1349,0.5782060785767235
13638,2016-06-01,03E,774,582,1356,0.5707964601769911
13639,2016-06-01,03F,1665,661,2326,0.7158211521926053
13640,2016-06-01,03G,993,1487,2480,0.4004032258064516
13641,2016-06-01,03H,1186,529,1715,0.6915451895043732
13642,2016-06-01,03J,1087,653,1740,0.6247126436781609
13643,2016-06-01,03K,917,446,1363,0.6727806309611152
13644,2016-06-01,03L,949,1678,2627,0.36124857251617815
13645,2016-06-01,03M,776,425,1201,0.6461282264779351
13646,2016-06-01,03N,3096,1509,4605,0.6723127035830619
13647,2016-06-01,03Q,1904,1053,2957,0.6438958403787622
13648,2016-06-01,03R,2303,1412,3715,0.6199192462987887
13649,2016-06-01,03T,1820,936,2756,0.660377358490566
13650,2016-06-01,03V,401,321,722,0.5554016620498615
13651,2016-06-01,03W,2180,1177,3357,0.6493893357164134
13652,2016-06-01,03X,302,382,684,0.4415204678362573
13653,2016-06-01,03Y,639,566,1205,0.5302904564315353
13654,2016-06-01,04C,1998,878,2876,0.6947148817802503
13655,2016-06-01,04D,1313,770,2083,0.6303408545367258
13656,2016-06-01,04E,589,1288,1877,0.3137986148108684
13657,2016-06-01,04F,1547,1044,2591,0.5970667695870321
13658,2016-06-01,04G,3963,2945,6908,0.5736826867400115
13659,2016-06-01,04H,386,792,1178,0.32767402376910015
13660,2016-06-01,04J,1697,1585,3282,0.5170627666057283
13661,2016-06-01,04K,725,1746,2471,0.2934034803723189
13662,2016-06-01,04L,351,944,1295,0.27104247104247103
13663,2016-06-01,04M,173,506,679,0.2547864506627393
13664,2016-06-01,04N,238,808,1046,0.22753346080305928
13665,2016-06-01,04Q,732,488,1220,0.6
13666,2016-06-01,04R,1839,2029,3868,0.4754395036194416
13667,2016-06-01,04V,2324,1160,3484,0.6670493685419059
13668,2016-06-01,04X,1056,1425,2481,0.42563482466747277
13669,2016-06-01,04Y,1013,439,1452,0.6976584022038568
13670,2016-06-01,05A,1908,2146,4054,0.4706462752836704
13671,2016-06-01,05C,1152,1894,3046,0.37820091923834537
13672,2016-06-01,05D,956,508,1464,0.6530054644808743
13673,2016-06-01,05F,1046,1066,2112,0.4952651515151515
13674,2016-06-01,05G,1551,720,2271,0.6829590488771466
13675,2016-06-01,05H,1040,780,1820,0.5714285714285714
13676,2016-06-01,05J,1313,722,2035,0.6452088452088452
13677,2016-06-01,05L,2255,1924,4179,0.5396027757836803
13678,2016-06-01,05N,2083,1191,3274,0.6362248014660965
13679,2016-06-01,05P,944,1257,2201,0.42889595638346206
13680,2016-06-01,05Q,1411,836,2247,0.6279483756119271
13681,2016-06-01,05R,1327,1571,2898,0.45790200138026227
13682,2016-06-01,05T,1956,1167,3123,0.6263208453410183
13683,2016-06-01,05V,973,599,1572,0.6189567430025446
13684,2016-06-01,05W,1838,848,2686,0.684288905435592
13685,2016-06-01,05X,963,765,1728,0.5572916666666666
13686,2016-06-01,05Y,1567,1159,2726,0.5748349229640499
13687,2016-06-01,06A,1387,961,2348,0.5907155025553663
13688,2016-06-01,06D,836,535,1371,0.6097738876732313
13689,2016-06-01,06F,1564,2502,4066,0.38465322183964584
13690,2016-06-01,06H,5100,3260,8360,0.6100478468899522
13691,2016-06-01,06K,2929,3079,6008,0.48751664447403464
13692,2016-06-01,06L,2429,1127,3556,0.6830708661417323
13693,2016-06-01,06M,1908,988,2896,0.6588397790055248
13694,2016-06-01,06N,2929,3001,5930,0.493929173693086
13695,2016-06-01,06P,805,913,1718,0.46856810244470315
13696,2016-06-01,06Q,2344,1286,3630,0.6457300275482094
13697,2016-06-01,06T,2116,1668,3784,0.5591966173361522
13698,2016-06-01,06V,1379,797,2176,0.6337316176470589
13699,2016-06-01,06W,1361,837,2198,0.6191992720655141
13700,2016-06-01,06Y,1284,759,2043,0.6284875183553598
13701,2016-06-01,07G,886,390,1276,0.6943573667711599
13702,2016-06-01,07H,1711,1240,2951,0.5798034564554388
13703,2016-06-01,07J,903,689,1592,0.5672110552763819
13704,2016-06-01,07K,1475,698,2173,0.6787850897376898
13705,2016-06-01,07L,701,394,1095,0.6401826484018265
13706,2016-06-01,07M,1129,1280,2409,0.46865919468659195
13707,2016-06-01,07N,1379,782,2161,0.6381304951411384
13708,2016-06-01,07P,804,736,1540,0.522077922077922
13709,2016-06-01,07Q,1628,889,2517,0.6468017481128328
13710,2016-06-01,07R,633,742,1375,0.46036363636363636
13711,2016-06-01,07T,537,825,1362,0.394273127753304
13712,2016-06-01,07V,1113,1684,2797,0.3979263496603504
13713,2016-06-01,07W,1131,929,2060,0.5490291262135922
13714,2016-06-01,07X,1212,814,2026,0.5982230997038499
13715,2016-06-01,07Y,898,599,1497,0.5998663994655978
13716,2016-06-01,08A,1070,677,1747,0.6124785346307956
13717,2016-06-01,08C,615,527,1142,0.5385288966725044
13718,2016-06-01,08D,853,551,1404,0.6075498575498576
13719,2016-06-01,08E,849,766,1615,0.5256965944272446
13720,2016-06-01,08F,1452,704,2156,0.673469387755102
13721,2016-06-01,08G,445,1319,1764,0.2522675736961451
13722,2016-06-01,08H,526,1007,1533,0.3431180691454664
13723,2016-06-01,08J,780,563,1343,0.580789277736411
13724,2016-06-01,08K,932,986,1918,0.4859228362877998
13725,2016-06-01,08L,588,1367,1955,0.30076726342710997
13726,2016-06-01,08M,1177,721,1898,0.6201264488935722
13727,2016-06-01,08N,1112,624,1736,0.6405529953917051
13728,2016-06-01,08P,882,639,1521,0.5798816568047337
13729,2016-06-01,08Q,644,716,1360,0.47352941176470587
13730,2016-06-01,08R,935,513,1448,0.6457182320441989
13731,2016-06-01,08T,922,720,1642,0.561510353227771
13732,2016-06-01,08V,1124,929,2053,0.547491475888943
13733,2016-06-01,08W,1069,718,1787,0.5982092893116956
13734,2016-06-01,08X,1146,1033,2179,0.525929325378614
13735,2016-06-01,08Y,692,555,1247,0.5549318364073778
13736,2016-06-01,09A,499,681,1180,0.4228813559322034
13737,2016-06-01,09C,650,607,1257,0.5171042163882259
13738,2016-06-01,09D,1129,1207,2336,0.4833047945205479
13739,2016-06-01,09E,1510,931,2441,0.6185989348627612
13740,2016-06-01,09F,1314,730,2044,0.6428571428571429
13741,2016-06-01,09G,3420,2018,5438,0.6289076866495035
13742,2016-06-01,09H,559,371,930,0.6010752688172043
13743,2016-06-01,09J,1519,1195,2714,0.5596904937361827
13744,2016-06-01,09L,849,597,1446,0.5871369294605809
13745,2016-06-01,09N,1014,810,1824,0.555921052631579
13746,2016-06-01,09P,1030,922,1952,0.5276639344262295
13747,2016-06-01,09W,1274,963,2237,0.5695127402771569
13748,2016-06-01,09X,1022,812,1834,0.5572519083969466
13749,2016-06-01,09Y,1312,1495,2807,0.46740292126825794
13750,2016-06-01,10A,1197,918,2115,0.5659574468085107
13751,2016-06-01,10C,487,347,834,0.5839328537170264
13752,2016-06-01,10D,591,411,1002,0.5898203592814372
13753,2016-06-01,10E,825,441,1266,0.6516587677725119
13754,2016-06-01,10G,668,409,1077,0.6202414113277623
13755,2016-06-01,10H,1644,1651,3295,0.49893778452200305
13756,2016-06-01,10J,1129,878,2007,0.5625311410064773
13757,2016-06-01,10K,1299,658,1957,0.6637710781808891
13758,2016-06-01,10L,990,511,1501,0.6595602931379081
13759,2016-06-01,10M,480,498,978,0.49079754601226994
13760,2016-06-01,10N,409,479,888,0.4605855855855856
13761,2016-06-01,10Q,3531,2857,6388,0.5527551659361303
13762,2016-06-01,10R,1415,628,2043,0.6926089084679393
13763,2016-06-01,10T,622,366,988,0.6295546558704453
13764,2016-06-01,10V,1319,705,2024,0.6516798418972332
13765,2016-06-01,10W,558,508,1066,0.5234521575984991
13766,2016-06-01,10X,1208,729,1937,0.6236448115642746
13767,2016-06-01,10Y,1203,1022,2225,0.5406741573033708
13768,2016-06-01,11A,3367,1865,5232,0.643539755351682
13769,2016-06-01,11C,851,429,1280,0.66484375
13770,2016-06-01,11D,645,613,1258,0.5127186009538951
13771,2016-06-01,11E,923,929,1852,0.49838012958963285
13772,2016-06-01,11H,2552,1648,4200,0.6076190476190476
13773,2016-06-01,11J,5085,2601,7686,0.6615925058548009
13774,2016-06-01,11M,3859,2160,6019,0.6411364013955807
13775,2016-06-01,11N,3162,2900,6062,0.5216100296931706
13776,2016-06-01,11T,1619,921,2540,0.6374015748031496
13777,2016-06-01,11X,3165,2023,5188,0.6100616808018504
13778,2016-06-01,12A,1476,862,2338,0.6313088109495295
13779,2016-06-01,12D,1145,933,2078,0.5510105871029837
13780,2016-06-01,12F,2255,1107,3362,0.6707317073170732
13781,2016-06-01,13P,2085,3449,5534,0.37676183592338275
13782,2016-06-01,13T,3157,1649,4806,0.6568872243029547
13783,2016-06-01,14L,2653,2220,4873,0.5444284834804022
13784,2016-06-01,99A,2202,1857,4059,0.5424981522542498
13785,2016-06-01,99C,1515,796,2311,0.6555603634790134
13786,2016-06-01,99D,1103,820,1923,0.5735829433177327
13787,2016-06-01,99E,1593,721,2314,0.6884183232497839
13788,2016-06-01,99F,1096,437,1533,0.7149380300065231
13789,2016-06-01,99G,1030,437,1467,0.7021131561008862
13790,2016-06-01,99H,1508,1197,2705,0.5574861367837338
13791,2016-06-01,99J,2833,1934,4767,0.5942941053073212
13792,2016-06-01,99K,907,807,1714,0.529171528588098
13793,2016-06-01,99M,1082,930,2012,0.5377733598409543
13794,2016-06-01,99N,2858,2491,5349,0.5343054776593756
13795,2016-06-01,99P,6113,2989,9102,0.6716106350252692
13796,2016-06-01,99Q,1786,1065,2851,0.6264468607506138
13797,2016-07-01,00C,694,341,1035,0.6705314009661836
13798,2016-07-01,00D,1973,1076,3049,0.647097408986553
13799,2016-07-01,00J,1600,806,2406,0.6650041562759768
13800,2016-07-01,00K,2052,1033,3085,0.6651539708265802
13801,2016-07-01,00L,2099,1305,3404,0.6166274970622797
13802,2016-07-01,00M,2122,1057,3179,0.6675055048757471
13803,2016-07-01,00N,1120,598,1718,0.6519208381839348
13804,2016-07-01,00P,2009,850,2859,0.7026932493878979
13805,2016-07-01,00Q,912,531,1443,0.632016632016632
13806,2016-07-01,00R,1109,784,1893,0.5858425779186477
13807,2016-07-01,00T,1764,1115,2879,0.6127127474817645
13808,2016-07-01,00V,1061,1023,2084,0.5091170825335892
13809,2016-07-01,00X,979,436,1415,0.6918727915194346
13810,2016-07-01,00Y,1496,1191,2687,0.55675474506885
13811,2016-07-01,01A,2248,1431,3679,0.6110356075020386
13812,2016-07-01,01C,828,779,1607,0.5152457996266335
13813,2016-07-01,01D,1128,915,2043,0.5521292217327459
13814,2016-07-01,01E,991,446,1437,0.6896311760612387
13815,2016-07-01,01F,794,640,1434,0.5536959553695955
13816,2016-07-01,01G,1184,1364,2548,0.46467817896389324
13817,2016-07-01,01H,2325,1088,3413,0.6812188690301787
13818,2016-07-01,01J,869,749,1618,0.5370828182941904
13819,2016-07-01,01K,1838,1703,3541,0.5190624117480938
13820,2016-07-01,01R,756,809,1565,0.4830670926517572
13821,2016-07-01,01T,637,627,1264,0.5039556962025317
13822,2016-07-01,01V,665,563,1228,0.5415309446254072
13823,2016-07-01,01W,2017,1085,3102,0.6502256608639587
13824,2016-07-01,01X,1409,948,2357,0.597793805685193
13825,2016-07-01,01Y,772,1294,2066,0.3736689254598258
13826,2016-07-01,02A,995,939,1934,0.5144777662874871
13827,2016-07-01,02D,449,443,892,0.5033632286995515
13828,2016-07-01,02E,1030,802,1832,0.5622270742358079
13829,2016-07-01,02F,1078,1327,2405,0.44823284823284826
13830,2016-07-01,02G,582,587,1169,0.49786142001710865
13831,2016-07-01,02H,1514,1662,3176,0.47670025188916876
13832,2016-07-01,02M,1112,564,1676,0.6634844868735084
13833,2016-07-01,02N,991,690,1681,0.5895300416418798
13834,2016-07-01,02P,871,1626,2497,0.3488185822987585
13835,2016-07-01,02Q,598,483,1081,0.5531914893617021
13836,2016-07-01,02R,1870,1308,3178,0.5884203901825047
13837,2016-07-01,02T,1257,943,2200,0.5713636363636364
13838,2016-07-01,02V,687,1232,1919,0.3579989577905159
13839,2016-07-01,02W,492,418,910,0.5406593406593406
13840,2016-07-01,02X,1732,1134,2866,0.6043265875785067
13841,2016-07-01,02Y,1960,880,2840,0.6901408450704225
13842,2016-07-01,03A,1337,904,2241,0.5966086568496207
13843,2016-07-01,03C,1023,1764,2787,0.36706135629709363
13844,2016-07-01,03D,810,534,1344,0.6026785714285714
13845,2016-07-01,03E,822,585,1407,0.5842217484008528
13846,2016-07-01,03F,1675,671,2346,0.7139812446717817
13847,2016-07-01,03G,917,1509,2426,0.3779884583676834
13848,2016-07-01,03H,1217,536,1753,0.6942384483742157
13849,2016-07-01,03J,1087,605,1692,0.642434988179669
13850,2016-07-01,03K,942,454,1396,0.6747851002865329
13851,2016-07-01,03L,912,1712,2624,0.3475609756097561
13852,2016-07-01,03M,832,428,1260,0.6603174603174603
13853,2016-07-01,03N,3026,1569,4595,0.6585418933623504
13854,2016-07-01,03Q,1928,1093,3021,0.6381992717643165
13855,2016-07-01,03R,2155,1405,3560,0.6053370786516854
13856,2016-07-01,03T,1774,879,2653,0.6686769694685262
13857,2016-07-01,03V,369,310,679,0.5434462444771723
13858,2016-07-01,03W,2146,1121,3267,0.6568717477808387
13859,2016-07-01,03X,282,455,737,0.38263229308005425
13860,2016-07-01,03Y,626,580,1206,0.5190713101160862
13861,2016-07-01,04C,1921,763,2684,0.7157228017883756
13862,2016-07-01,04D,1305,810,2115,0.6170212765957447
13863,2016-07-01,04E,588,1286,1874,0.3137673425827108
13864,2016-07-01,04F,1421,1033,2454,0.5790546047269763
13865,2016-07-01,04G,3844,3059,6903,0.5568593365203535
13866,2016-07-01,04H,410,821,1231,0.3330625507717303
13867,2016-07-01,04J,1611,1536,3147,0.5119161105815062
13868,2016-07-01,04K,649,1690,2339,0.2774690038477982
13869,2016-07-01,04L,265,934,1199,0.22101751459549623
13870,2016-07-01,04M,179,522,701,0.2553495007132668
13871,2016-07-01,04N,239,802,1041,0.22958693563880883
13872,2016-07-01,04Q,751,470,1221,0.6150696150696151
13873,2016-07-01,04R,1821,2021,3842,0.47397188964081205
13874,2016-07-01,04V,2359,1199,3558,0.6630129286115796
13875,2016-07-01,04X,1106,1480,2586,0.4276875483372003
13876,2016-07-01,04Y,826,428,1254,0.6586921850079744
13877,2016-07-01,05A,1844,2205,4049,0.45542109162756234
13878,2016-07-01,05C,1130,1931,3061,0.3691604050963737
13879,2016-07-01,05D,989,460,1449,0.6825396825396826
13880,2016-07-01,05F,1015,1097,2112,0.4805871212121212
13881,2016-07-01,05G,1581,717,2298,0.6879895561357703
13882,2016-07-01,05H,886,883,1769,0.500847936687394
13883,2016-07-01,05J,1404,846,2250,0.624
13884,2016-07-01,05L,2167,2036,4203,0.5155841065905306
13885,2016-07-01,05N,2059,1169,3228,0.6378562577447335
13886,2016-07-01,05P,946,1254,2200,0.43
13887,2016-07-01,05Q,1402,822,2224,0.6303956834532374
13888,2016-07-01,05R,1183,1599,2782,0.4252336448598131
13889,2016-07-01,05T,2019,1302,3321,0.6079494128274616
13890,2016-07-01,05V,963,596,1559,0.6177036561898653
13891,2016-07-01,05W,1938,836,2774,0.6986301369863014
13892,2016-07-01,05X,912,783,1695,0.5380530973451327
13893,2016-07-01,05Y,1573,1159,2732,0.5757686676427526
13894,2016-07-01,06A,1372,970,2342,0.5858240819812126
13895,2016-07-01,06D,916,608,1524,0.6010498687664042
13896,2016-07-01,06F,1629,2448,4077,0.3995584988962472
13897,2016-07-01,06H,5029,3217,8246,0.6098714528256124
13898,2016-07-01,06K,3041,3114,6155,0.4940698619008936
13899,2016-07-01,06L,2503,1142,3645,0.6866941015089163
13900,2016-07-01,06M,1807,984,2791,0.6474381941956288
13901,2016-07-01,06N,2742,2840,5582,0.4912217843067001
13902,2016-07-01,06P,820,906,1726,0.47508690614136734
13903,2016-07-01,06Q,2187,1311,3498,0.6252144082332761
13904,2016-07-01,06T,2168,1743,3911,0.5543339299411915
13905,2016-07-01,06V,1287,765,2052,0.6271929824561403
13906,2016-07-01,06W,1406,865,2271,0.6191105239982386
13907,2016-07-01,06Y,1229,756,1985,0.6191435768261965
13908,2016-07-01,07G,887,400,1287,0.6891996891996892
13909,2016-07-01,07H,1628,1166,2794,0.5826771653543307
13910,2016-07-01,07J,942,671,1613,0.5840049597024178
13911,2016-07-01,07K,1426,744,2170,0.6571428571428571
13912,2016-07-01,07L,696,393,1089,0.6391184573002755
13913,2016-07-01,07M,1172,1270,2442,0.4799344799344799
13914,2016-07-01,07N,1370,803,2173,0.6304647952139899
13915,2016-07-01,07P,770,728,1498,0.514018691588785
13916,2016-07-01,07Q,1584,846,2430,0.6518518518518519
13917,2016-07-01,07R,495,713,1208,0.4097682119205298
13918,2016-07-01,07T,531,845,1376,0.3859011627906977
13919,2016-07-01,07V,991,1729,2720,0.36433823529411763
13920,2016-07-01,07W,1194,862,2056,0.580739299610895
13921,2016-07-01,07X,1122,922,2044,0.5489236790606654
13922,2016-07-01,07Y,931,590,1521,0.6120973044049968
13923,2016-07-01,08A,996,698,1694,0.5879574970484062
13924,2016-07-01,08C,617,577,1194,0.516750418760469
13925,2016-07-01,08D,740,640,1380,0.5362318840579711
13926,2016-07-01,08E,823,742,1565,0.5258785942492012
13927,2016-07-01,08F,1413,791,2204,0.6411070780399274
13928,2016-07-01,08G,411,1261,1672,0.2458133971291866
13929,2016-07-01,08H,501,870,1371,0.36542669584245074
13930,2016-07-01,08J,746,546,1292,0.5773993808049536
13931,2016-07-01,08K,932,907,1839,0.5067971723762915
13932,2016-07-01,08L,615,1332,1947,0.31587057010785824
13933,2016-07-01,08M,1104,708,1812,0.609271523178808
13934,2016-07-01,08N,1073,582,1655,0.6483383685800604
13935,2016-07-01,08P,914,686,1600,0.57125
13936,2016-07-01,08Q,674,719,1393,0.4838478104809763
13937,2016-07-01,08R,857,494,1351,0.6343449296817173
13938,2016-07-01,08T,971,643,1614,0.6016109045848823
13939,2016-07-01,08V,992,958,1950,0.5087179487179487
13940,2016-07-01,08W,984,660,1644,0.5985401459854015
13941,2016-07-01,08X,1228,1040,2268,0.5414462081128748
13942,2016-07-01,08Y,642,621,1263,0.5083135391923991
13943,2016-07-01,09A,467,721,1188,0.3930976430976431
13944,2016-07-01,09C,692,602,1294,0.5347758887171561
13945,2016-07-01,09D,1127,1172,2299,0.4902131361461505
13946,2016-07-01,09E,1541,916,2457,0.6271876271876272
13947,2016-07-01,09F,1264,715,1979,0.6387064173825164
13948,2016-07-01,09G,3468,2019,5487,0.6320393657736468
13949,2016-07-01,09H,517,384,901,0.5738068812430632
13950,2016-07-01,09J,1497,1161,2658,0.5632054176072234
13951,2016-07-01,09L,795,625,1420,0.5598591549295775
13952,2016-07-01,09N,1013,823,1836,0.5517429193899782
13953,2016-07-01,09P,1107,894,2001,0.553223388305847
13954,2016-07-01,09W,1290,914,2204,0.5852994555353902
13955,2016-07-01,09X,977,816,1793,0.5448968209704406
13956,2016-07-01,09Y,1277,1518,2795,0.45688729874776385
13957,2016-07-01,10A,1244,898,2142,0.580765639589169
13958,2016-07-01,10C,472,405,877,0.5381984036488028
13959,2016-07-01,10D,533,486,1019,0.5230618253189402
13960,2016-07-01,10E,777,450,1227,0.6332518337408313
13961,2016-07-01,10G,705,438,1143,0.6167979002624672
13962,2016-07-01,10H,1742,1561,3303,0.5273993339388435
13963,2016-07-01,10J,1078,923,2001,0.5387306346826587
13964,2016-07-01,10K,1263,662,1925,0.6561038961038961
13965,2016-07-01,10L,1020,528,1548,0.6589147286821705
13966,2016-07-01,10M,448,423,871,0.5143513203214696
13967,2016-07-01,10N,432,466,898,0.48106904231625836
13968,2016-07-01,10Q,3366,2879,6245,0.5389911929543635
13969,2016-07-01,10R,1377,647,2024,0.6803359683794467
13970,2016-07-01,10T,622,386,1008,0.6170634920634921
13971,2016-07-01,10V,1232,684,1916,0.6430062630480167
13972,2016-07-01,10W,490,421,911,0.5378704720087816
13973,2016-07-01,10X,1170,778,1948,0.6006160164271047
13974,2016-07-01,10Y,1203,1093,2296,0.5239547038327527
13975,2016-07-01,11A,3245,1900,5145,0.630709426627794
13976,2016-07-01,11C,838,401,1239,0.6763518966908797
13977,2016-07-01,11D,677,674,1351,0.5011102886750555
13978,2016-07-01,11E,857,943,1800,0.4761111111111111
13979,2016-07-01,11H,2438,1654,4092,0.5957966764418378
13980,2016-07-01,11J,5107,2663,7770,0.6572715572715573
13981,2016-07-01,11M,3818,2202,6020,0.63421926910299
13982,2016-07-01,11N,3148,3058,6206,0.5072510473735095
13983,2016-07-01,11T,1638,940,2578,0.6353762606671839
13984,2016-07-01,11X,3114,1997,5111,0.6092741146546664
13985,2016-07-01,12A,1378,851,2229,0.6182144459398834
13986,2016-07-01,12D,1141,870,2011,0.5673794132272502
13987,2016-07-01,12F,2128,1086,3214,0.6621032980709396
13988,2016-07-01,13P,1948,3436,5384,0.36181277860326894
13989,2016-07-01,13T,3166,1672,4838,0.6544026457213725
13990,2016-07-01,14L,2527,2045,4572,0.5527121609798775
13991,2016-07-01,99A,2210,1977,4187,0.5278242178170528
13992,2016-07-01,99C,1493,837,2330,0.6407725321888412
13993,2016-07-01,99D,1048,848,1896,0.5527426160337553
13994,2016-07-01,99E,1635,730,2365,0.6913319238900634
13995,2016-07-01,99F,1104,451,1555,0.7099678456591639
13996,2016-07-01,99G,1019,407,1426,0.7145862552594671
13997,2016-07-01,99H,1457,1253,2710,0.5376383763837639
13998,2016-07-01,99J,2859,1938,4797,0.5959974984365228
13999,2016-07-01,99K,829,779,1608,0.5155472636815921
14000,2016-07-01,99M,1057,951,2008,0.526394422310757
14001,2016-07-01,99N,2995,2502,5497,0.5448426414407859
14002,2016-07-01,99P,5942,3125,9067,0.6553435535458255
14003,2016-07-01,99Q,1753,987,2740,0.6397810218978102
14004,2016-08-01,00C,750,363,1113,0.6738544474393531
14005,2016-08-01,00D,2077,1164,3241,0.6408515890157359
14006,2016-08-01,00J,1703,830,2533,0.6723253059613107
14007,2016-08-01,00K,2209,1066,3275,0.6745038167938932
14008,2016-08-01,00L,2115,1345,3460,0.611271676300578
14009,2016-08-01,00M,2333,1124,3457,0.6748625976280012
14010,2016-08-01,00N,1220,638,1858,0.6566200215285253
14011,2016-08-01,00P,2076,915,2991,0.6940822467402207
14012,2016-08-01,00Q,997,546,1543,0.6461438755670771
14013,2016-08-01,00R,1153,894,2047,0.5632633121641426
14014,2016-08-01,00T,1896,1165,3061,0.6194054230643581
14015,2016-08-01,00V,1079,1035,2114,0.5104068117313151
14016,2016-08-01,00X,1034,440,1474,0.7014925373134329
14017,2016-08-01,00Y,1558,1324,2882,0.5405968077723803
14018,2016-08-01,01A,2184,1449,3633,0.6011560693641619
14019,2016-08-01,01C,866,787,1653,0.5238959467634604
14020,2016-08-01,01D,1215,995,2210,0.5497737556561086
14021,2016-08-01,01E,1044,391,1435,0.7275261324041812
14022,2016-08-01,01F,802,628,1430,0.5608391608391609
14023,2016-08-01,01G,1221,1459,2680,0.45559701492537313
14024,2016-08-01,01H,2420,1205,3625,0.6675862068965517
14025,2016-08-01,01J,828,820,1648,0.5024271844660194
14026,2016-08-01,01K,1854,1938,3792,0.4889240506329114
14027,2016-08-01,01R,736,832,1568,0.46938775510204084
14028,2016-08-01,01T,597,718,1315,0.45399239543726233
14029,2016-08-01,01V,688,666,1354,0.5081240768094535
14030,2016-08-01,01W,2097,1148,3245,0.6462249614791987
14031,2016-08-01,01X,1390,998,2388,0.5820770519262981
14032,2016-08-01,01Y,732,1359,2091,0.3500717360114778
14033,2016-08-01,02A,990,1055,2045,0.4841075794621027
14034,2016-08-01,02D,437,497,934,0.4678800856531049
14035,2016-08-01,02E,1060,862,1922,0.5515088449531738
14036,2016-08-01,02F,1052,1415,2467,0.4264288609647345
14037,2016-08-01,02G,536,564,1100,0.48727272727272725
14038,2016-08-01,02H,1481,1656,3137,0.4721071087025821
14039,2016-08-01,02M,1080,582,1662,0.6498194945848376
14040,2016-08-01,02N,909,669,1578,0.5760456273764258
14041,2016-08-01,02P,903,1637,2540,0.35551181102362206
14042,2016-08-01,02Q,565,531,1096,0.5155109489051095
14043,2016-08-01,02R,2135,1344,3479,0.613682092555332
14044,2016-08-01,02T,1242,975,2217,0.5602165087956699
14045,2016-08-01,02V,613,1232,1845,0.3322493224932249
14046,2016-08-01,02W,583,441,1024,0.5693359375
14047,2016-08-01,02X,1877,1151,3028,0.6198811096433289
14048,2016-08-01,02Y,2133,1048,3181,0.6705438541339201
14049,2016-08-01,03A,1323,917,2240,0.590625
14050,2016-08-01,03C,984,1954,2938,0.3349217154526889
14051,2016-08-01,03D,898,578,1476,0.6084010840108401
14052,2016-08-01,03E,851,590,1441,0.5905621096460791
14053,2016-08-01,03F,1609,725,2334,0.6893744644387317
14054,2016-08-01,03G,921,1570,2491,0.36973103171417104
14055,2016-08-01,03H,1237,587,1824,0.6781798245614035
14056,2016-08-01,03J,1069,657,1726,0.619351100811124
14057,2016-08-01,03K,963,482,1445,0.6664359861591695
14058,2016-08-01,03L,992,1794,2786,0.3560660445082556
14059,2016-08-01,03M,911,476,1387,0.6568132660418169
14060,2016-08-01,03N,3262,1602,4864,0.670641447368421
14061,2016-08-01,03Q,1901,1076,2977,0.638562311051394
14062,2016-08-01,03R,2307,1454,3761,0.6134006913055039
14063,2016-08-01,03T,1870,968,2838,0.6589147286821705
14064,2016-08-01,03V,415,299,714,0.5812324929971989
14065,2016-08-01,03W,2371,1244,3615,0.6558782849239281
14066,2016-08-01,03X,272,500,772,0.35233160621761656
14067,2016-08-01,03Y,584,598,1182,0.494077834179357
14068,2016-08-01,04C,1965,848,2813,0.6985424813366513
14069,2016-08-01,04D,1347,826,2173,0.6198803497468937
14070,2016-08-01,04E,578,1405,1983,0.2914775592536561
14071,2016-08-01,04F,1478,1125,2603,0.5678063772570111
14072,2016-08-01,04G,3935,3051,6986,0.5632693959347266
14073,2016-08-01,04H,367,831,1198,0.3063439065108514
14074,2016-08-01,04J,1619,1617,3236,0.5003090234857849
14075,2016-08-01,04K,643,1845,2488,0.2584405144694534
14076,2016-08-01,04L,327,967,1294,0.2527047913446677
14077,2016-08-01,04M,162,591,753,0.2151394422310757
14078,2016-08-01,04N,225,826,1051,0.21408182683158897
14079,2016-08-01,04Q,794,549,1343,0.5912137006701415
14080,2016-08-01,04R,1849,2154,4003,0.4619035723207594
14081,2016-08-01,04V,2331,1299,3630,0.6421487603305785
14082,2016-08-01,04X,1123,1492,2615,0.42944550669216064
14083,2016-08-01,04Y,942,485,1427,0.6601261387526279
14084,2016-08-01,05A,1821,2324,4145,0.43932448733413754
14085,2016-08-01,05C,1061,1976,3037,0.3493579189990122
14086,2016-08-01,05D,1084,519,1603,0.6762320648783531
14087,2016-08-01,05F,1015,1114,2129,0.4767496477219352
14088,2016-08-01,05G,1648,761,2409,0.6841012868410129
14089,2016-08-01,05H,907,957,1864,0.486587982832618
14090,2016-08-01,05J,1354,789,2143,0.6318245450303314
14091,2016-08-01,05L,2218,2049,4267,0.5198031403796578
14092,2016-08-01,05N,2139,1237,3376,0.6335900473933649
14093,2016-08-01,05P,932,1358,2290,0.4069868995633188
14094,2016-08-01,05Q,1458,881,2339,0.6233433091064557
14095,2016-08-01,05R,1177,1818,2995,0.39298831385642735
14096,2016-08-01,05T,2036,1369,3405,0.5979441997063143
14097,2016-08-01,05V,997,625,1622,0.6146732429099877
14098,2016-08-01,05W,1950,913,2863,0.6811037373384562
14099,2016-08-01,05X,916,771,1687,0.5429756965026674
14100,2016-08-01,05Y,1670,1234,2904,0.5750688705234159
14101,2016-08-01,06A,1331,1044,2375,0.5604210526315789
14102,2016-08-01,06D,840,577,1417,0.592801693719125
14103,2016-08-01,06F,1611,2599,4210,0.38266033254156767
14104,2016-08-01,06H,5187,3417,8604,0.6028591352859135
14105,2016-08-01,06K,2960,3213,6173,0.4795075328041471
14106,2016-08-01,06L,2580,1252,3832,0.673277661795407
14107,2016-08-01,06M,1853,1102,2955,0.6270727580372251
14108,2016-08-01,06N,2858,2994,5852,0.48838004101161997
14109,2016-08-01,06P,783,1006,1789,0.43767467859139186
14110,2016-08-01,06Q,2504,1371,3875,0.6461935483870968
14111,2016-08-01,06T,2174,1785,3959,0.5491285678201566
14112,2016-08-01,06V,1380,844,2224,0.6205035971223022
14113,2016-08-01,06W,1379,941,2320,0.594396551724138
14114,2016-08-01,06Y,1283,760,2043,0.6279980420949584
14115,2016-08-01,07G,880,389,1269,0.6934594168636722
14116,2016-08-01,07H,1664,1216,2880,0.5777777777777777
14117,2016-08-01,07J,995,738,1733,0.5741488747836122
14118,2016-08-01,07K,1474,799,2273,0.6484821821381435
14119,2016-08-01,07L,702,447,1149,0.6109660574412533
14120,2016-08-01,07M,1168,1289,2457,0.47537647537647537
14121,2016-08-01,07N,1367,887,2254,0.6064773735581189
14122,2016-08-01,07P,751,819,1570,0.478343949044586
14123,2016-08-01,07Q,1638,834,2472,0.662621359223301
14124,2016-08-01,07R,534,791,1325,0.4030188679245283
14125,2016-08-01,07T,535,855,1390,0.38489208633093525
14126,2016-08-01,07V,1089,1785,2874,0.37891440501043844
14127,2016-08-01,07W,1097,923,2020,0.5430693069306931
14128,2016-08-01,07X,1087,908,1995,0.5448621553884712
14129,2016-08-01,07Y,911,575,1486,0.6130551816958277
14130,2016-08-01,08A,972,720,1692,0.574468085106383
14131,2016-08-01,08C,584,580,1164,0.5017182130584192
14132,2016-08-01,08D,774,657,1431,0.5408805031446541
14133,2016-08-01,08E,839,701,1540,0.5448051948051948
14134,2016-08-01,08F,1330,765,2095,0.6348448687350835
14135,2016-08-01,08G,393,1432,1825,0.21534246575342467
14136,2016-08-01,08H,492,1037,1529,0.32177894048397643
14137,2016-08-01,08J,782,657,1439,0.5434329395413482
14138,2016-08-01,08K,1069,929,1998,0.535035035035035
14139,2016-08-01,08L,602,1361,1963,0.3066734589913398
14140,2016-08-01,08M,1098,751,1849,0.5938345051379124
14141,2016-08-01,08N,1213,643,1856,0.6535560344827587
14142,2016-08-01,08P,850,621,1471,0.5778382053025153
14143,2016-08-01,08Q,713,774,1487,0.47948890383322124
14144,2016-08-01,08R,894,573,1467,0.6094069529652352
14145,2016-08-01,08T,973,709,1682,0.5784780023781213
14146,2016-08-01,08V,1063,928,1991,0.5339025615268709
14147,2016-08-01,08W,1009,688,1697,0.5945786682380672
14148,2016-08-01,08X,1237,1155,2392,0.5171404682274248
14149,2016-08-01,08Y,622,604,1226,0.5073409461663948
14150,2016-08-01,09A,510,735,1245,0.40963855421686746
14151,2016-08-01,09C,723,590,1313,0.5506473724295506
14152,2016-08-01,09D,1192,1323,2515,0.4739562624254473
14153,2016-08-01,09E,1528,954,2482,0.6156325543916197
14154,2016-08-01,09F,1368,751,2119,0.6455875412930627
14155,2016-08-01,09G,3711,2140,5851,0.634250555460605
14156,2016-08-01,09H,514,392,906,0.5673289183222958
14157,2016-08-01,09J,1561,1210,2771,0.5633345362684952
14158,2016-08-01,09L,821,649,1470,0.5585034013605442
14159,2016-08-01,09N,1010,799,1809,0.5583195135433942
14160,2016-08-01,09P,1116,878,1994,0.559679037111334
14161,2016-08-01,09W,1384,1007,2391,0.5788373065662903
14162,2016-08-01,09X,980,846,1826,0.5366922234392114
14163,2016-08-01,09Y,1275,1613,2888,0.44148199445983377
14164,2016-08-01,10A,1229,915,2144,0.5732276119402985
14165,2016-08-01,10C,391,389,780,0.5012820512820513
14166,2016-08-01,10D,580,501,1081,0.5365402405180388
14167,2016-08-01,10E,831,493,1324,0.627643504531722
14168,2016-08-01,10G,705,528,1233,0.5717761557177615
14169,2016-08-01,10H,1726,1677,3403,0.5071995298266235
14170,2016-08-01,10J,1117,961,2078,0.5375360923965351
14171,2016-08-01,10K,1363,713,2076,0.6565510597302505
14172,2016-08-01,10L,1070,544,1614,0.6629491945477075
14173,2016-08-01,10M,535,475,1010,0.5297029702970297
14174,2016-08-01,10N,448,486,934,0.4796573875802998
14175,2016-08-01,10Q,3520,3061,6581,0.5348731195866889
14176,2016-08-01,10R,1362,690,2052,0.6637426900584795
14177,2016-08-01,10T,604,393,997,0.6058174523570712
14178,2016-08-01,10V,1361,682,2043,0.6661771904062653
14179,2016-08-01,10W,493,512,1005,0.490547263681592
14180,2016-08-01,10X,1213,754,1967,0.6166751398068124
14181,2016-08-01,10Y,1169,1096,2265,0.5161147902869757
14182,2016-08-01,11A,3240,1845,5085,0.6371681415929203
14183,2016-08-01,11C,839,453,1292,0.6493808049535603
14184,2016-08-01,11D,720,685,1405,0.5124555160142349
14185,2016-08-01,11E,896,1051,1947,0.4601951720595788
14186,2016-08-01,11H,2595,1707,4302,0.6032078103207811
14187,2016-08-01,11J,5347,2846,8193,0.6526302941535457
14188,2016-08-01,11M,3789,2209,5998,0.6317105701900634
14189,2016-08-01,11N,3164,3232,6396,0.49468417761100686
14190,2016-08-01,11T,1583,1038,2621,0.603967951163678
14191,2016-08-01,11X,3255,2083,5338,0.6097789434245036
14192,2016-08-01,12A,1589,928,2517,0.6313071116408423
14193,2016-08-01,12D,1163,953,2116,0.5496219281663516
14194,2016-08-01,12F,2226,1191,3417,0.6514486391571555
14195,2016-08-01,13P,2128,3707,5835,0.3646958011996572
14196,2016-08-01,13T,3195,1769,4964,0.6436341659951652
14197,2016-08-01,14L,2681,2304,4985,0.5378134403209629
14198,2016-08-01,99A,2105,2172,4277,0.4921674070610241
14199,2016-08-01,99C,1467,927,2394,0.6127819548872181
14200,2016-08-01,99D,1056,905,1961,0.5385007649158593
14201,2016-08-01,99E,1747,701,2448,0.7136437908496732
14202,2016-08-01,99F,1223,487,1710,0.7152046783625731
14203,2016-08-01,99G,1059,418,1477,0.7169939065673663
14204,2016-08-01,99H,1495,1311,2806,0.5327868852459017
14205,2016-08-01,99J,2944,2051,4995,0.5893893893893893
14206,2016-08-01,99K,930,842,1772,0.5248306997742663
14207,2016-08-01,99M,1087,990,2077,0.5233509870004814
14208,2016-08-01,99N,2902,2592,5494,0.5282125955587914
14209,2016-08-01,99P,6246,3155,9401,0.6643974045314328
14210,2016-08-01,99Q,1919,1087,3006,0.6383898868928809
14211,2016-09-01,00C,833,400,1233,0.67558799675588
14212,2016-09-01,00D,2190,1196,3386,0.6467808623744832
14213,2016-09-01,00J,1728,807,2535,0.6816568047337278
14214,2016-09-01,00K,2296,1265,3561,0.6447627071047458
14215,2016-09-01,00L,2259,1431,3690,0.6121951219512195
14216,2016-09-01,00M,2421,1194,3615,0.6697095435684647
14217,2016-09-01,00N,1242,660,1902,0.6529968454258676
14218,2016-09-01,00P,2034,883,2917,0.6972917380870758
14219,2016-09-01,00Q,1109,587,1696,0.6538915094339622
14220,2016-09-01,00R,1148,863,2011,0.5708602685231228
14221,2016-09-01,00T,1970,1294,3264,0.6035539215686274
14222,2016-09-01,00V,1115,1069,2184,0.5105311355311355
14223,2016-09-01,00X,1070,517,1587,0.6742281033396346
14224,2016-09-01,00Y,1583,1267,2850,0.5554385964912281
14225,2016-09-01,01A,2246,1548,3794,0.5919873484449131
14226,2016-09-01,01C,880,826,1706,0.5158264947245017
14227,2016-09-01,01D,1296,1007,2303,0.5627442466348241
14228,2016-09-01,01E,1090,447,1537,0.7091737150292778
14229,2016-09-01,01F,848,688,1536,0.5520833333333334
14230,2016-09-01,01G,1285,1518,2803,0.45843738851230825
14231,2016-09-01,01H,2523,1146,3669,0.687653311529027
14232,2016-09-01,01J,923,895,1818,0.5077007700770076
14233,2016-09-01,01K,1735,1939,3674,0.47223734349482854
14234,2016-09-01,01R,781,837,1618,0.4826946847960445
14235,2016-09-01,01T,672,789,1461,0.459958932238193
14236,2016-09-01,01V,673,690,1363,0.4937637564196625
14237,2016-09-01,01W,2035,1151,3186,0.6387319522912743
14238,2016-09-01,01X,1318,1014,2332,0.565180102915952
14239,2016-09-01,01Y,742,1330,2072,0.3581081081081081
14240,2016-09-01,02A,976,965,1941,0.502833590932509
14241,2016-09-01,02D,477,510,987,0.48328267477203646
14242,2016-09-01,02E,1056,871,1927,0.5480020757654385
14243,2016-09-01,02F,1132,1507,2639,0.42895035998484277
14244,2016-09-01,02G,592,549,1141,0.5188431200701139
14245,2016-09-01,02H,1539,1819,3358,0.4583085169743895
14246,2016-09-01,02M,1074,590,1664,0.6454326923076923
14247,2016-09-01,02N,1042,736,1778,0.5860517435320585
14248,2016-09-01,02P,992,1740,2732,0.363103953147877
14249,2016-09-01,02Q,595,572,1167,0.5098543273350471
14250,2016-09-01,02R,2085,1250,3335,0.6251874062968515
14251,2016-09-01,02T,1398,957,2355,0.5936305732484076
14252,2016-09-01,02V,667,1302,1969,0.3387506348400203
14253,2016-09-01,02W,596,418,1014,0.5877712031558185
14254,2016-09-01,02X,1867,1242,3109,0.6005146349308459
14255,2016-09-01,02Y,2127,1045,3172,0.6705548549810845
14256,2016-09-01,03A,1491,971,2462,0.6056051990251827
14257,2016-09-01,03C,1012,2114,3126,0.3237364043506078
14258,2016-09-01,03D,820,570,1390,0.5899280575539568
14259,2016-09-01,03E,919,614,1533,0.5994781474233529
14260,2016-09-01,03F,1801,724,2525,0.7132673267326732
14261,2016-09-01,03G,1042,1594,2636,0.3952959028831563
14262,2016-09-01,03H,1284,596,1880,0.6829787234042554
14263,2016-09-01,03J,1182,650,1832,0.6451965065502183
14264,2016-09-01,03K,961,497,1458,0.659122085048011
14265,2016-09-01,03L,942,1813,2755,0.34192377495462795
14266,2016-09-01,03M,883,477,1360,0.649264705882353
14267,2016-09-01,03N,3287,1688,4975,0.6607035175879397
14268,2016-09-01,03Q,2007,1144,3151,0.6369406537607109
14269,2016-09-01,03R,2396,1552,3948,0.6068895643363729
14270,2016-09-01,03T,1913,935,2848,0.6716994382022472
14271,2016-09-01,03V,441,339,780,0.5653846153846154
14272,2016-09-01,03W,2317,1257,3574,0.6482932288752099
14273,2016-09-01,03X,313,503,816,0.38357843137254904
14274,2016-09-01,03Y,600,671,1271,0.47206923682140045
14275,2016-09-01,04C,2182,974,3156,0.6913814955640051
14276,2016-09-01,04D,1473,888,2361,0.6238881829733164
14277,2016-09-01,04E,591,1440,2031,0.29098966026587886
14278,2016-09-01,04F,1680,1149,2829,0.5938494167550371
14279,2016-09-01,04G,4146,3240,7386,0.561332250203087
14280,2016-09-01,04H,400,881,1281,0.312256049960968
14281,2016-09-01,04J,1698,1727,3425,0.49576642335766424
14282,2016-09-01,04K,625,1900,2525,0.24752475247524752
14283,2016-09-01,04L,266,1020,1286,0.20684292379471228
14284,2016-09-01,04M,174,612,786,0.22137404580152673
14285,2016-09-01,04N,206,856,1062,0.19397363465160075
14286,2016-09-01,04Q,788,546,1334,0.5907046476761619
14287,2016-09-01,04R,1925,2431,4356,0.44191919191919193
14288,2016-09-01,04V,2582,1376,3958,0.6523496715512885
14289,2016-09-01,04X,1051,1581,2632,0.3993161094224924
14290,2016-09-01,04Y,975,420,1395,0.6989247311827957
14291,2016-09-01,05A,1801,2345,4146,0.43439459720212253
14292,2016-09-01,05C,1112,2204,3316,0.3353437876960193
14293,2016-09-01,05D,1031,505,1536,0.6712239583333334
14294,2016-09-01,05F,1058,1177,2235,0.4733780760626398
14295,2016-09-01,05G,1643,799,2442,0.6728091728091729
14296,2016-09-01,05H,952,1059,2011,0.4733963202386872
14297,2016-09-01,05J,1422,789,2211,0.6431478968792401
14298,2016-09-01,05L,2280,2187,4467,0.5104096709200806
14299,2016-09-01,05N,2156,1368,3524,0.6118047673098751
14300,2016-09-01,05P,915,1520,2435,0.3757700205338809
14301,2016-09-01,05Q,1596,924,2520,0.6333333333333333
14302,2016-09-01,05R,1209,1866,3075,0.3931707317073171
14303,2016-09-01,05T,2073,1463,3536,0.5862556561085973
14304,2016-09-01,05V,1006,720,1726,0.5828505214368482
14305,2016-09-01,05W,2108,983,3091,0.6819799417664186
14306,2016-09-01,05X,958,810,1768,0.5418552036199095
14307,2016-09-01,05Y,1761,1205,2966,0.5937289278489548
14308,2016-09-01,06A,1315,1026,2341,0.5617257582229817
14309,2016-09-01,06D,888,599,1487,0.5971755211835911
14310,2016-09-01,06F,1663,2776,4439,0.374633926560036
14311,2016-09-01,06H,5264,3680,8944,0.5885509838998211
14312,2016-09-01,06K,3117,3340,6457,0.4827319188477621
14313,2016-09-01,06L,2630,1206,3836,0.6856100104275287
14314,2016-09-01,06M,2145,1045,3190,0.6724137931034483
14315,2016-09-01,06N,2970,3118,6088,0.4878449408672799
14316,2016-09-01,06P,840,1098,1938,0.43343653250773995
14317,2016-09-01,06Q,2511,1485,3996,0.6283783783783784
14318,2016-09-01,06T,2187,1817,4004,0.5462037962037962
14319,2016-09-01,06V,1432,881,2313,0.6191093817552962
14320,2016-09-01,06W,1475,964,2439,0.6047560475604756
14321,2016-09-01,06Y,1346,856,2202,0.6112624886466849
14322,2016-09-01,07G,972,400,1372,0.7084548104956269
14323,2016-09-01,07H,1817,1296,3113,0.583681336331513
14324,2016-09-01,07J,1035,748,1783,0.5804823331463825
14325,2016-09-01,07K,1565,752,2317,0.6754423823910228
14326,2016-09-01,07L,801,479,1280,0.62578125
14327,2016-09-01,07M,1276,1327,2603,0.4902036112178256
14328,2016-09-01,07N,1508,870,2378,0.6341463414634146
14329,2016-09-01,07P,844,831,1675,0.5038805970149254
14330,2016-09-01,07Q,1704,906,2610,0.6528735632183909
14331,2016-09-01,07R,570,847,1417,0.40225829216654907
14332,2016-09-01,07T,537,967,1504,0.3570478723404255
14333,2016-09-01,07V,1058,1798,2856,0.3704481792717087
14334,2016-09-01,07W,1233,1000,2233,0.5521719659650695
14335,2016-09-01,07X,1144,930,2074,0.5515911282545806
14336,2016-09-01,07Y,984,593,1577,0.6239695624603678
14337,2016-09-01,08A,1077,763,1840,0.5853260869565218
14338,2016-09-01,08C,639,730,1369,0.46676406135865595
14339,2016-09-01,08D,768,743,1511,0.5082726671078756
14340,2016-09-01,08E,840,814,1654,0.5078597339782346
14341,2016-09-01,08F,1466,884,2350,0.6238297872340426
14342,2016-09-01,08G,532,1389,1921,0.2769390942217595
14343,2016-09-01,08H,548,1069,1617,0.3388991960420532
14344,2016-09-01,08J,794,591,1385,0.5732851985559567
14345,2016-09-01,08K,989,1094,2083,0.47479596735477675
14346,2016-09-01,08L,675,1399,2074,0.3254580520732883
14347,2016-09-01,08M,1146,782,1928,0.5943983402489627
14348,2016-09-01,08N,1265,647,1912,0.6616108786610879
14349,2016-09-01,08P,946,703,1649,0.5736810187992722
14350,2016-09-01,08Q,799,829,1628,0.4907862407862408
14351,2016-09-01,08R,849,523,1372,0.6188046647230321
14352,2016-09-01,08T,987,719,1706,0.5785463071512309
14353,2016-09-01,08V,1215,1049,2264,0.536660777385159
14354,2016-09-01,08W,1125,726,1851,0.6077795786061588
14355,2016-09-01,08X,1331,1194,2525,0.5271287128712872
14356,2016-09-01,08Y,703,676,1379,0.5097897026831038
14357,2016-09-01,09A,544,752,1296,0.41975308641975306
14358,2016-09-01,09C,741,666,1407,0.5266524520255863
14359,2016-09-01,09D,1259,1375,2634,0.4779802581624905
14360,2016-09-01,09E,1616,956,2572,0.6283048211508554
14361,2016-09-01,09F,1318,770,2088,0.6312260536398467
14362,2016-09-01,09G,3782,2184,5966,0.6339255782769024
14363,2016-09-01,09H,540,396,936,0.5769230769230769
14364,2016-09-01,09J,1609,1300,2909,0.553111034719835
14365,2016-09-01,09L,870,719,1589,0.5475141598489616
14366,2016-09-01,09N,1041,829,1870,0.5566844919786096
14367,2016-09-01,09P,1073,915,1988,0.539738430583501
14368,2016-09-01,09W,1401,1009,2410,0.5813278008298756
14369,2016-09-01,09X,983,912,1895,0.5187335092348285
14370,2016-09-01,09Y,1306,1610,2916,0.44787379972565156
14371,2016-09-01,10A,1326,955,2281,0.5813239807102148
14372,2016-09-01,10C,481,446,927,0.5188781014023732
14373,2016-09-01,10D,640,479,1119,0.5719392314566577
14374,2016-09-01,10E,908,463,1371,0.662290299051787
14375,2016-09-01,10G,716,458,1174,0.6098807495741057
14376,2016-09-01,10H,1674,1735,3409,0.4910530947491933
14377,2016-09-01,10J,1104,993,2097,0.5264663805436338
14378,2016-09-01,10K,1421,730,2151,0.6606229660622966
14379,2016-09-01,10L,1072,615,1687,0.6354475400118553
14380,2016-09-01,10M,515,481,996,0.5170682730923695
14381,2016-09-01,10N,437,529,966,0.4523809523809524
14382,2016-09-01,10Q,3646,3148,6794,0.5366499852811304
14383,2016-09-01,10R,1512,719,2231,0.6777229941730166
14384,2016-09-01,10T,703,368,1071,0.6563958916900093
14385,2016-09-01,10V,1378,810,2188,0.629798903107861
14386,2016-09-01,10W,548,522,1070,0.5121495327102804
14387,2016-09-01,10X,1259,783,2042,0.6165523996082273
14388,2016-09-01,10Y,1271,1265,2536,0.5011829652996845
14389,2016-09-01,11A,3455,2061,5516,0.6263596809282088
14390,2016-09-01,11C,931,541,1472,0.6324728260869565
14391,2016-09-01,11D,711,714,1425,0.49894736842105264
14392,2016-09-01,11E,937,1070,2007,0.46686596910812156
14393,2016-09-01,11H,2729,1822,4551,0.5996484289167217
14394,2016-09-01,11J,5496,2884,8380,0.6558472553699284
14395,2016-09-01,11M,4173,2361,6534,0.6386593204775023
14396,2016-09-01,11N,3134,3465,6599,0.47492044249128657
14397,2016-09-01,11T,1654,1019,2673,0.6187803965581743
14398,2016-09-01,11X,3365,2189,5554,0.60586964350018
14399,2016-09-01,12A,1551,910,2461,0.6302316131653799
14400,2016-09-01,12D,1191,982,2173,0.5480901978831109
14401,2016-09-01,12F,2300,1298,3598,0.6392440244580322
14402,2016-09-01,13P,2135,3732,5867,0.3638997784216806
14403,2016-09-01,13T,3108,1732,4840,0.6421487603305785
14404,2016-09-01,14L,2847,2416,5263,0.5409462283868516
14405,2016-09-01,99A,2193,2259,4452,0.4925876010781671
14406,2016-09-01,99C,1561,947,2508,0.6224082934609251
14407,2016-09-01,99D,1141,961,2102,0.5428163653663178
14408,2016-09-01,99E,1723,742,2465,0.6989858012170386
14409,2016-09-01,99F,1292,534,1826,0.7075575027382256
14410,2016-09-01,99G,1079,427,1506,0.7164674634794157
14411,2016-09-01,99H,1485,1298,2783,0.5335968379446641
14412,2016-09-01,99J,3098,2162,5260,0.5889733840304182
14413,2016-09-01,99K,967,837,1804,0.5360310421286031
14414,2016-09-01,99M,1118,1017,2135,0.5236533957845433
14415,2016-09-01,99N,3154,2755,5909,0.5337620578778135
14416,2016-09-01,99P,6312,3325,9637,0.6549756148178894
14417,2016-09-01,99Q,1999,1138,3137,0.6372330251832962
14418,2016-10-01,00C,742,357,1099,0.6751592356687898
14419,2016-10-01,00D,2117,1143,3260,0.6493865030674847
14420,2016-10-01,00J,1688,852,2540,0.6645669291338583
14421,2016-10-01,00K,2131,1075,3206,0.664691203992514
14422,2016-10-01,00L,2162,1268,3430,0.6303206997084548
14423,2016-10-01,00M,2076,1195,3271,0.6346682971568328
14424,2016-10-01,00N,1150,592,1742,0.6601607347876005
14425,2016-10-01,00P,1891,872,2763,0.6844010133912414
14426,2016-10-01,00Q,983,563,1546,0.6358344113842174
14427,2016-10-01,00R,1087,831,1918,0.5667361835245047
14428,2016-10-01,00T,1736,1156,2892,0.6002766251728907
14429,2016-10-01,00V,1129,983,2112,0.5345643939393939
14430,2016-10-01,00X,1002,479,1481,0.6765698852126941
14431,2016-10-01,00Y,1439,1290,2729,0.5272993770611946
14432,2016-10-01,01A,2100,1462,3562,0.5895564289724874
14433,2016-10-01,01C,863,839,1702,0.5070505287896592
14434,2016-10-01,01D,1141,925,2066,0.5522749273959342
14435,2016-10-01,01E,1024,475,1499,0.6831220813875917
14436,2016-10-01,01F,811,637,1448,0.5600828729281768
14437,2016-10-01,01G,1249,1413,2662,0.4691960931630353
14438,2016-10-01,01H,2384,1148,3532,0.6749716874292185
14439,2016-10-01,01J,874,800,1674,0.5221027479091995
14440,2016-10-01,01K,1693,1771,3464,0.48874133949191684
14441,2016-10-01,01R,785,839,1624,0.4833743842364532
14442,2016-10-01,01T,596,762,1358,0.43888070692194403
14443,2016-10-01,01V,587,685,1272,0.46147798742138363
14444,2016-10-01,01W,1872,1058,2930,0.6389078498293516
14445,2016-10-01,01X,1351,971,2322,0.5818260120585702
14446,2016-10-01,01Y,729,1277,2006,0.3634097706879362
14447,2016-10-01,02A,1015,982,1997,0.5082623935903856
14448,2016-10-01,02D,406,484,890,0.45617977528089887
14449,2016-10-01,02E,988,876,1864,0.5300429184549357
14450,2016-10-01,02F,1021,1327,2348,0.4348381601362862
14451,2016-10-01,02G,541,534,1075,0.5032558139534884
14452,2016-10-01,02H,1485,1682,3167,0.468898010735712
14453,2016-10-01,02M,1077,584,1661,0.6484045755568935
14454,2016-10-01,02N,1007,684,1691,0.5955056179775281
14455,2016-10-01,02P,965,1627,2592,0.3722993827160494
14456,2016-10-01,02Q,602,523,1125,0.5351111111111111
14457,2016-10-01,02R,1965,1214,3179,0.6181189053161371
14458,2016-10-01,02T,1157,933,2090,0.5535885167464115
14459,2016-10-01,02V,673,1203,1876,0.35874200426439234
14460,2016-10-01,02W,564,397,961,0.586888657648283
14461,2016-10-01,02X,1853,1169,3022,0.613170086035738
14462,2016-10-01,02Y,2035,968,3003,0.6776556776556777
14463,2016-10-01,03A,1386,894,2280,0.6078947368421053
14464,2016-10-01,03C,952,2149,3101,0.30699774266365687
14465,2016-10-01,03D,820,509,1329,0.617005267118134
14466,2016-10-01,03E,857,650,1507,0.568679495686795
14467,2016-10-01,03F,1807,688,2495,0.724248496993988
14468,2016-10-01,03G,942,1530,2472,0.38106796116504854
14469,2016-10-01,03H,1238,510,1748,0.7082379862700229
14470,2016-10-01,03J,1077,570,1647,0.6539162112932605
14471,2016-10-01,03K,982,485,1467,0.6693933197000682
14472,2016-10-01,03L,921,1709,2630,0.3501901140684411
14473,2016-10-01,03M,802,486,1288,0.6226708074534162
14474,2016-10-01,03N,3184,1697,4881,0.6523253431673838
14475,2016-10-01,03Q,2024,1086,3110,0.6508038585209003
14476,2016-10-01,03R,2273,1421,3694,0.6153221440173254
14477,2016-10-01,03T,1830,871,2701,0.6775268419104036
14478,2016-10-01,03V,439,346,785,0.5592356687898089
14479,2016-10-01,03W,2336,1210,3546,0.658770445572476
14480,2016-10-01,03X,254,454,708,0.3587570621468927
14481,2016-10-01,03Y,530,583,1113,0.47619047619047616
14482,2016-10-01,04C,2067,935,3002,0.6885409726848768
14483,2016-10-01,04D,1349,828,2177,0.6196600826825908
14484,2016-10-01,04E,510,1301,1811,0.2816123688569851
14485,2016-10-01,04F,1459,1098,2557,0.570590535784122
14486,2016-10-01,04G,3925,3111,7036,0.5578453666856168
14487,2016-10-01,04H,386,848,1234,0.31280388978930307
14488,2016-10-01,04J,1556,1662,3218,0.48353014294592916
14489,2016-10-01,04K,643,1985,2628,0.24467275494672755
14490,2016-10-01,04L,305,953,1258,0.2424483306836248
14491,2016-10-01,04M,145,548,693,0.20923520923520925
14492,2016-10-01,04N,228,861,1089,0.209366391184573
14493,2016-10-01,04Q,748,492,1240,0.603225806451613
14494,2016-10-01,04R,1809,2212,4021,0.4498880875404128
14495,2016-10-01,04V,2433,1364,3797,0.6407690281801423
14496,2016-10-01,04X,1116,1524,2640,0.42272727272727273
14497,2016-10-01,04Y,877,468,1345,0.6520446096654275
14498,2016-10-01,05A,1730,2310,4040,0.4282178217821782
14499,2016-10-01,05C,1102,2259,3361,0.3278786075572746
14500,2016-10-01,05D,1056,497,1553,0.6799742433998712
14501,2016-10-01,05F,1037,1135,2172,0.47744014732965007
14502,2016-10-01,05G,1631,819,2450,0.6657142857142857
14503,2016-10-01,05H,899,975,1874,0.4797225186766275
14504,2016-10-01,05J,1419,746,2165,0.6554272517321016
14505,2016-10-01,05L,2246,2216,4462,0.503361721201255
14506,2016-10-01,05N,2028,1300,3328,0.609375
14507,2016-10-01,05P,858,1386,2244,0.38235294117647056
14508,2016-10-01,05Q,1410,857,2267,0.6219673577415086
14509,2016-10-01,05R,1143,1815,2958,0.38640973630831643
14510,2016-10-01,05T,2045,1320,3365,0.6077265973254086
14511,2016-10-01,05V,946,574,1520,0.6223684210526316
14512,2016-10-01,05W,1829,937,2766,0.6612436731742588
14513,2016-10-01,05X,993,714,1707,0.5817223198594025
14514,2016-10-01,05Y,1646,1199,2845,0.5785588752196836
14515,2016-10-01,06A,1369,1068,2437,0.5617562576938859
14516,2016-10-01,06D,830,564,1394,0.5954088952654233
14517,2016-10-01,06F,1643,2646,4289,0.3830729773840056
14518,2016-10-01,06H,5106,3491,8597,0.593928114458532
14519,2016-10-01,06K,2984,3364,6348,0.4700693131695022
14520,2016-10-01,06L,2409,1187,3596,0.6699110122358176
14521,2016-10-01,06M,1882,1045,2927,0.6429791595490263
14522,2016-10-01,06N,2810,2839,5649,0.49743317401309967
14523,2016-10-01,06P,848,991,1839,0.46112017400761285
14524,2016-10-01,06Q,2310,1362,3672,0.6290849673202614
14525,2016-10-01,06T,2051,1722,3773,0.5435992578849722
14526,2016-10-01,06V,1371,833,2204,0.6220508166969148
14527,2016-10-01,06W,1527,874,2401,0.635985006247397
14528,2016-10-01,06Y,1259,805,2064,0.6099806201550387
14529,2016-10-01,07G,869,384,1253,0.6935355147645651
14530,2016-10-01,07H,1751,1290,3041,0.5757974350542585
14531,2016-10-01,07J,900,712,1612,0.5583126550868487
14532,2016-10-01,07K,1503,759,2262,0.6644562334217506
14533,2016-10-01,07L,793,454,1247,0.6359262229350441
14534,2016-10-01,07M,1249,1472,2721,0.4590224182285924
14535,2016-10-01,07N,1453,915,2368,0.613597972972973
14536,2016-10-01,07P,794,818,1612,0.49255583126550867
14537,2016-10-01,07Q,1628,801,2429,0.6702346644709757
14538,2016-10-01,07R,570,860,1430,0.3986013986013986
14539,2016-10-01,07T,565,934,1499,0.37691794529686456
14540,2016-10-01,07V,1027,1798,2825,0.36353982300884957
14541,2016-10-01,07W,1170,1036,2206,0.5303717135086129
14542,2016-10-01,07X,1154,939,2093,0.5513616817964644
14543,2016-10-01,07Y,969,627,1596,0.6071428571428571
14544,2016-10-01,08A,1025,729,1754,0.5843785632839225
14545,2016-10-01,08C,643,606,1249,0.5148118494795837
14546,2016-10-01,08D,759,670,1429,0.5311406578026592
14547,2016-10-01,08E,816,797,1613,0.5058896466212027
14548,2016-10-01,08F,1422,899,2321,0.6126669538991814
14549,2016-10-01,08G,430,1434,1864,0.23068669527896996
14550,2016-10-01,08H,525,988,1513,0.34699272967614014
14551,2016-10-01,08J,780,589,1369,0.5697589481373265
14552,2016-10-01,08K,1014,1089,2103,0.48216833095577744
14553,2016-10-01,08L,607,1313,1920,0.31614583333333335
14554,2016-10-01,08M,1184,817,2001,0.591704147926037
14555,2016-10-01,08N,1215,628,1843,0.6592512208355942
14556,2016-10-01,08P,924,698,1622,0.5696670776818742
14557,2016-10-01,08Q,728,825,1553,0.4687701223438506
14558,2016-10-01,08R,880,517,1397,0.6299212598425197
14559,2016-10-01,08T,957,707,1664,0.5751201923076923
14560,2016-10-01,08V,1149,1052,2201,0.522035438437074
14561,2016-10-01,08W,1054,744,1798,0.5862068965517241
14562,2016-10-01,08X,1233,1144,2377,0.5187210769877998
14563,2016-10-01,08Y,636,638,1274,0.49921507064364207
14564,2016-10-01,09A,524,799,1323,0.3960695389266818
14565,2016-10-01,09C,723,526,1249,0.5788630904723779
14566,2016-10-01,09D,1241,1293,2534,0.4897395422257301
14567,2016-10-01,09E,1447,904,2351,0.6154827732879625
14568,2016-10-01,09F,1242,796,2038,0.6094210009813543
14569,2016-10-01,09G,3509,2085,5594,0.6272792277440115
14570,2016-10-01,09H,545,393,938,0.5810234541577826
14571,2016-10-01,09J,1500,1198,2698,0.5559673832468495
14572,2016-10-01,09L,844,726,1570,0.5375796178343949
14573,2016-10-01,09N,1063,826,1889,0.5627316040232927
14574,2016-10-01,09P,1101,1015,2116,0.5203213610586012
14575,2016-10-01,09W,1310,999,2309,0.5673451710697271
14576,2016-10-01,09X,969,910,1879,0.5156998403406067
14577,2016-10-01,09Y,1378,1679,3057,0.45076872751063135
14578,2016-10-01,10A,1229,930,2159,0.5692450208429829
14579,2016-10-01,10C,485,372,857,0.5659276546091015
14580,2016-10-01,10D,610,517,1127,0.541259982253771
14581,2016-10-01,10E,861,492,1353,0.6363636363636364
14582,2016-10-01,10G,655,404,1059,0.6185080264400378
14583,2016-10-01,10H,1716,1676,3392,0.5058962264150944
14584,2016-10-01,10J,1073,947,2020,0.5311881188118812
14585,2016-10-01,10K,1267,682,1949,0.6500769625448948
14586,2016-10-01,10L,1085,595,1680,0.6458333333333334
14587,2016-10-01,10M,445,531,976,0.45594262295081966
14588,2016-10-01,10N,411,505,916,0.44868995633187775
14589,2016-10-01,10Q,3362,2998,6360,0.5286163522012579
14590,2016-10-01,10R,1395,721,2116,0.6592627599243857
14591,2016-10-01,10T,647,382,1029,0.6287657920310982
14592,2016-10-01,10V,1279,720,1999,0.6398199099549775
14593,2016-10-01,10W,494,531,1025,0.4819512195121951
14594,2016-10-01,10X,1234,836,2070,0.5961352657004831
14595,2016-10-01,10Y,1187,1196,2383,0.4981116240033571
14596,2016-10-01,11A,3219,2013,5232,0.6152522935779816
14597,2016-10-01,11C,923,494,1417,0.6513761467889908
14598,2016-10-01,11D,641,697,1338,0.4790732436472347
14599,2016-10-01,11E,907,1035,1942,0.4670442842430484
14600,2016-10-01,11H,2565,1757,4322,0.593475242943082
14601,2016-10-01,11J,5283,2604,7887,0.6698364397109167
14602,2016-10-01,11M,3984,2242,6226,0.63989720526823
14603,2016-10-01,11N,2862,3244,6106,0.46871929249918115
14604,2016-10-01,11T,1456,1019,2475,0.5882828282828283
14605,2016-10-01,11X,3027,1984,5011,0.6040710437038516
14606,2016-10-01,12A,1518,893,2411,0.6296142679386146
14607,2016-10-01,12D,1138,909,2047,0.5559355153883733
14608,2016-10-01,12F,2038,1427,3465,0.5881673881673881
14609,2016-10-01,13P,2041,3663,5704,0.35781907433380084
14610,2016-10-01,13T,3147,1729,4876,0.6454060705496308
14611,2016-10-01,14L,2716,2292,5008,0.542332268370607
14612,2016-10-01,99A,2023,2214,4237,0.4774604673117772
14613,2016-10-01,99C,1384,858,2242,0.6173059768064229
14614,2016-10-01,99D,1090,957,2047,0.5324865657059111
14615,2016-10-01,99E,1671,744,2415,0.6919254658385093
14616,2016-10-01,99F,1194,467,1661,0.7188440698374473
14617,2016-10-01,99G,972,414,1386,0.7012987012987013
14618,2016-10-01,99H,1503,1326,2829,0.5312831389183457
14619,2016-10-01,99J,2941,2104,5045,0.5829534192269574
14620,2016-10-01,99K,959,839,1798,0.5333704115684094
14621,2016-10-01,99M,1015,930,1945,0.5218508997429306
14622,2016-10-01,99N,2849,2550,5399,0.5276903130209298
14623,2016-10-01,99P,6030,3090,9120,0.6611842105263158
14624,2016-10-01,99Q,1898,1042,2940,0.645578231292517
14625,2016-11-01,00C,757,368,1125,0.6728888888888889
14626,2016-11-01,00D,2056,1180,3236,0.6353522867737948
14627,2016-11-01,00J,1762,910,2672,0.6594311377245509
14628,2016-11-01,00K,2214,1068,3282,0.6745886654478976
14629,2016-11-01,00L,2132,1294,3426,0.6223000583771162
14630,2016-11-01,00M,2061,1264,3325,0.6198496240601504
14631,2016-11-01,00N,1155,597,1752,0.6592465753424658
14632,2016-11-01,00P,1894,912,2806,0.6749821810406272
14633,2016-11-01,00Q,918,494,1412,0.6501416430594901
14634,2016-11-01,00R,1027,802,1829,0.5615090213231274
14635,2016-11-01,00T,1803,1152,2955,0.6101522842639594
14636,2016-11-01,00V,1079,1040,2119,0.50920245398773
14637,2016-11-01,00X,1022,482,1504,0.6795212765957447
14638,2016-11-01,00Y,1449,1275,2724,0.5319383259911894
14639,2016-11-01,01A,1935,1538,3473,0.5571551972358192
14640,2016-11-01,01C,850,854,1704,0.4988262910798122
14641,2016-11-01,01D,1142,1027,2169,0.5265099124020286
14642,2016-11-01,01E,1017,426,1443,0.7047817047817048
14643,2016-11-01,01F,795,675,1470,0.5408163265306123
14644,2016-11-01,01G,1225,1402,2627,0.46631138180433956
14645,2016-11-01,01H,2285,1121,3406,0.6708749266001175
14646,2016-11-01,01J,894,816,1710,0.5228070175438596
14647,2016-11-01,01K,1637,1741,3378,0.4846062759029011
14648,2016-11-01,01R,796,789,1585,0.5022082018927445
14649,2016-11-01,01T,632,758,1390,0.4546762589928058
14650,2016-11-01,01V,611,668,1279,0.47771696637998434
14651,2016-11-01,01W,1823,1136,2959,0.6160865157147685
14652,2016-11-01,01X,1371,996,2367,0.5792141951837769
14653,2016-11-01,01Y,733,1297,2030,0.3610837438423645
14654,2016-11-01,02A,967,1005,1972,0.49036511156186613
14655,2016-11-01,02D,439,480,919,0.4776931447225245
14656,2016-11-01,02E,965,950,1915,0.5039164490861618
14657,2016-11-01,02F,1090,1333,2423,0.44985555096987206
14658,2016-11-01,02G,530,528,1058,0.500945179584121
14659,2016-11-01,02H,1492,1651,3143,0.4747056951956729
14660,2016-11-01,02M,963,608,1571,0.6129853596435392
14661,2016-11-01,02N,982,702,1684,0.5831353919239906
14662,2016-11-01,02P,942,1650,2592,0.36342592592592593
14663,2016-11-01,02Q,514,549,1063,0.4835371589840075
14664,2016-11-01,02R,1960,1218,3178,0.6167400881057269
14665,2016-11-01,02T,1136,1051,2187,0.5194330132601738
14666,2016-11-01,02V,632,1280,1912,0.3305439330543933
14667,2016-11-01,02W,529,419,948,0.5580168776371308
14668,2016-11-01,02X,1766,1259,3025,0.583801652892562
14669,2016-11-01,02Y,2114,1044,3158,0.6694110196326789
14670,2016-11-01,03A,1384,881,2265,0.611037527593819
14671,2016-11-01,03C,983,2078,3061,0.32113688337144725
14672,2016-11-01,03D,828,601,1429,0.5794261721483555
14673,2016-11-01,03E,816,625,1441,0.5662734212352533
14674,2016-11-01,03F,1726,686,2412,0.7155887230514096
14675,2016-11-01,03G,891,1541,2432,0.36636513157894735
14676,2016-11-01,03H,1254,538,1792,0.6997767857142857
14677,2016-11-01,03J,1069,636,1705,0.6269794721407624
14678,2016-11-01,03K,1050,515,1565,0.670926517571885
14679,2016-11-01,03L,939,1718,2657,0.3534060971019947
14680,2016-11-01,03M,814,445,1259,0.6465448768864178
14681,2016-11-01,03N,3214,1752,4966,0.6472009665726943
14682,2016-11-01,03Q,2013,1109,3122,0.6447789878283152
14683,2016-11-01,03R,2241,1529,3770,0.5944297082228117
14684,2016-11-01,03T,1851,952,2803,0.6603638958259008
14685,2016-11-01,03V,373,305,678,0.5501474926253688
14686,2016-11-01,03W,2276,1234,3510,0.6484330484330484
14687,2016-11-01,03X,251,466,717,0.3500697350069735
14688,2016-11-01,03Y,522,605,1127,0.4631765749778172
14689,2016-11-01,04C,2087,947,3034,0.6878707976268952
14690,2016-11-01,04D,1387,892,2279,0.6086002632733655
14691,2016-11-01,04E,582,1299,1881,0.3094098883572568
14692,2016-11-01,04F,1457,1111,2568,0.567367601246106
14693,2016-11-01,04G,3884,3104,6988,0.5558099599313108
14694,2016-11-01,04H,375,830,1205,0.3112033195020747
14695,2016-11-01,04J,1484,1666,3150,0.4711111111111111
14696,2016-11-01,04K,736,1923,2659,0.2767957878901843
14697,2016-11-01,04L,265,967,1232,0.2150974025974026
14698,2016-11-01,04M,184,533,717,0.25662482566248257
14699,2016-11-01,04N,229,831,1060,0.2160377358490566
14700,2016-11-01,04Q,779,482,1261,0.6177636796193497
14701,2016-11-01,04R,1943,2394,4337,0.44800553377911
14702,2016-11-01,04V,2534,1346,3880,0.6530927835051547
14703,2016-11-01,04X,1100,1610,2710,0.4059040590405904
14704,2016-11-01,04Y,878,446,1324,0.6631419939577039
14705,2016-11-01,05A,1792,2442,4234,0.4232404345772319
14706,2016-11-01,05C,1101,2167,3268,0.3369033047735618
14707,2016-11-01,05D,1103,504,1607,0.686372121966397
14708,2016-11-01,05F,1018,1110,2128,0.4783834586466165
14709,2016-11-01,05G,1374,1047,2421,0.5675340768277571
14710,2016-11-01,05H,887,984,1871,0.4740780331373597
14711,2016-11-01,05J,1342,806,2148,0.6247672253258846
14712,2016-11-01,05L,2285,2206,4491,0.5087953685148074
14713,2016-11-01,05N,2040,1272,3312,0.6159420289855072
14714,2016-11-01,05P,867,1208,2075,0.4178313253012048
14715,2016-11-01,05Q,1379,903,2282,0.6042944785276073
14716,2016-11-01,05R,1127,1816,2943,0.38294257560312606
14717,2016-11-01,05T,2009,1356,3365,0.5970282317979198
14718,2016-11-01,05V,1018,682,1700,0.5988235294117648
14719,2016-11-01,05W,1730,1042,2772,0.6240981240981242
14720,2016-11-01,05X,1004,734,1738,0.5776754890678941
14721,2016-11-01,05Y,1603,1176,2779,0.5768261964735516
14722,2016-11-01,06A,1298,1032,2330,0.5570815450643777
14723,2016-11-01,06D,913,592,1505,0.6066445182724253
14724,2016-11-01,06F,1631,2624,4255,0.3833137485311398
14725,2016-11-01,06H,5153,3382,8535,0.6037492677211482
14726,2016-11-01,06K,3005,3364,6369,0.4718166117129848
14727,2016-11-01,06L,2531,1199,3730,0.6785522788203754
14728,2016-11-01,06M,1857,1083,2940,0.6316326530612245
14729,2016-11-01,06N,2870,2907,5777,0.4967976458369396
14730,2016-11-01,06P,902,1013,1915,0.4710182767624021
14731,2016-11-01,06Q,2457,1338,3795,0.6474308300395257
14732,2016-11-01,06T,2149,1870,4019,0.5347101268972381
14733,2016-11-01,06V,1345,800,2145,0.627039627039627
14734,2016-11-01,06W,1397,882,2279,0.612988152698552
14735,2016-11-01,06Y,1315,837,2152,0.6110594795539034
14736,2016-11-01,07G,878,372,1250,0.7024
14737,2016-11-01,07H,1713,1229,2942,0.5822569680489463
14738,2016-11-01,07J,928,695,1623,0.5717806531115218
14739,2016-11-01,07K,1549,804,2353,0.6583085422864429
14740,2016-11-01,07L,723,392,1115,0.6484304932735426
14741,2016-11-01,07M,1128,1318,2446,0.46116107931316436
14742,2016-11-01,07N,1356,873,2229,0.6083445491251682
14743,2016-11-01,07P,771,877,1648,0.4678398058252427
14744,2016-11-01,07Q,1622,881,2503,0.6480223731522173
14745,2016-11-01,07R,576,914,1490,0.3865771812080537
14746,2016-11-01,07T,519,939,1458,0.3559670781893004
14747,2016-11-01,07V,1034,1792,2826,0.36588818117480537
14748,2016-11-01,07W,1168,1045,2213,0.5277903298689561
14749,2016-11-01,07X,1208,936,2144,0.5634328358208955
14750,2016-11-01,07Y,903,591,1494,0.6044176706827309
14751,2016-11-01,08A,1068,703,1771,0.6030491247882552
14752,2016-11-01,08C,609,634,1243,0.4899436846339501
14753,2016-11-01,08D,742,730,1472,0.5040760869565217
14754,2016-11-01,08E,835,862,1697,0.4920447849145551
14755,2016-11-01,08F,1451,857,2308,0.628682842287695
14756,2016-11-01,08G,433,1499,1932,0.22412008281573498
14757,2016-11-01,08H,468,1000,1468,0.3188010899182561
14758,2016-11-01,08J,789,647,1436,0.5494428969359332
14759,2016-11-01,08K,992,1120,2112,0.4696969696969697
14760,2016-11-01,08L,738,1230,1968,0.375
14761,2016-11-01,08M,1131,812,1943,0.582089552238806
14762,2016-11-01,08N,1159,673,1832,0.63264192139738
14763,2016-11-01,08P,917,729,1646,0.5571081409477521
14764,2016-11-01,08Q,720,798,1518,0.4743083003952569
14765,2016-11-01,08R,889,588,1477,0.6018957345971564
14766,2016-11-01,08T,981,798,1779,0.551433389544688
14767,2016-11-01,08V,1067,1052,2119,0.5035394053798962
14768,2016-11-01,08W,1027,698,1725,0.5953623188405797
14769,2016-11-01,08X,1256,1171,2427,0.5175113308611454
14770,2016-11-01,08Y,676,659,1335,0.5063670411985018
14771,2016-11-01,09A,541,830,1371,0.39460247994164843
14772,2016-11-01,09C,707,603,1310,0.5396946564885496
14773,2016-11-01,09D,1175,1328,2503,0.46943667598881345
14774,2016-11-01,09E,1404,919,2323,0.6043908738699957
14775,2016-11-01,09F,1183,790,1973,0.5995945261023822
14776,2016-11-01,09G,3657,2122,5779,0.6328084443675376
14777,2016-11-01,09H,550,398,948,0.580168776371308
14778,2016-11-01,09J,1560,1249,2809,0.5553577785688857
14779,2016-11-01,09L,848,689,1537,0.5517241379310345
14780,2016-11-01,09N,1031,831,1862,0.5537056928034372
14781,2016-11-01,09P,1050,1023,2073,0.5065123010130246
14782,2016-11-01,09W,1411,1056,2467,0.5719497365220916
14783,2016-11-01,09X,955,909,1864,0.5123390557939914
14784,2016-11-01,09Y,1326,1691,3017,0.43950944647000334
14785,2016-11-01,10A,1210,929,2139,0.565684899485741
14786,2016-11-01,10C,475,379,854,0.5562060889929742
14787,2016-11-01,10D,619,459,1078,0.5742115027829313
14788,2016-11-01,10E,865,486,1351,0.6402664692820134
14789,2016-11-01,10G,722,450,1172,0.6160409556313993
14790,2016-11-01,10H,1653,1843,3496,0.47282608695652173
14791,2016-11-01,10J,1016,1015,2031,0.5002461841457411
14792,2016-11-01,10K,1274,716,1990,0.6402010050251257
14793,2016-11-01,10L,1044,590,1634,0.6389228886168911
14794,2016-11-01,10M,423,537,960,0.440625
14795,2016-11-01,10N,402,506,908,0.44273127753303965
14796,2016-11-01,10Q,3499,3184,6683,0.5235672602124795
14797,2016-11-01,10R,1436,784,2220,0.6468468468468469
14798,2016-11-01,10T,588,388,976,0.6024590163934426
14799,2016-11-01,10V,1406,708,2114,0.6650898770104068
14800,2016-11-01,10W,464,517,981,0.47298674821610603
14801,2016-11-01,10X,1239,855,2094,0.5916905444126075
14802,2016-11-01,10Y,1211,1202,2413,0.5018648984666391
14803,2016-11-01,11A,3177,2047,5224,0.6081546707503829
14804,2016-11-01,11C,930,468,1398,0.6652360515021459
14805,2016-11-01,11D,632,660,1292,0.4891640866873065
14806,2016-11-01,11E,956,1010,1966,0.4862665310274669
14807,2016-11-01,11H,2531,1808,4339,0.5833141276791888
14808,2016-11-01,11J,5327,2888,8215,0.6484479610468655
14809,2016-11-01,11M,4095,2238,6333,0.6466129796305069
14810,2016-11-01,11N,2773,3127,5900,0.47
14811,2016-11-01,11T,1428,958,2386,0.5984911986588433
14812,2016-11-01,11X,3104,1990,5094,0.6093443266588143
14813,2016-11-01,12A,1489,862,2351,0.6333475116971502
14814,2016-11-01,12D,1124,1035,2159,0.5206113941639648
14815,2016-11-01,12F,1971,1394,3365,0.5857355126300149
14816,2016-11-01,13P,2048,3643,5691,0.3598664558074152
14817,2016-11-01,13T,3041,1741,4782,0.6359263906315349
14818,2016-11-01,14L,2632,2374,5006,0.525769077107471
14819,2016-11-01,99A,2118,2385,4503,0.4703530979347102
14820,2016-11-01,99C,1390,860,2250,0.6177777777777778
14821,2016-11-01,99D,1044,911,1955,0.5340153452685422
14822,2016-11-01,99E,1698,724,2422,0.7010734929810074
14823,2016-11-01,99F,1253,465,1718,0.729336437718277
14824,2016-11-01,99G,1132,448,1580,0.7164556962025317
14825,2016-11-01,99H,1452,1343,2795,0.5194991055456172
14826,2016-11-01,99J,3016,2105,5121,0.5889474711970318
14827,2016-11-01,99K,928,891,1819,0.5101704233095107
14828,2016-11-01,99M,1003,999,2002,0.500999000999001
14829,2016-11-01,99N,2886,2680,5566,0.518505210204815
14830,2016-11-01,99P,6236,3338,9574,0.6513473992061835
14831,2016-11-01,99Q,1862,1138,3000,0.6206666666666667
14832,2016-12-01,00C,755,355,1110,0.6801801801801802
14833,2016-12-01,00D,1970,1201,3171,0.6212551245663829
14834,2016-12-01,00J,1607,886,2493,0.6446048937023666
14835,2016-12-01,00K,2064,1053,3117,0.6621751684311838
14836,2016-12-01,00L,2184,1390,3574,0.6110800223838836
14837,2016-12-01,00M,2181,1214,3395,0.6424153166421208
14838,2016-12-01,00N,1169,611,1780,0.6567415730337078
14839,2016-12-01,00P,1801,932,2733,0.6589828027808269
14840,2016-12-01,00Q,923,558,1481,0.6232275489534098
14841,2016-12-01,00R,1016,809,1825,0.5567123287671233
14842,2016-12-01,00T,1771,1194,2965,0.5973018549747049
14843,2016-12-01,00V,1004,1018,2022,0.49653808110781406
14844,2016-12-01,00X,1010,496,1506,0.6706507304116865
14845,2016-12-01,00Y,1438,1287,2725,0.5277064220183486
14846,2016-12-01,01A,2003,1586,3589,0.5580941766508777
14847,2016-12-01,01C,874,830,1704,0.5129107981220657
14848,2016-12-01,01D,1168,970,2138,0.5463049579045838
14849,2016-12-01,01E,1020,453,1473,0.6924643584521385
14850,2016-12-01,01F,757,659,1416,0.5346045197740112
14851,2016-12-01,01G,1196,1360,2556,0.4679186228482003
14852,2016-12-01,01H,2264,1215,3479,0.6507617131359587
14853,2016-12-01,01J,805,866,1671,0.4817474566128067
14854,2016-12-01,01K,1632,1758,3390,0.4814159292035398
14855,2016-12-01,01R,811,809,1620,0.5006172839506173
14856,2016-12-01,01T,589,836,1425,0.41333333333333333
14857,2016-12-01,01V,657,694,1351,0.4863064396743153
14858,2016-12-01,01W,1792,1221,3013,0.5947560570859608
14859,2016-12-01,01X,1381,1064,2445,0.5648261758691207
14860,2016-12-01,01Y,742,1331,2073,0.3579353593825374
14861,2016-12-01,02A,952,1073,2025,0.47012345679012346
14862,2016-12-01,02D,440,471,911,0.4829857299670692
14863,2016-12-01,02E,944,882,1826,0.5169769989047097
14864,2016-12-01,02F,1092,1359,2451,0.4455324357405141
14865,2016-12-01,02G,580,536,1116,0.5197132616487455
14866,2016-12-01,02H,1572,1714,3286,0.47839318320146074
14867,2016-12-01,02M,925,569,1494,0.6191432396251674
14868,2016-12-01,02N,1019,702,1721,0.5920976176641487
14869,2016-12-01,02P,893,1596,2489,0.35877862595419846
14870,2016-12-01,02Q,551,544,1095,0.5031963470319635
14871,2016-12-01,02R,1949,1146,3095,0.6297253634894991
14872,2016-12-01,02T,1199,969,2168,0.5530442804428044
14873,2016-12-01,02V,688,1256,1944,0.35390946502057613
14874,2016-12-01,02W,480,400,880,0.5454545454545454
14875,2016-12-01,02X,1637,1187,2824,0.5796742209631728
14876,2016-12-01,02Y,1989,1022,3011,0.6605778811026237
14877,2016-12-01,03A,1318,914,2232,0.5905017921146953
14878,2016-12-01,03C,934,1940,2874,0.32498260264439804
14879,2016-12-01,03D,813,537,1350,0.6022222222222222
14880,2016-12-01,03E,837,611,1448,0.5780386740331491
14881,2016-12-01,03F,1716,708,2424,0.7079207920792079
14882,2016-12-01,03G,900,1579,2479,0.36304961678096004
14883,2016-12-01,03H,1235,550,1785,0.6918767507002801
14884,2016-12-01,03J,1075,668,1743,0.6167527251864601
14885,2016-12-01,03K,1032,446,1478,0.6982408660351827
14886,2016-12-01,03L,924,1639,2563,0.3605150214592275
14887,2016-12-01,03M,856,455,1311,0.6529366895499619
14888,2016-12-01,03N,3119,1854,4973,0.6271868087673437
14889,2016-12-01,03Q,1863,1099,2962,0.6289669142471304
14890,2016-12-01,03R,2358,1521,3879,0.6078886310904872
14891,2016-12-01,03T,1911,878,2789,0.6851918250268914
14892,2016-12-01,03V,409,353,762,0.536745406824147
14893,2016-12-01,03W,2240,1296,3536,0.6334841628959276
14894,2016-12-01,03X,273,419,692,0.3945086705202312
14895,2016-12-01,03Y,524,617,1141,0.45924627519719546
14896,2016-12-01,04C,1933,924,2857,0.6765838291914595
14897,2016-12-01,04D,1402,871,2273,0.6168059832820062
14898,2016-12-01,04E,538,1353,1891,0.28450555261766264
14899,2016-12-01,04F,1466,1090,2556,0.5735524256651017
14900,2016-12-01,04G,3898,3191,7089,0.5498659895612922
14901,2016-12-01,04H,418,914,1332,0.3138138138138138
14902,2016-12-01,04J,1425,1804,3229,0.44131310003096935
14903,2016-12-01,04K,592,1805,2397,0.24697538589904047
14904,2016-12-01,04L,280,993,1273,0.2199528672427337
14905,2016-12-01,04M,159,541,700,0.22714285714285715
14906,2016-12-01,04N,206,784,990,0.2080808080808081
14907,2016-12-01,04Q,780,472,1252,0.6230031948881789
14908,2016-12-01,04R,1787,2263,4050,0.44123456790123455
14909,2016-12-01,04V,2297,1367,3664,0.6269104803493449
14910,2016-12-01,04X,1049,1455,2504,0.4189297124600639
14911,2016-12-01,04Y,746,584,1330,0.5609022556390978
14912,2016-12-01,05A,1719,2368,4087,0.4206019084903352
14913,2016-12-01,05C,1124,2163,3287,0.3419531487678734
14914,2016-12-01,05D,991,514,1505,0.6584717607973422
14915,2016-12-01,05F,901,1197,2098,0.4294566253574833
14916,2016-12-01,05G,1346,1031,2377,0.5662599915860328
14917,2016-12-01,05H,847,1018,1865,0.45415549597855226
14918,2016-12-01,05J,1201,781,1982,0.6059535822401615
14919,2016-12-01,05L,2091,2158,4249,0.4921157919510473
14920,2016-12-01,05N,1974,1280,3254,0.6066379840196681
14921,2016-12-01,05P,811,1214,2025,0.4004938271604938
14922,2016-12-01,05Q,1438,858,2296,0.6263066202090593
14923,2016-12-01,05R,1172,1881,3053,0.3838847035702588
14924,2016-12-01,05T,1939,1397,3336,0.5812350119904077
14925,2016-12-01,05V,945,736,1681,0.5621653777513385
14926,2016-12-01,05W,1530,1197,2727,0.5610561056105611
14927,2016-12-01,05X,889,761,1650,0.5387878787878788
14928,2016-12-01,05Y,1647,1212,2859,0.5760755508919203
14929,2016-12-01,06A,1208,1139,2347,0.5146996165317427
14930,2016-12-01,06D,824,537,1361,0.6054371785451874
14931,2016-12-01,06F,1589,2719,4308,0.36884865366759517
14932,2016-12-01,06H,5108,3416,8524,0.5992491787893008
14933,2016-12-01,06K,3017,3304,6321,0.47729789590254706
14934,2016-12-01,06L,2417,1226,3643,0.6634641778753775
14935,2016-12-01,06M,1768,1090,2858,0.6186144156752974
14936,2016-12-01,06N,2866,2986,5852,0.48974709501025293
14937,2016-12-01,06P,800,934,1734,0.461361014994233
14938,2016-12-01,06Q,2435,1413,3848,0.6327962577962578
14939,2016-12-01,06T,2019,1833,3852,0.5241433021806854
14940,2016-12-01,06V,1317,880,2197,0.5994538006372326
14941,2016-12-01,06W,1376,922,2298,0.598781549173194
14942,2016-12-01,06Y,1282,784,2066,0.6205227492739593
14943,2016-12-01,07G,849,339,1188,0.7146464646464646
14944,2016-12-01,07H,1695,1344,3039,0.5577492596248766
14945,2016-12-01,07J,868,720,1588,0.5465994962216625
14946,2016-12-01,07K,1425,808,2233,0.638154948499776
14947,2016-12-01,07L,722,435,1157,0.6240276577355229
14948,2016-12-01,07M,1173,1379,2552,0.4596394984326019
14949,2016-12-01,07N,1380,896,2276,0.6063268892794376
14950,2016-12-01,07P,799,854,1653,0.48336358136721114
14951,2016-12-01,07Q,1610,1017,2627,0.6128663875142748
14952,2016-12-01,07R,519,759,1278,0.4061032863849765
14953,2016-12-01,07T,488,857,1345,0.36282527881040894
14954,2016-12-01,07V,1001,1810,2811,0.3561010316613305
14955,2016-12-01,07W,1159,1003,2162,0.5360777058279371
14956,2016-12-01,07X,1080,919,1999,0.5402701350675337
14957,2016-12-01,07Y,944,624,1568,0.6020408163265306
14958,2016-12-01,08A,884,743,1627,0.5433312845728334
14959,2016-12-01,08C,598,646,1244,0.4807073954983923
14960,2016-12-01,08D,658,717,1375,0.47854545454545455
14961,2016-12-01,08E,780,848,1628,0.47911547911547914
14962,2016-12-01,08F,1311,825,2136,0.6137640449438202
14963,2016-12-01,08G,510,1427,1937,0.2632937532266391
14964,2016-12-01,08H,456,927,1383,0.3297180043383948
14965,2016-12-01,08J,749,664,1413,0.5300778485491862
14966,2016-12-01,08K,803,942,1745,0.46017191977077365
14967,2016-12-01,08L,714,1216,1930,0.3699481865284974
14968,2016-12-01,08M,1089,679,1768,0.6159502262443439
14969,2016-12-01,08N,1136,644,1780,0.6382022471910113
14970,2016-12-01,08P,882,683,1565,0.5635782747603834
14971,2016-12-01,08Q,664,805,1469,0.45200816882232814
14972,2016-12-01,08R,858,567,1425,0.6021052631578947
14973,2016-12-01,08T,1000,868,1868,0.5353319057815846
14974,2016-12-01,08V,966,959,1925,0.5018181818181818
14975,2016-12-01,08W,967,646,1613,0.5995040297582145
14976,2016-12-01,08X,1216,1156,2372,0.5126475548060708
14977,2016-12-01,08Y,603,616,1219,0.4946677604593929
14978,2016-12-01,09A,481,721,1202,0.4001663893510815
14979,2016-12-01,09C,694,567,1261,0.5503568596352102
14980,2016-12-01,09D,1084,1274,2358,0.45971162001696353
14981,2016-12-01,09E,1395,924,2319,0.6015523932729625
14982,2016-12-01,09F,1108,823,1931,0.5737959606421543
14983,2016-12-01,09G,3558,2014,5572,0.6385498923187365
14984,2016-12-01,09H,508,423,931,0.5456498388829216
14985,2016-12-01,09J,1519,1273,2792,0.544054441260745
14986,2016-12-01,09L,784,685,1469,0.5336963921034718
14987,2016-12-01,09N,966,907,1873,0.5157501334757074
14988,2016-12-01,09P,873,1059,1932,0.4518633540372671
14989,2016-12-01,09W,1219,945,2164,0.5633086876155268
14990,2016-12-01,09X,952,988,1940,0.49072164948453606
14991,2016-12-01,09Y,1307,1771,3078,0.42462638076673165
14992,2016-12-01,10A,1259,929,2188,0.5754113345521024
14993,2016-12-01,10C,419,446,865,0.484393063583815
14994,2016-12-01,10D,608,442,1050,0.579047619047619
14995,2016-12-01,10E,861,456,1317,0.6537585421412301
14996,2016-12-01,10G,713,444,1157,0.6162489196197062
14997,2016-12-01,10H,1636,1805,3441,0.47544318512060446
14998,2016-12-01,10J,869,1032,1901,0.457127827459232
14999,2016-12-01,10K,1290,774,2064,0.625
15000,2016-12-01,10L,1016,596,1612,0.630272952853598
15001,2016-12-01,10M,450,507,957,0.4702194357366771
15002,2016-12-01,10N,410,540,950,0.43157894736842106
15003,2016-12-01,10Q,3367,3211,6578,0.5118577075098815
15004,2016-12-01,10R,1368,735,2103,0.6504992867332382
15005,2016-12-01,10T,633,408,1041,0.6080691642651297
15006,2016-12-01,10V,1306,692,1998,0.6536536536536537
15007,2016-12-01,10W,440,475,915,0.4808743169398907
15008,2016-12-01,10X,1229,902,2131,0.5767245424683247
15009,2016-12-01,10Y,1205,1172,2377,0.5069415229280606
15010,2016-12-01,11A,3030,2028,5058,0.5990510083036773
15011,2016-12-01,11C,875,494,1369,0.6391526661796932
15012,2016-12-01,11D,630,741,1371,0.45951859956236324
15013,2016-12-01,11E,1005,1107,2112,0.4758522727272727
15014,2016-12-01,11H,2495,1731,4226,0.5903928064363464
15015,2016-12-01,11J,5149,2874,8023,0.6417798828368441
15016,2016-12-01,11M,3863,2355,6218,0.6212608555805725
15017,2016-12-01,11N,2818,3354,6172,0.45657809462086846
15018,2016-12-01,11T,1432,1020,2452,0.5840130505709625
15019,2016-12-01,11X,3051,2043,5094,0.598939929328622
15020,2016-12-01,12A,1519,911,2430,0.6251028806584362
15021,2016-12-01,12D,1094,977,2071,0.5282472235634958
15022,2016-12-01,12F,1985,1590,3575,0.5552447552447553
15023,2016-12-01,13P,2041,3473,5514,0.3701487123685165
15024,2016-12-01,13T,3065,1751,4816,0.6364202657807309
15025,2016-12-01,14L,2598,2379,4977,0.5220012055455093
15026,2016-12-01,99A,2040,2233,4273,0.47741633512754506
15027,2016-12-01,99C,1484,898,2382,0.6230058774139379
15028,2016-12-01,99D,1063,897,1960,0.5423469387755102
15029,2016-12-01,99E,1662,792,2454,0.6772616136919315
15030,2016-12-01,99F,1178,463,1641,0.7178549664838513
15031,2016-12-01,99G,1076,430,1506,0.7144754316069057
15032,2016-12-01,99H,1434,1314,2748,0.5218340611353712
15033,2016-12-01,99J,3010,2193,5203,0.5785123966942148
15034,2016-12-01,99K,909,885,1794,0.5066889632107023
15035,2016-12-01,99M,1028,985,2013,0.5106805762543467
15036,2016-12-01,99N,2823,2670,5493,0.5139268159475696
15037,2016-12-01,99P,5931,3504,9435,0.628616852146264
15038,2016-12-01,99Q,1909,1088,2997,0.6369703036369703
15039,2017-01-01,00C,807,367,1174,0.6873935264054515
15040,2017-01-01,00D,2036,1174,3210,0.6342679127725857
15041,2017-01-01,00J,1630,894,2524,0.6458003169572107
15042,2017-01-01,00K,2082,1086,3168,0.6571969696969697
15043,2017-01-01,00L,1997,1487,3484,0.5731917336394948
15044,2017-01-01,00M,2282,1198,3480,0.6557471264367816
15045,2017-01-01,00N,1240,601,1841,0.6735469853340575
15046,2017-01-01,00P,1784,995,2779,0.6419575386829794
15047,2017-01-01,00Q,951,560,1511,0.6293845135671741
15048,2017-01-01,00R,1115,819,1934,0.5765253360910031
15049,2017-01-01,00T,1823,1194,3017,0.6042426251242956
15050,2017-01-01,00V,1068,993,2061,0.5181950509461426
15051,2017-01-01,00X,1081,498,1579,0.6846105129829005
15052,2017-01-01,00Y,1447,1265,2712,0.5335545722713865
15053,2017-01-01,01A,2043,1556,3599,0.567657682689636
15054,2017-01-01,01C,751,839,1590,0.47232704402515724
15055,2017-01-01,01D,1216,1060,2276,0.5342706502636204
15056,2017-01-01,01E,1000,419,1419,0.704721634954193
15057,2017-01-01,01F,764,700,1464,0.5218579234972678
15058,2017-01-01,01G,1186,1449,2635,0.45009487666034154
15059,2017-01-01,01H,2270,1222,3492,0.650057273768614
15060,2017-01-01,01J,840,886,1726,0.48667439165701043
15061,2017-01-01,01K,1695,1744,3439,0.4928758359988369
15062,2017-01-01,01R,768,837,1605,0.4785046728971963
15063,2017-01-01,01T,559,728,1287,0.43434343434343436
15064,2017-01-01,01V,576,639,1215,0.4740740740740741
15065,2017-01-01,01W,1720,1257,2977,0.5777628485052065
15066,2017-01-01,01X,1409,1080,2489,0.5660907995178787
15067,2017-01-01,01Y,751,1309,2060,0.36456310679611653
15068,2017-01-01,02A,962,1096,2058,0.467444120505345
15069,2017-01-01,02D,456,476,932,0.4892703862660944
15070,2017-01-01,02E,956,850,1806,0.5293466223698782
15071,2017-01-01,02F,1048,1342,2390,0.4384937238493724
15072,2017-01-01,02G,567,623,1190,0.4764705882352941
15073,2017-01-01,02H,1582,1614,3196,0.49499374217772213
15074,2017-01-01,02M,1016,659,1675,0.6065671641791045
15075,2017-01-01,02N,911,711,1622,0.561652281134402
15076,2017-01-01,02P,917,1687,2604,0.3521505376344086
15077,2017-01-01,02Q,568,589,1157,0.4909248055315471
15078,2017-01-01,02R,1980,1261,3241,0.6109225547670472
15079,2017-01-01,02T,1133,947,2080,0.5447115384615384
15080,2017-01-01,02V,625,1240,1865,0.3351206434316354
15081,2017-01-01,02W,562,432,994,0.5653923541247485
15082,2017-01-01,02X,1672,1340,3012,0.5551128818061088
15083,2017-01-01,02Y,2076,933,3009,0.6899302093718843
15084,2017-01-01,03A,1304,917,2221,0.5871229176046826
15085,2017-01-01,03C,950,1935,2885,0.3292894280762565
15086,2017-01-01,03D,754,488,1242,0.607085346215781
15087,2017-01-01,03E,846,527,1373,0.6161689730517116
15088,2017-01-01,03F,1714,688,2402,0.7135720233139051
15089,2017-01-01,03G,825,1550,2375,0.3473684210526316
15090,2017-01-01,03H,1246,543,1789,0.6964784795975405
15091,2017-01-01,03J,1040,646,1686,0.6168446026097272
15092,2017-01-01,03K,999,520,1519,0.6576695194206715
15093,2017-01-01,03L,870,1690,2560,0.33984375
15094,2017-01-01,03M,864,446,1310,0.6595419847328244
15095,2017-01-01,03N,3163,1820,4983,0.6347581778045355
15096,2017-01-01,03Q,1969,1050,3019,0.6522027161311693
15097,2017-01-01,03R,2295,1446,3741,0.6134723336006416
15098,2017-01-01,03T,1808,860,2668,0.6776611694152923
15099,2017-01-01,03V,424,329,753,0.5630810092961488
15100,2017-01-01,03W,2265,1175,3440,0.6584302325581395
15101,2017-01-01,03X,255,455,710,0.3591549295774648
15102,2017-01-01,03Y,465,673,1138,0.4086115992970123
15103,2017-01-01,04C,1980,1016,2996,0.6608811748998665
15104,2017-01-01,04D,1365,762,2127,0.6417489421720733
15105,2017-01-01,04E,542,1337,1879,0.28845130388504525
15106,2017-01-01,04F,1496,1134,2630,0.5688212927756654
15107,2017-01-01,04G,3678,3380,7058,0.5211107962595636
15108,2017-01-01,04H,380,855,1235,0.3076923076923077
15109,2017-01-01,04J,1330,1810,3140,0.42356687898089174
15110,2017-01-01,04K,587,1875,2462,0.23842404549147034
15111,2017-01-01,04L,248,977,1225,0.20244897959183675
15112,2017-01-01,04M,170,534,704,0.24147727272727273
15113,2017-01-01,04N,236,793,1029,0.2293488824101069
15114,2017-01-01,04Q,744,485,1229,0.6053702196908055
15115,2017-01-01,04R,1877,2421,4298,0.4367147510469986
15116,2017-01-01,04V,2363,1307,3670,0.6438692098092643
15117,2017-01-01,04X,1138,1608,2746,0.4144209759650401
15118,2017-01-01,04Y,730,651,1381,0.5286024619840695
15119,2017-01-01,05A,1772,2421,4193,0.4226091104221321
15120,2017-01-01,05C,1058,2243,3301,0.3205089366858528
15121,2017-01-01,05D,1006,518,1524,0.6601049868766404
15122,2017-01-01,05F,771,1147,1918,0.40198123044838374
15123,2017-01-01,05G,1471,1029,2500,0.5884
15124,2017-01-01,05H,858,1058,1916,0.44780793319415446
15125,2017-01-01,05J,1345,786,2131,0.6311590802440169
15126,2017-01-01,05L,2221,2259,4480,0.49575892857142856
15127,2017-01-01,05N,1967,1278,3245,0.6061633281972265
15128,2017-01-01,05P,750,1325,2075,0.3614457831325301
15129,2017-01-01,05Q,1426,883,2309,0.6175833694239931
15130,2017-01-01,05R,1073,1713,2786,0.3851399856424982
15131,2017-01-01,05T,1879,1359,3238,0.5802964793082149
15132,2017-01-01,05V,957,722,1679,0.5699821322215605
15133,2017-01-01,05W,1577,1231,2808,0.5616096866096866
15134,2017-01-01,05X,913,724,1637,0.5577275503970678
15135,2017-01-01,05Y,1685,1195,2880,0.5850694444444444
15136,2017-01-01,06A,1244,1123,2367,0.5255597803126321
15137,2017-01-01,06D,855,513,1368,0.625
15138,2017-01-01,06F,1491,2717,4208,0.35432509505703425
15139,2017-01-01,06H,5064,3343,8407,0.6023551802069704
15140,2017-01-01,06K,3024,3098,6122,0.4939562234563868
15141,2017-01-01,06L,2532,1214,3746,0.6759209823812066
15142,2017-01-01,06M,1691,1098,2789,0.6063105055575475
15143,2017-01-01,06N,2893,2916,5809,0.4980203133069375
15144,2017-01-01,06P,797,1014,1811,0.44008834897846494
15145,2017-01-01,06Q,2322,1291,3613,0.6426792139496263
15146,2017-01-01,06T,1987,1808,3795,0.5235836627140975
15147,2017-01-01,06V,1335,915,2250,0.5933333333333334
15148,2017-01-01,06W,1325,839,2164,0.6122920517560074
15149,2017-01-01,06Y,1197,761,1958,0.6113381001021451
15150,2017-01-01,07G,943,370,1313,0.7182025894897182
15151,2017-01-01,07H,1740,1295,3035,0.5733113673805601
15152,2017-01-01,07J,966,700,1666,0.5798319327731093
15153,2017-01-01,07K,1476,779,2255,0.6545454545454545
15154,2017-01-01,07L,689,413,1102,0.6252268602540835
15155,2017-01-01,07M,1128,1382,2510,0.44940239043824703
15156,2017-01-01,07N,1396,830,2226,0.6271338724168913
15157,2017-01-01,07P,734,794,1528,0.4803664921465969
15158,2017-01-01,07Q,1629,897,2526,0.6448931116389549
15159,2017-01-01,07R,554,859,1413,0.3920736022646851
15160,2017-01-01,07T,559,948,1507,0.37093563370935634
15161,2017-01-01,07V,1072,1760,2832,0.3785310734463277
15162,2017-01-01,07W,1112,991,2103,0.5287684260580123
15163,2017-01-01,07X,1112,907,2019,0.5507677067855374
15164,2017-01-01,07Y,931,655,1586,0.5870113493064313
15165,2017-01-01,08A,976,699,1675,0.5826865671641791
15166,2017-01-01,08C,573,561,1134,0.5052910052910053
15167,2017-01-01,08D,697,762,1459,0.47772446881425634
15168,2017-01-01,08E,768,864,1632,0.47058823529411764
15169,2017-01-01,08F,1415,816,2231,0.6342447333034513
15170,2017-01-01,08G,447,1414,1861,0.24019344438473939
15171,2017-01-01,08H,435,1020,1455,0.29896907216494845
15172,2017-01-01,08J,798,641,1439,0.5545517720639332
15173,2017-01-01,08K,823,1104,1927,0.4270887389724961
15174,2017-01-01,08L,703,1136,1839,0.38227297444263186
15175,2017-01-01,08M,1148,769,1917,0.5988523735002608
15176,2017-01-01,08N,1196,642,1838,0.6507072905331882
15177,2017-01-01,08P,930,703,1633,0.5695039804041642
15178,2017-01-01,08Q,661,821,1482,0.44601889338731443
15179,2017-01-01,08R,871,529,1400,0.6221428571428571
15180,2017-01-01,08T,1008,762,1770,0.5694915254237288
15181,2017-01-01,08V,1097,932,2029,0.5406604238541153
15182,2017-01-01,08W,993,721,1714,0.5793465577596266
15183,2017-01-01,08X,1153,1112,2265,0.5090507726269315
15184,2017-01-01,08Y,636,669,1305,0.48735632183908045
15185,2017-01-01,09A,506,817,1323,0.382464096749811
15186,2017-01-01,09C,722,633,1355,0.5328413284132841
15187,2017-01-01,09D,1063,1326,2389,0.4449560485558811
15188,2017-01-01,09E,1416,945,2361,0.5997458703939009
15189,2017-01-01,09F,1247,865,2112,0.5904356060606061
15190,2017-01-01,09G,3466,1981,5447,0.6363135671011566
15191,2017-01-01,09H,553,384,937,0.5901814300960512
15192,2017-01-01,09J,1559,1222,2781,0.5605897159295218
15193,2017-01-01,09L,772,681,1453,0.5313145216792843
15194,2017-01-01,09N,986,883,1869,0.5275548421615838
15195,2017-01-01,09P,897,1029,1926,0.4657320872274143
15196,2017-01-01,09W,1347,972,2319,0.5808538163001293
15197,2017-01-01,09X,917,885,1802,0.5088790233074362
15198,2017-01-01,09Y,1233,1758,2991,0.41223671013039115
15199,2017-01-01,10A,1195,828,2023,0.5907068709836876
15200,2017-01-01,10C,456,454,910,0.5010989010989011
15201,2017-01-01,10D,573,525,1098,0.5218579234972678
15202,2017-01-01,10E,791,455,1246,0.6348314606741573
15203,2017-01-01,10G,658,533,1191,0.5524769101595298
15204,2017-01-01,10H,1641,1788,3429,0.4785651793525809
15205,2017-01-01,10J,891,1130,2021,0.4408708560118753
15206,2017-01-01,10K,1230,703,1933,0.636316606311433
15207,2017-01-01,10L,1049,656,1705,0.6152492668621701
15208,2017-01-01,10M,442,551,993,0.44511581067472306
15209,2017-01-01,10N,389,492,881,0.44154370034052215
15210,2017-01-01,10Q,3342,3077,6419,0.5206418445240691
15211,2017-01-01,10R,1383,703,2086,0.6629913710450623
15212,2017-01-01,10T,656,436,1092,0.6007326007326007
15213,2017-01-01,10V,1227,699,1926,0.6370716510903427
15214,2017-01-01,10W,479,532,1011,0.47378832838773494
15215,2017-01-01,10X,1215,908,2123,0.5723033443240697
15216,2017-01-01,10Y,1141,1119,2260,0.5048672566371681
15217,2017-01-01,11A,3020,2092,5112,0.5907668231611893
15218,2017-01-01,11C,907,472,1379,0.6577229876722263
15219,2017-01-01,11D,585,617,1202,0.48668885191347755
15220,2017-01-01,11E,882,1082,1964,0.44908350305498984
15221,2017-01-01,11H,2465,1823,4288,0.5748600746268657
15222,2017-01-01,11J,4704,3172,7876,0.5972574911122397
15223,2017-01-01,11M,3913,2228,6141,0.6371926396352385
15224,2017-01-01,11N,2609,3338,5947,0.4387085925676812
15225,2017-01-01,11T,1404,965,2369,0.5926551287463064
15226,2017-01-01,11X,3043,2024,5067,0.6005525952239984
15227,2017-01-01,12A,1536,907,2443,0.628735161686451
15228,2017-01-01,12D,1121,996,2117,0.5295229097779878
15229,2017-01-01,12F,1949,1627,3576,0.5450223713646533
15230,2017-01-01,13P,2074,3765,5839,0.3551978078438089
15231,2017-01-01,13T,3095,1761,4856,0.6373558484349259
15232,2017-01-01,14L,2697,2291,4988,0.5406976744186046
15233,2017-01-01,99A,1944,2267,4211,0.46164806459273333
15234,2017-01-01,99C,1423,888,2311,0.6157507572479446
15235,2017-01-01,99D,1111,888,1999,0.5557778889444722
15236,2017-01-01,99E,1650,760,2410,0.6846473029045643
15237,2017-01-01,99F,1158,446,1604,0.7219451371571073
15238,2017-01-01,99G,1025,420,1445,0.7093425605536332
15239,2017-01-01,99H,1428,1341,2769,0.5157096424702059
15240,2017-01-01,99J,2859,1996,4855,0.5888774459320288
15241,2017-01-01,99K,835,887,1722,0.4849012775842044
15242,2017-01-01,99M,1021,1024,2045,0.49926650366748165
15243,2017-01-01,99N,2818,2684,5502,0.5121773900399854
15244,2017-01-01,99P,5772,3305,9077,0.6358929161617275
15245,2017-01-01,99Q,1818,1067,2885,0.630155979202773
15246,2017-02-01,00C,724,319,1043,0.6941514860977949
15247,2017-02-01,00D,1777,1189,2966,0.5991233985165205
15248,2017-02-01,00J,1483,810,2293,0.6467509812472743
15249,2017-02-01,00K,1871,910,2781,0.672779575692197
15250,2017-02-01,00L,1828,1447,3275,0.5581679389312977
15251,2017-02-01,00M,1922,1082,3004,0.6398135818908123
15252,2017-02-01,00N,1128,553,1681,0.6710291493158834
15253,2017-02-01,00P,1628,929,2557,0.6366836136096988
15254,2017-02-01,00Q,874,503,1377,0.6347131445170661
15255,2017-02-01,00R,1011,792,1803,0.5607321131447587
15256,2017-02-01,00T,1632,1125,2757,0.5919477693144722
15257,2017-02-01,00V,918,947,1865,0.49222520107238604
15258,2017-02-01,00X,964,433,1397,0.690050107372942
15259,2017-02-01,00Y,1218,1276,2494,0.4883720930232558
15260,2017-02-01,01A,1738,1408,3146,0.5524475524475524
15261,2017-02-01,01C,664,801,1465,0.45324232081911264
15262,2017-02-01,01D,1147,880,2027,0.5658608781450419
15263,2017-02-01,01E,954,411,1365,0.6989010989010989
15264,2017-02-01,01F,686,563,1249,0.5492393915132106
15265,2017-02-01,01G,992,1365,2357,0.4208739923631735
15266,2017-02-01,01H,1865,1144,3009,0.619807244931871
15267,2017-02-01,01J,789,883,1672,0.47188995215311
15268,2017-02-01,01K,1512,1606,3118,0.48492623476587554
15269,2017-02-01,01R,600,743,1343,0.4467609828741623
15270,2017-02-01,01T,532,653,1185,0.4489451476793249
15271,2017-02-01,01V,528,616,1144,0.46153846153846156
15272,2017-02-01,01W,1522,1095,2617,0.5815819640810088
15273,2017-02-01,01X,1196,985,2181,0.5483723062815222
15274,2017-02-01,01Y,690,1224,1914,0.3605015673981191
15275,2017-02-01,02A,853,1022,1875,0.45493333333333336
15276,2017-02-01,02D,377,445,822,0.4586374695863747
15277,2017-02-01,02E,879,858,1737,0.5060449050086355
15278,2017-02-01,02F,1020,1268,2288,0.4458041958041958
15279,2017-02-01,02G,522,544,1066,0.4896810506566604
15280,2017-02-01,02H,1443,1562,3005,0.4801996672212978
15281,2017-02-01,02M,857,658,1515,0.5656765676567657
15282,2017-02-01,02N,859,660,1519,0.56550362080316
15283,2017-02-01,02P,846,1517,2363,0.35801946677951757
15284,2017-02-01,02Q,588,533,1121,0.5245316681534344
15285,2017-02-01,02R,1811,1149,2960,0.6118243243243243
15286,2017-02-01,02T,1030,849,1879,0.5481639169771155
15287,2017-02-01,02V,556,1074,1630,0.3411042944785276
15288,2017-02-01,02W,499,344,843,0.5919335705812574
15289,2017-02-01,02X,1282,1414,2696,0.4755192878338279
15290,2017-02-01,02Y,1798,956,2754,0.6528685548293391
15291,2017-02-01,03A,1220,841,2061,0.5919456574478409
15292,2017-02-01,03C,818,1884,2702,0.3027387120651369
15293,2017-02-01,03D,676,570,1246,0.5425361155698234
15294,2017-02-01,03E,772,501,1273,0.6064414768263944
15295,2017-02-01,03F,1568,645,2213,0.7085404428377767
15296,2017-02-01,03G,781,1465,2246,0.3477292965271594
15297,2017-02-01,03H,1140,484,1624,0.7019704433497537
15298,2017-02-01,03J,1008,613,1621,0.621838371375694
15299,2017-02-01,03K,898,423,1321,0.6797880393641181
15300,2017-02-01,03L,812,1603,2415,0.336231884057971
15301,2017-02-01,03M,788,402,1190,0.6621848739495798
15302,2017-02-01,03N,2841,1695,4536,0.6263227513227513
15303,2017-02-01,03Q,1714,973,2687,0.6378861183475996
15304,2017-02-01,03R,2010,1475,3485,0.5767575322812052
15305,2017-02-01,03T,1642,812,2454,0.6691116544417278
15306,2017-02-01,03V,364,332,696,0.5229885057471264
15307,2017-02-01,03W,2039,1093,3132,0.651021711366539
15308,2017-02-01,03X,221,405,626,0.35303514376996803
15309,2017-02-01,03Y,475,621,1096,0.4333941605839416
15310,2017-02-01,04C,1716,934,2650,0.6475471698113208
15311,2017-02-01,04D,1219,761,1980,0.6156565656565657
15312,2017-02-01,04E,518,1224,1742,0.2973593570608496
15313,2017-02-01,04F,1283,1035,2318,0.5534943917169974
15314,2017-02-01,04G,3192,3206,6398,0.4989059080962801
15315,2017-02-01,04H,352,776,1128,0.3120567375886525
15316,2017-02-01,04J,1176,1857,3033,0.3877349159248269
15317,2017-02-01,04K,636,1833,2469,0.25759416767922233
15318,2017-02-01,04L,220,858,1078,0.20408163265306123
15319,2017-02-01,04M,134,533,667,0.20089955022488756
15320,2017-02-01,04N,202,673,875,0.23085714285714284
15321,2017-02-01,04Q,719,456,1175,0.6119148936170212
15322,2017-02-01,04R,1537,2286,3823,0.40204028250065393
15323,2017-02-01,04V,2181,1186,3367,0.6477576477576478
15324,2017-02-01,04X,912,1489,2401,0.3798417326114119
15325,2017-02-01,04Y,721,568,1289,0.5593483320403414
15326,2017-02-01,05A,1574,2176,3750,0.41973333333333335
15327,2017-02-01,05C,999,1984,2983,0.3348977539389876
15328,2017-02-01,05D,919,466,1385,0.6635379061371841
15329,2017-02-01,05F,728,1138,1866,0.39013933547695606
15330,2017-02-01,05G,1316,908,2224,0.591726618705036
15331,2017-02-01,05H,738,957,1695,0.4353982300884956
15332,2017-02-01,05J,1174,726,1900,0.6178947368421053
15333,2017-02-01,05L,2006,2078,4084,0.4911851126346719
15334,2017-02-01,05N,1792,1220,3012,0.5949535192563081
15335,2017-02-01,05P,752,1175,1927,0.3902439024390244
15336,2017-02-01,05Q,1242,806,2048,0.6064453125
15337,2017-02-01,05R,943,1727,2670,0.35318352059925096
15338,2017-02-01,05T,1723,1285,3008,0.5728058510638298
15339,2017-02-01,05V,785,689,1474,0.5325644504748982
15340,2017-02-01,05W,1442,1140,2582,0.5584817970565453
15341,2017-02-01,05X,862,713,1575,0.5473015873015873
15342,2017-02-01,05Y,1447,1137,2584,0.559984520123839
15343,2017-02-01,06A,1131,977,2108,0.536527514231499
15344,2017-02-01,06D,852,522,1374,0.6200873362445415
15345,2017-02-01,06F,1343,2533,3876,0.34649122807017546
15346,2017-02-01,06H,4683,3160,7843,0.5970929491266097
15347,2017-02-01,06K,2698,3008,5706,0.4728356116368735
15348,2017-02-01,06L,2254,1145,3399,0.6631362165342748
15349,2017-02-01,06M,1635,1017,2652,0.6165158371040724
15350,2017-02-01,06N,2580,2735,5315,0.4854186265286924
15351,2017-02-01,06P,739,848,1587,0.465658475110271
15352,2017-02-01,06Q,2265,1301,3566,0.6351654514862591
15353,2017-02-01,06T,1920,1596,3516,0.5460750853242321
15354,2017-02-01,06V,1122,850,1972,0.5689655172413793
15355,2017-02-01,06W,1298,792,2090,0.6210526315789474
15356,2017-02-01,06Y,1224,751,1975,0.619746835443038
15357,2017-02-01,07G,782,371,1153,0.6782307025151778
15358,2017-02-01,07H,1610,1193,2803,0.5743845879414913
15359,2017-02-01,07J,926,653,1579,0.5864471184293857
15360,2017-02-01,07K,1331,745,2076,0.6411368015414258
15361,2017-02-01,07L,697,391,1088,0.640625
15362,2017-02-01,07M,1077,1269,2346,0.45907928388746805
15363,2017-02-01,07N,1275,837,2112,0.6036931818181818
15364,2017-02-01,07P,733,822,1555,0.47138263665594854
15365,2017-02-01,07Q,1464,896,2360,0.6203389830508474
15366,2017-02-01,07R,494,780,1274,0.3877551020408163
15367,2017-02-01,07T,470,873,1343,0.34996276991809383
15368,2017-02-01,07V,917,1714,2631,0.3485366780691752
15369,2017-02-01,07W,1067,931,1998,0.534034034034034
15370,2017-02-01,07X,1049,868,1917,0.5472091810119979
15371,2017-02-01,07Y,838,585,1423,0.5888966971187631
15372,2017-02-01,08A,881,667,1548,0.5691214470284238
15373,2017-02-01,08C,484,581,1065,0.4544600938967136
15374,2017-02-01,08D,598,729,1327,0.4506405425772419
15375,2017-02-01,08E,766,842,1608,0.4763681592039801
15376,2017-02-01,08F,1243,731,1974,0.6296859169199595
15377,2017-02-01,08G,426,1284,1710,0.24912280701754386
15378,2017-02-01,08H,447,907,1354,0.33013293943870015
15379,2017-02-01,08J,740,595,1335,0.5543071161048689
15380,2017-02-01,08K,811,1074,1885,0.43023872679045094
15381,2017-02-01,08L,669,1067,1736,0.38536866359447003
15382,2017-02-01,08M,1072,764,1836,0.5838779956427015
15383,2017-02-01,08N,1058,689,1747,0.6056096164854036
15384,2017-02-01,08P,864,618,1482,0.582995951417004
15385,2017-02-01,08Q,623,823,1446,0.43084370677731676
15386,2017-02-01,08R,743,545,1288,0.5768633540372671
15387,2017-02-01,08T,808,753,1561,0.5176169122357464
15388,2017-02-01,08V,1029,909,1938,0.5309597523219814
15389,2017-02-01,08W,885,721,1606,0.5510585305105853
15390,2017-02-01,08X,1046,1080,2126,0.49200376293508935
15391,2017-02-01,08Y,560,595,1155,0.48484848484848486
15392,2017-02-01,09A,472,792,1264,0.37341772151898733
15393,2017-02-01,09C,575,531,1106,0.5198915009041591
15394,2017-02-01,09D,957,1238,2195,0.4359908883826879
15395,2017-02-01,09E,1307,827,2134,0.612464854732896
15396,2017-02-01,09F,995,748,1743,0.5708548479632817
15397,2017-02-01,09G,3225,1831,5056,0.6378560126582279
15398,2017-02-01,09H,479,379,858,0.5582750582750583
15399,2017-02-01,09J,1402,1149,2551,0.5495883967071736
15400,2017-02-01,09L,630,668,1298,0.48536209553158705
15401,2017-02-01,09N,910,844,1754,0.5188141391106044
15402,2017-02-01,09P,772,1027,1799,0.4291272929405225
15403,2017-02-01,09W,1194,952,2146,0.5563839701770736
15404,2017-02-01,09X,902,880,1782,0.5061728395061729
15405,2017-02-01,09Y,948,1788,2736,0.34649122807017546
15406,2017-02-01,10A,1063,847,1910,0.5565445026178011
15407,2017-02-01,10C,369,415,784,0.47066326530612246
15408,2017-02-01,10D,497,507,1004,0.4950199203187251
15409,2017-02-01,10E,726,428,1154,0.6291161178509532
15410,2017-02-01,10G,428,571,999,0.42842842842842843
15411,2017-02-01,10H,1476,1664,3140,0.47006369426751593
15412,2017-02-01,10J,781,965,1746,0.4473081328751432
15413,2017-02-01,10K,1115,656,1771,0.629587803500847
15414,2017-02-01,10L,927,565,1492,0.621313672922252
15415,2017-02-01,10M,372,484,856,0.43457943925233644
15416,2017-02-01,10N,362,473,835,0.43353293413173655
15417,2017-02-01,10Q,2995,2880,5875,0.5097872340425532
15418,2017-02-01,10R,1255,629,1884,0.666135881104034
15419,2017-02-01,10T,445,595,1040,0.42788461538461536
15420,2017-02-01,10V,1132,725,1857,0.6095853527194399
15421,2017-02-01,10W,438,474,912,0.48026315789473684
15422,2017-02-01,10X,1031,761,1792,0.5753348214285714
15423,2017-02-01,10Y,1029,1069,2098,0.49046711153479505
15424,2017-02-01,11A,2597,1990,4587,0.566165249618487
15425,2017-02-01,11C,619,583,1202,0.5149750415973378
15426,2017-02-01,11D,549,640,1189,0.46173254835996635
15427,2017-02-01,11E,847,962,1809,0.46821448313985625
15428,2017-02-01,11H,2167,1651,3818,0.5675746464117339
15429,2017-02-01,11J,4379,3168,7547,0.5802305551874917
15430,2017-02-01,11M,3655,1968,5623,0.6500088920505068
15431,2017-02-01,11N,2398,2995,5393,0.4446504728351567
15432,2017-02-01,11T,1256,904,2160,0.5814814814814815
15433,2017-02-01,11X,2732,1779,4511,0.6056306805586344
15434,2017-02-01,12A,1268,863,2131,0.5950258094791178
15435,2017-02-01,12D,1007,938,1945,0.5177377892030849
15436,2017-02-01,12F,1658,1510,3168,0.5233585858585859
15437,2017-02-01,13P,1895,3437,5332,0.3554013503375844
15438,2017-02-01,13T,2769,1697,4466,0.6200179131213615
15439,2017-02-01,14L,2395,2082,4477,0.5349564440473531
15440,2017-02-01,99A,1667,2042,3709,0.4494472903747641
15441,2017-02-01,99C,1321,827,2148,0.6149906890130353
15442,2017-02-01,99D,946,828,1774,0.5332581736189402
15443,2017-02-01,99E,1524,678,2202,0.6920980926430518
15444,2017-02-01,99F,1138,464,1602,0.7103620474406991
15445,2017-02-01,99G,995,427,1422,0.6997187060478199
15446,2017-02-01,99H,1227,1267,2494,0.4919807538091419
15447,2017-02-01,99J,2580,1900,4480,0.5758928571428571
15448,2017-02-01,99K,840,794,1634,0.5140758873929009
15449,2017-02-01,99M,845,942,1787,0.47285954113038614
15450,2017-02-01,99N,2574,2388,4962,0.5187424425634825
15451,2017-02-01,99P,5193,3261,8454,0.6142654364797729
15452,2017-02-01,99Q,1648,999,2647,0.6225916131469588
15453,2017-03-01,00C,802,388,1190,0.6739495798319328
15454,2017-03-01,00D,1879,1537,3416,0.5500585480093677
15455,2017-03-01,00J,1615,945,2560,0.630859375
15456,2017-03-01,00K,2167,1140,3307,0.655276685817962
15457,2017-03-01,00L,2037,1719,3756,0.542332268370607
15458,2017-03-01,00M,2165,1227,3392,0.6382665094339622
15459,2017-03-01,00N,1240,690,1930,0.6424870466321243
15460,2017-03-01,00P,1776,1133,2909,0.61051907872121
15461,2017-03-01,00Q,959,663,1622,0.5912453760789149
15462,2017-03-01,00R,1068,832,1900,0.5621052631578948
15463,2017-03-01,00T,1786,1229,3015,0.5923714759535655
15464,2017-03-01,00V,997,1060,2057,0.4846864365580943
15465,2017-03-01,00X,1023,452,1475,0.6935593220338983
15466,2017-03-01,00Y,1431,1446,2877,0.49739311783107404
15467,2017-03-01,01A,1842,1676,3518,0.5235929505400796
15468,2017-03-01,01C,610,986,1596,0.38220551378446116
15469,2017-03-01,01D,1181,935,2116,0.5581285444234405
15470,2017-03-01,01E,1055,445,1500,0.7033333333333334
15471,2017-03-01,01F,765,641,1406,0.5440967283072546
15472,2017-03-01,01G,1238,1429,2667,0.4641919760029996
15473,2017-03-01,01H,2273,1305,3578,0.6352711011738401
15474,2017-03-01,01J,831,921,1752,0.4743150684931507
15475,2017-03-01,01K,1678,1866,3544,0.4734762979683973
15476,2017-03-01,01R,644,945,1589,0.4052863436123348
15477,2017-03-01,01T,582,720,1302,0.4470046082949309
15478,2017-03-01,01V,588,748,1336,0.44011976047904194
15479,2017-03-01,01W,1770,1289,3059,0.5786204642039883
15480,2017-03-01,01X,1381,1167,2548,0.5419937205651492
15481,2017-03-01,01Y,727,1399,2126,0.3419567262464723
15482,2017-03-01,02A,949,1128,2077,0.45690900337024554
15483,2017-03-01,02D,335,542,877,0.38198403648802737
15484,2017-03-01,02E,946,1033,1979,0.47801920161697825
15485,2017-03-01,02F,1133,1400,2533,0.4472956968022108
15486,2017-03-01,02G,546,639,1185,0.4607594936708861
15487,2017-03-01,02H,1601,1759,3360,0.4764880952380952
15488,2017-03-01,02M,829,779,1608,0.5155472636815921
15489,2017-03-01,02N,924,814,1738,0.5316455696202531
15490,2017-03-01,02P,1010,1769,2779,0.3634400863620007
15491,2017-03-01,02Q,578,566,1144,0.5052447552447552
15492,2017-03-01,02R,1888,1312,3200,0.59
15493,2017-03-01,02T,1109,1065,2174,0.5101195952161913
15494,2017-03-01,02V,660,1240,1900,0.3473684210526316
15495,2017-03-01,02W,603,448,1051,0.5737392959086585
15496,2017-03-01,02X,1487,1643,3130,0.47507987220447284
15497,2017-03-01,02Y,2050,1054,3104,0.6604381443298969
15498,2017-03-01,03A,1368,963,2331,0.5868725868725869
15499,2017-03-01,03C,953,2065,3018,0.3157720344599072
15500,2017-03-01,03D,642,722,1364,0.4706744868035191
15501,2017-03-01,03E,757,618,1375,0.5505454545454546
15502,2017-03-01,03F,1848,726,2574,0.717948717948718
15503,2017-03-01,03G,829,1700,2529,0.3277975484381178
15504,2017-03-01,03H,1285,501,1786,0.719484882418813
15505,2017-03-01,03J,1129,667,1796,0.628619153674833
15506,2017-03-01,03K,1035,475,1510,0.6854304635761589
15507,2017-03-01,03L,887,1881,2768,0.3204479768786127
15508,2017-03-01,03M,855,495,1350,0.6333333333333333
15509,2017-03-01,03N,3056,2170,5226,0.5847684653654803
15510,2017-03-01,03Q,1927,1159,3086,0.6244329228775113
15511,2017-03-01,03R,2118,1592,3710,0.57088948787062
15512,2017-03-01,03T,1824,932,2756,0.6618287373004355
15513,2017-03-01,03V,364,363,727,0.5006877579092159
15514,2017-03-01,03W,2189,1287,3476,0.629746835443038
15515,2017-03-01,03X,207,448,655,0.31603053435114503
15516,2017-03-01,03Y,500,713,1213,0.41220115416323166
15517,2017-03-01,04C,1969,1128,3097,0.6357765579593154
15518,2017-03-01,04D,1353,905,2258,0.5992028343666962
15519,2017-03-01,04E,574,1417,1991,0.2882973380210949
15520,2017-03-01,04F,1499,1189,2688,0.5576636904761905
15521,2017-03-01,04G,3268,3889,7157,0.45661590051697637
15522,2017-03-01,04H,337,882,1219,0.27645611156685806
15523,2017-03-01,04J,1214,2031,3245,0.3741140215716487
15524,2017-03-01,04K,640,2089,2729,0.23451813851227557
15525,2017-03-01,04L,302,942,1244,0.2427652733118971
15526,2017-03-01,04M,162,590,752,0.2154255319148936
15527,2017-03-01,04N,206,781,987,0.20871327254305977
15528,2017-03-01,04Q,809,478,1287,0.6285936285936286
15529,2017-03-01,04R,1546,2755,4301,0.35945129039758195
15530,2017-03-01,04V,2464,1373,3837,0.6421683606984624
15531,2017-03-01,04X,1061,1740,2801,0.3787932881113888
15532,2017-03-01,04Y,787,699,1486,0.5296096904441454
15533,2017-03-01,05A,1810,2558,4368,0.4143772893772894
15534,2017-03-01,05C,1094,2209,3303,0.33121404783530123
15535,2017-03-01,05D,984,527,1511,0.6512243547319656
15536,2017-03-01,05F,816,1262,2078,0.39268527430221367
15537,2017-03-01,05G,1427,1138,2565,0.5563352826510721
15538,2017-03-01,05H,847,1058,1905,0.44461942257217846
15539,2017-03-01,05J,1344,870,2214,0.6070460704607046
15540,2017-03-01,05L,2167,2214,4381,0.4946359278703492
15541,2017-03-01,05N,1919,1440,3359,0.5713009824352486
15542,2017-03-01,05P,753,1373,2126,0.3541862652869238
15543,2017-03-01,05Q,1369,916,2285,0.5991247264770241
15544,2017-03-01,05R,1092,1942,3034,0.35992089650626236
15545,2017-03-01,05T,1836,1538,3374,0.5441612329579134
15546,2017-03-01,05V,981,740,1721,0.5700174317257408
15547,2017-03-01,05W,1551,1243,2794,0.5551181102362205
15548,2017-03-01,05X,919,837,1756,0.5233485193621867
15549,2017-03-01,05Y,1556,1450,3006,0.5176314038589488
15550,2017-03-01,06A,1278,1111,2389,0.5349518627040603
15551,2017-03-01,06D,938,575,1513,0.619960343688037
15552,2017-03-01,06F,1484,2998,4482,0.33110218652387324
15553,2017-03-01,06H,5247,3544,8791,0.5968604254351041
15554,2017-03-01,06K,3062,3424,6486,0.47209374036386065
15555,2017-03-01,06L,2399,1426,3825,0.6271895424836601
15556,2017-03-01,06M,1814,1234,3048,0.5951443569553806
15557,2017-03-01,06N,2981,2995,5976,0.49882864792503345
15558,2017-03-01,06P,848,1032,1880,0.451063829787234
15559,2017-03-01,06Q,2470,1440,3910,0.6317135549872123
15560,2017-03-01,06T,2101,1913,4014,0.5234180368709517
15561,2017-03-01,06V,1312,1018,2330,0.5630901287553648
15562,2017-03-01,06W,1493,1027,2520,0.5924603174603175
15563,2017-03-01,06Y,1288,875,2163,0.5954692556634305
15564,2017-03-01,07G,880,429,1309,0.6722689075630253
15565,2017-03-01,07H,1878,1337,3215,0.5841368584758942
15566,2017-03-01,07J,987,787,1774,0.556369785794814
15567,2017-03-01,07K,1509,877,2386,0.63243922883487
15568,2017-03-01,07L,770,476,1246,0.6179775280898876
15569,2017-03-01,07M,1212,1489,2701,0.44872269529803777
15570,2017-03-01,07N,1408,943,2351,0.5988940876222884
15571,2017-03-01,07P,696,954,1650,0.4218181818181818
15572,2017-03-01,07Q,1587,1098,2685,0.5910614525139665
15573,2017-03-01,07R,545,938,1483,0.3674983142279164
15574,2017-03-01,07T,495,984,1479,0.33468559837728196
15575,2017-03-01,07V,1074,1887,2961,0.36271529888551163
15576,2017-03-01,07W,1253,1075,2328,0.5382302405498282
15577,2017-03-01,07X,1155,1085,2240,0.515625
15578,2017-03-01,07Y,979,693,1672,0.5855263157894737
15579,2017-03-01,08A,993,750,1743,0.5697074010327022
15580,2017-03-01,08C,630,664,1294,0.4868624420401855
15581,2017-03-01,08D,729,835,1564,0.46611253196930946
15582,2017-03-01,08E,817,892,1709,0.47805734347571677
15583,2017-03-01,08F,1435,850,2285,0.6280087527352297
15584,2017-03-01,08G,458,1499,1957,0.2340316811446091
15585,2017-03-01,08H,505,992,1497,0.33734134936539745
15586,2017-03-01,08J,809,699,1508,0.536472148541114
15587,2017-03-01,08K,817,1225,2042,0.4000979431929481
15588,2017-03-01,08L,768,1246,2014,0.381330685203575
15589,2017-03-01,08M,1212,812,2024,0.5988142292490118
15590,2017-03-01,08N,1200,753,1953,0.6144393241167435
15591,2017-03-01,08P,937,725,1662,0.5637785800240674
15592,2017-03-01,08Q,679,902,1581,0.42947501581277675
15593,2017-03-01,08R,886,603,1489,0.5950302216252519
15594,2017-03-01,08T,796,907,1703,0.4674104521432766
15595,2017-03-01,08V,1100,1057,2157,0.5099675475197033
15596,2017-03-01,08W,1050,835,1885,0.5570291777188329
15597,2017-03-01,08X,1169,1338,2507,0.4662943757479059
15598,2017-03-01,08Y,617,720,1337,0.46148092744951386
15599,2017-03-01,09A,514,788,1302,0.39477726574500765
15600,2017-03-01,09C,652,606,1258,0.5182829888712241
15601,2017-03-01,09D,1062,1412,2474,0.42926434923201295
15602,2017-03-01,09E,1403,960,2363,0.5937367752856538
15603,2017-03-01,09F,1109,875,1984,0.5589717741935484
15604,2017-03-01,09G,3669,2187,5856,0.6265368852459017
15605,2017-03-01,09H,531,417,948,0.560126582278481
15606,2017-03-01,09J,1589,1289,2878,0.5521195274496178
15607,2017-03-01,09L,750,811,1561,0.48046124279308133
15608,2017-03-01,09N,899,1107,2006,0.4481555333998006
15609,2017-03-01,09P,859,1138,1997,0.4301452178267401
15610,2017-03-01,09W,1407,1096,2503,0.5621254494606472
15611,2017-03-01,09X,1093,1063,2156,0.5069573283858998
15612,2017-03-01,09Y,1004,2045,3049,0.3292882912430305
15613,2017-03-01,10A,1296,941,2237,0.5793473401877515
15614,2017-03-01,10C,420,402,822,0.5109489051094891
15615,2017-03-01,10D,656,550,1206,0.5439469320066335
15616,2017-03-01,10E,691,634,1325,0.5215094339622641
15617,2017-03-01,10G,434,700,1134,0.38271604938271603
15618,2017-03-01,10H,1511,1978,3489,0.4330753797649756
15619,2017-03-01,10J,904,1181,2085,0.43357314148681053
15620,2017-03-01,10K,1342,766,2108,0.6366223908918406
15621,2017-03-01,10L,945,694,1639,0.5765710799267846
15622,2017-03-01,10M,380,511,891,0.4264870931537598
15623,2017-03-01,10N,393,550,943,0.41675503711558853
15624,2017-03-01,10Q,3355,3337,6692,0.5013448894202033
15625,2017-03-01,10R,1449,810,2259,0.6414342629482072
15626,2017-03-01,10T,411,665,1076,0.3819702602230483
15627,2017-03-01,10V,1341,787,2128,0.6301691729323309
15628,2017-03-01,10W,421,582,1003,0.419740777666999
15629,2017-03-01,10X,1263,898,2161,0.5844516427579824
15630,2017-03-01,10Y,1041,1322,2363,0.44054168429961915
15631,2017-03-01,11A,2878,2220,5098,0.5645351118085524
15632,2017-03-01,11C,708,782,1490,0.47516778523489933
15633,2017-03-01,11D,615,761,1376,0.44694767441860467
15634,2017-03-01,11E,816,1214,2030,0.4019704433497537
15635,2017-03-01,11H,2439,1871,4310,0.565893271461717
15636,2017-03-01,11J,4670,3918,8588,0.5437820214252446
15637,2017-03-01,11M,3942,2252,6194,0.6364223442040684
15638,2017-03-01,11N,2706,3561,6267,0.43178554332216373
15639,2017-03-01,11T,1433,1047,2480,0.5778225806451613
15640,2017-03-01,11X,2886,2092,4978,0.579750903977501
15641,2017-03-01,12A,1580,963,2543,0.6213134093590248
15642,2017-03-01,12D,1083,1115,2198,0.4927206551410373
15643,2017-03-01,12F,1974,1964,3938,0.5012696800406298
15644,2017-03-01,13P,1983,3916,5899,0.33615867096117985
15645,2017-03-01,13T,3174,1890,5064,0.6267772511848341
15646,2017-03-01,14L,2746,2399,5145,0.5337220602526725
15647,2017-03-01,99A,1844,2379,4223,0.43665640539900547
15648,2017-03-01,99C,1544,937,2481,0.6223297057638049
15649,2017-03-01,99D,1165,952,2117,0.550307038261691
15650,2017-03-01,99E,1721,765,2486,0.6922767497988737
15651,2017-03-01,99F,1170,536,1706,0.6858147713950762
15652,2017-03-01,99G,1036,526,1562,0.6632522407170295
15653,2017-03-01,99H,1288,1541,2829,0.45528455284552843
15654,2017-03-01,99J,3061,2158,5219,0.5865108258287028
15655,2017-03-01,99K,855,935,1790,0.4776536312849162
15656,2017-03-01,99M,1037,1127,2164,0.4792051756007394
15657,2017-03-01,99N,2735,2876,5611,0.4874353947602923
15658,2017-03-01,99P,5818,3719,9537,0.6100450875537381
15659,2017-03-01,99Q,1930,1236,3166,0.609602021478206
15660,2017-04-01,00C,621,385,1006,0.617296222664016
15661,2017-04-01,00D,1447,1379,2826,0.5120311394196745
15662,2017-04-01,00J,1214,980,2194,0.5533272561531449
15663,2017-04-01,00K,1472,890,2362,0.6232006773920407
15664,2017-04-01,00L,1565,1543,3108,0.5035392535392536
15665,2017-04-01,00M,1632,1165,2797,0.5834823024669289
15666,2017-04-01,00N,1043,621,1664,0.6268028846153846
15667,2017-04-01,00P,1499,1055,2554,0.5869224745497259
15668,2017-04-01,00Q,601,690,1291,0.46553059643687067
15669,2017-04-01,00R,878,843,1721,0.5101685066821615
15670,2017-04-01,00T,1525,1106,2631,0.5796275180539718
15671,2017-04-01,00V,775,1006,1781,0.4351487928130264
15672,2017-04-01,00X,871,410,1281,0.6799375487900078
15673,2017-04-01,00Y,1128,1237,2365,0.47695560253699787
15674,2017-04-01,01A,1632,1545,3177,0.5136921624173749
15675,2017-04-01,01C,544,828,1372,0.3965014577259475
15676,2017-04-01,01D,984,795,1779,0.5531197301854974
15677,2017-04-01,01E,843,401,1244,0.677652733118971
15678,2017-04-01,01F,630,575,1205,0.5228215767634855
15679,2017-04-01,01G,954,1216,2170,0.4396313364055299
15680,2017-04-01,01H,1950,1161,3111,0.626808100289296
15681,2017-04-01,01J,651,766,1417,0.45942131263232183
15682,2017-04-01,01K,1348,1605,2953,0.45648493057907213
15683,2017-04-01,01R,534,804,1338,0.3991031390134529
15684,2017-04-01,01T,481,715,1196,0.40217391304347827
15685,2017-04-01,01V,485,602,1087,0.44618215271389144
15686,2017-04-01,01W,1559,1129,2688,0.5799851190476191
15687,2017-04-01,01X,1115,1031,2146,0.5195712954333644
15688,2017-04-01,01Y,514,1228,1742,0.29506314580941445
15689,2017-04-01,02A,833,929,1762,0.4727582292849035
15690,2017-04-01,02D,268,474,742,0.3611859838274933
15691,2017-04-01,02E,694,780,1474,0.4708276797829037
15692,2017-04-01,02F,867,1247,2114,0.41012298959318827
15693,2017-04-01,02G,460,518,978,0.4703476482617587
15694,2017-04-01,02H,1317,1407,2724,0.4834801762114537
15695,2017-04-01,02M,675,739,1414,0.47736916548797736
15696,2017-04-01,02N,608,743,1351,0.45003700962250187
15697,2017-04-01,02P,787,1463,2250,0.3497777777777778
15698,2017-04-01,02Q,499,489,988,0.5050607287449392
15699,2017-04-01,02R,1522,1145,2667,0.5706786651668542
15700,2017-04-01,02T,896,907,1803,0.49694952856350527
15701,2017-04-01,02V,553,1138,1691,0.3270254287403903
15702,2017-04-01,02W,419,358,777,0.5392535392535392
15703,2017-04-01,02X,1308,1370,2678,0.48842419716206126
15704,2017-04-01,02Y,1575,1046,2621,0.6009156810377718
15705,2017-04-01,03A,1101,798,1899,0.5797788309636651
15706,2017-04-01,03C,707,1634,2341,0.30200768902178554
15707,2017-04-01,03D,467,641,1108,0.4214801444043321
15708,2017-04-01,03E,583,555,1138,0.5123022847100176
15709,2017-04-01,03F,1477,625,2102,0.7026641294005709
15710,2017-04-01,03G,711,1353,2064,0.3444767441860465
15711,2017-04-01,03H,1120,477,1597,0.7013149655604258
15712,2017-04-01,03J,870,616,1486,0.585464333781965
15713,2017-04-01,03K,813,436,1249,0.6509207365892714
15714,2017-04-01,03L,784,1624,2408,0.32558139534883723
15715,2017-04-01,03M,727,410,1137,0.6394019349164468
15716,2017-04-01,03N,2411,1947,4358,0.5532354290959156
15717,2017-04-01,03Q,1616,1002,2618,0.6172650878533231
15718,2017-04-01,03R,1533,1576,3109,0.4930845931167578
15719,2017-04-01,03T,1534,779,2313,0.6632079550367488
15720,2017-04-01,03V,279,362,641,0.43525741029641185
15721,2017-04-01,03W,1736,1313,3049,0.5693670055755986
15722,2017-04-01,03X,169,395,564,0.299645390070922
15723,2017-04-01,03Y,364,613,977,0.3725690890481064
15724,2017-04-01,04C,1461,958,2419,0.603968582058702
15725,2017-04-01,04D,1148,737,1885,0.6090185676392573
15726,2017-04-01,04E,470,1129,1599,0.2939337085678549
15727,2017-04-01,04F,1205,1048,2253,0.5348424323124723
15728,2017-04-01,04G,2613,3518,6131,0.4261947480019573
15729,2017-04-01,04H,313,710,1023,0.30596285434995113
15730,2017-04-01,04J,986,1961,2947,0.334577536477774
15731,2017-04-01,04K,552,1721,2273,0.24285085789705235
15732,2017-04-01,04L,229,845,1074,0.2132216014897579
15733,2017-04-01,04M,132,478,610,0.21639344262295082
15734,2017-04-01,04N,169,662,831,0.20336943441636582
15735,2017-04-01,04Q,707,421,1128,0.62677304964539
15736,2017-04-01,04R,1237,2379,3616,0.3420907079646018
15737,2017-04-01,04V,1905,1331,3236,0.5886897404202719
15738,2017-04-01,04X,850,1550,2400,0.3541666666666667
15739,2017-04-01,04Y,666,603,1269,0.524822695035461
15740,2017-04-01,05A,1425,2094,3519,0.40494458653026427
15741,2017-04-01,05C,928,1967,2895,0.32055267702936097
15742,2017-04-01,05D,835,474,1309,0.6378915202444614
15743,2017-04-01,05F,620,1082,1702,0.36427732079905994
15744,2017-04-01,05G,1122,846,1968,0.5701219512195121
15745,2017-04-01,05H,691,871,1562,0.44238156209987195
15746,2017-04-01,05J,1116,804,1920,0.58125
15747,2017-04-01,05L,1796,1976,3772,0.47613997879109227
15748,2017-04-01,05N,1588,1200,2788,0.569583931133429
15749,2017-04-01,05P,648,1251,1899,0.3412322274881517
15750,2017-04-01,05Q,1120,889,2009,0.5574912891986062
15751,2017-04-01,05R,901,1609,2510,0.35896414342629485
15752,2017-04-01,05T,1436,1309,2745,0.5231329690346084
15753,2017-04-01,05V,718,668,1386,0.5180375180375181
15754,2017-04-01,05W,1276,1064,2340,0.5452991452991452
15755,2017-04-01,05X,699,786,1485,0.4707070707070707
15756,2017-04-01,05Y,1224,1179,2403,0.5093632958801498
15757,2017-04-01,06A,1023,994,2017,0.5071888943976203
15758,2017-04-01,06D,615,668,1283,0.4793452844894778
15759,2017-04-01,06F,1058,2509,3567,0.2966077936641435
15760,2017-04-01,06H,4266,3097,7363,0.5793834035040065
15761,2017-04-01,06K,2555,3070,5625,0.45422222222222225
15762,2017-04-01,06L,1942,1371,3313,0.5861756715967401
15763,2017-04-01,06M,1445,1067,2512,0.5752388535031847
15764,2017-04-01,06N,2418,2639,5057,0.4781491002570694
15765,2017-04-01,06P,639,890,1529,0.41792020928711576
15766,2017-04-01,06Q,2063,1250,3313,0.6226984606097193
15767,2017-04-01,06T,1829,1578,3407,0.5368359260346346
15768,2017-04-01,06V,1014,857,1871,0.5419561731694281
15769,2017-04-01,06W,1280,898,2178,0.5876951331496786
15770,2017-04-01,06Y,1053,707,1760,0.5982954545454545
15771,2017-04-01,07G,734,405,1139,0.6444249341527656
15772,2017-04-01,07H,1451,1201,2652,0.547134238310709
15773,2017-04-01,07J,897,659,1556,0.5764781491002571
15774,2017-04-01,07K,1196,740,1936,0.6177685950413223
15775,2017-04-01,07L,612,393,1005,0.608955223880597
15776,2017-04-01,07M,958,1215,2173,0.4408651633686148
15777,2017-04-01,07N,1176,767,1943,0.6052496139989707
15778,2017-04-01,07P,569,815,1384,0.4111271676300578
15779,2017-04-01,07Q,1257,949,2206,0.5698096101541251
15780,2017-04-01,07R,422,789,1211,0.34847233691164325
15781,2017-04-01,07T,424,806,1230,0.34471544715447155
15782,2017-04-01,07V,892,1513,2405,0.3708939708939709
15783,2017-04-01,07W,970,914,1884,0.5148619957537155
15784,2017-04-01,07X,894,857,1751,0.5105653912050258
15785,2017-04-01,07Y,698,587,1285,0.5431906614785992
15786,2017-04-01,08A,786,615,1401,0.5610278372591007
15787,2017-04-01,08C,446,633,1079,0.41334569045412417
15788,2017-04-01,08D,491,652,1143,0.42957130358705164
15789,2017-04-01,08E,664,806,1470,0.45170068027210886
15790,2017-04-01,08F,1156,745,1901,0.6081009994739611
15791,2017-04-01,08G,401,1210,1611,0.2489137181874612
15792,2017-04-01,08H,406,878,1284,0.3161993769470405
15793,2017-04-01,08J,666,560,1226,0.5432300163132137
15794,2017-04-01,08K,612,1004,1616,0.3787128712871287
15795,2017-04-01,08L,636,1088,1724,0.3689095127610209
15796,2017-04-01,08M,896,660,1556,0.5758354755784062
15797,2017-04-01,08N,1036,658,1694,0.6115702479338843
15798,2017-04-01,08P,822,660,1482,0.5546558704453441
15799,2017-04-01,08Q,575,843,1418,0.40550070521861775
15800,2017-04-01,08R,599,568,1167,0.5132819194515853
15801,2017-04-01,08T,643,863,1506,0.42695883134130147
15802,2017-04-01,08V,871,882,1753,0.4968625213918996
15803,2017-04-01,08W,829,755,1584,0.5233585858585859
15804,2017-04-01,08X,915,1090,2005,0.456359102244389
15805,2017-04-01,08Y,597,549,1146,0.5209424083769634
15806,2017-04-01,09A,398,743,1141,0.3488168273444347
15807,2017-04-01,09C,557,607,1164,0.47852233676975947
15808,2017-04-01,09D,898,1170,2068,0.43423597678916825
15809,2017-04-01,09E,1163,897,2060,0.5645631067961165
15810,2017-04-01,09F,799,909,1708,0.4677985948477752
15811,2017-04-01,09G,2859,1899,4758,0.6008827238335435
15812,2017-04-01,09H,427,360,787,0.542566709021601
15813,2017-04-01,09J,1336,1078,2414,0.5534382767191384
15814,2017-04-01,09L,609,616,1225,0.49714285714285716
15815,2017-04-01,09N,692,890,1582,0.43742098609355246
15816,2017-04-01,09P,691,1071,1762,0.39216799091940974
15817,2017-04-01,09W,1096,940,2036,0.5383104125736738
15818,2017-04-01,09X,737,890,1627,0.45298094652735094
15819,2017-04-01,09Y,820,1810,2630,0.311787072243346
15820,2017-04-01,10A,1036,847,1883,0.550185873605948
15821,2017-04-01,10C,364,383,747,0.48728246318607765
15822,2017-04-01,10D,486,491,977,0.49744114636642783
15823,2017-04-01,10E,554,575,1129,0.49069973427812225
15824,2017-04-01,10G,275,652,927,0.296655879180151
15825,2017-04-01,10H,1084,1764,2848,0.3806179775280899
15826,2017-04-01,10J,707,985,1692,0.4178486997635934
15827,2017-04-01,10K,1015,644,1659,0.6118143459915611
15828,2017-04-01,10L,806,571,1377,0.5853304284676834
15829,2017-04-01,10M,320,478,798,0.40100250626566414
15830,2017-04-01,10N,294,479,773,0.38033635187580855
15831,2017-04-01,10Q,2652,2714,5366,0.4942228848304137
15832,2017-04-01,10R,1117,615,1732,0.644919168591224
15833,2017-04-01,10T,332,560,892,0.3721973094170404
15834,2017-04-01,10V,1064,651,1715,0.6204081632653061
15835,2017-04-01,10W,343,502,845,0.4059171597633136
15836,2017-04-01,10X,1016,736,1752,0.5799086757990868
15837,2017-04-01,10Y,785,1093,1878,0.4179978700745474
15838,2017-04-01,11A,2545,2000,4545,0.55995599559956
15839,2017-04-01,11C,548,699,1247,0.43945469125902165
15840,2017-04-01,11D,557,613,1170,0.47606837606837604
15841,2017-04-01,11E,736,1017,1753,0.41985168282943525
15842,2017-04-01,11H,2028,1495,3523,0.5756457564575646
15843,2017-04-01,11J,3731,3258,6989,0.5338388896837888
15844,2017-04-01,11M,3289,1999,5288,0.6219742813918305
15845,2017-04-01,11N,2119,2897,5016,0.4224481658692185
15846,2017-04-01,11T,1219,928,2147,0.567768979972054
15847,2017-04-01,11X,2507,1812,4319,0.5804584394535772
15848,2017-04-01,12A,1266,872,2138,0.5921421889616464
15849,2017-04-01,12D,876,1056,1932,0.453416149068323
15850,2017-04-01,12F,1549,1546,3095,0.5004846526655896
15851,2017-04-01,13P,1690,3384,5074,0.33307055577453687
15852,2017-04-01,13T,2374,1673,4047,0.5866073634791203
15853,2017-04-01,14L,2247,2067,4314,0.5208623087621697
15854,2017-04-01,99A,1544,1906,3450,0.44753623188405794
15855,2017-04-01,99C,1259,803,2062,0.6105722599418041
15856,2017-04-01,99D,940,779,1719,0.5468295520651542
15857,2017-04-01,99E,1452,714,2166,0.6703601108033241
15858,2017-04-01,99F,914,421,1335,0.6846441947565544
15859,2017-04-01,99G,799,516,1315,0.6076045627376426
15860,2017-04-01,99H,1086,1280,2366,0.45900253592561285
15861,2017-04-01,99J,2619,1851,4470,0.5859060402684564
15862,2017-04-01,99K,662,783,1445,0.4581314878892734
15863,2017-04-01,99M,823,1012,1835,0.4485013623978202
15864,2017-04-01,99N,2442,2420,4862,0.502262443438914
15865,2017-04-01,99P,4621,3289,7910,0.584197218710493
15866,2017-04-01,99Q,1612,1078,2690,0.5992565055762081
15867,2017-05-01,00C,651,422,1073,0.6067101584342963
15868,2017-05-01,00D,1369,1794,3163,0.4328169459374012
15869,2017-05-01,00J,1184,1200,2384,0.4966442953020134
15870,2017-05-01,00K,1644,1142,2786,0.5900933237616655
15871,2017-05-01,00L,1516,1896,3412,0.44431418522860494
15872,2017-05-01,00M,1639,1308,2947,0.5561588055649813
15873,2017-05-01,00N,1078,738,1816,0.5936123348017621
15874,2017-05-01,00P,1557,1278,2835,0.5492063492063493
15875,2017-05-01,00Q,590,803,1393,0.4235463029432879
15876,2017-05-01,00R,859,819,1678,0.5119189511323003
15877,2017-05-01,00T,1645,1173,2818,0.5837473385379702
15878,2017-05-01,00V,770,1102,1872,0.4113247863247863
15879,2017-05-01,00X,817,574,1391,0.5873472322070453
15880,2017-05-01,00Y,1364,1443,2807,0.4859280370502316
15881,2017-05-01,01A,1580,1737,3317,0.47633403678022307
15882,2017-05-01,01C,499,972,1471,0.3392250169952413
15883,2017-05-01,01D,900,981,1881,0.4784688995215311
15884,2017-05-01,01E,829,575,1404,0.5904558404558404
15885,2017-05-01,01F,615,637,1252,0.49121405750798725
15886,2017-05-01,01G,1101,1373,2474,0.4450282942603072
15887,2017-05-01,01H,1972,1198,3170,0.6220820189274447
15888,2017-05-01,01J,710,795,1505,0.4717607973421927
15889,2017-05-01,01K,1455,1732,3187,0.4565422026984625
15890,2017-05-01,01R,544,861,1405,0.3871886120996441
15891,2017-05-01,01T,485,715,1200,0.4041666666666667
15892,2017-05-01,01V,548,700,1248,0.4391025641025641
15893,2017-05-01,01W,1581,1188,2769,0.570964247020585
15894,2017-05-01,01X,1136,1086,2222,0.5112511251125113
15895,2017-05-01,01Y,601,1430,2031,0.2959133431806992
15896,2017-05-01,02A,905,1008,1913,0.47307893361212755
15897,2017-05-01,02D,261,495,756,0.34523809523809523
15898,2017-05-01,02E,769,880,1649,0.46634323832625835
15899,2017-05-01,02F,1003,1260,2263,0.4432169686257181
15900,2017-05-01,02G,481,501,982,0.48981670061099797
15901,2017-05-01,02H,1455,1513,2968,0.49022911051212936
15902,2017-05-01,02M,714,893,1607,0.44430616054760425
15903,2017-05-01,02N,643,930,1573,0.4087730451366815
15904,2017-05-01,02P,896,1684,2580,0.34728682170542635
15905,2017-05-01,02Q,414,698,1112,0.3723021582733813
15906,2017-05-01,02R,1700,1280,2980,0.5704697986577181
15907,2017-05-01,02T,988,1039,2027,0.4874198322644302
15908,2017-05-01,02V,557,1232,1789,0.31134712129681386
15909,2017-05-01,02W,510,417,927,0.5501618122977346
15910,2017-05-01,02X,1317,1493,2810,0.4686832740213523
15911,2017-05-01,02Y,1807,1167,2974,0.6075991930060525
15912,2017-05-01,03A,1270,921,2191,0.5796439981743496
15913,2017-05-01,03C,774,1903,2677,0.28912962271199105
15914,2017-05-01,03D,457,805,1262,0.36212361331220283
15915,2017-05-01,03E,661,624,1285,0.514396887159533
15916,2017-05-01,03F,1549,749,2298,0.6740644038294169
15917,2017-05-01,03G,704,1557,2261,0.3113666519239275
15918,2017-05-01,03H,1194,499,1693,0.7052569403425871
15919,2017-05-01,03J,908,689,1597,0.5685660613650595
15920,2017-05-01,03K,869,568,1437,0.60473208072373
15921,2017-05-01,03L,838,1793,2631,0.3185100722158875
15922,2017-05-01,03M,810,476,1286,0.6298600311041991
15923,2017-05-01,03N,2601,2133,4734,0.5494296577946768
15924,2017-05-01,03Q,1784,1066,2850,0.6259649122807017
15925,2017-05-01,03R,1584,2027,3611,0.43865965106618665
15926,2017-05-01,03T,1562,855,2417,0.6462556888705007
15927,2017-05-01,03V,311,363,674,0.46142433234421365
15928,2017-05-01,03W,1634,1759,3393,0.4815797229590333
15929,2017-05-01,03X,173,423,596,0.2902684563758389
15930,2017-05-01,03Y,345,654,999,0.34534534534534533
15931,2017-05-01,04C,1495,1291,2786,0.5366116295764537
15932,2017-05-01,04D,1220,801,2021,0.6036615536862939
15933,2017-05-01,04E,508,1236,1744,0.29128440366972475
15934,2017-05-01,04F,1159,1280,2439,0.4751947519475195
15935,2017-05-01,04G,2816,3939,6755,0.4168763878608438
15936,2017-05-01,04H,303,754,1057,0.28666035950804164
15937,2017-05-01,04J,1007,2022,3029,0.3324529547705513
15938,2017-05-01,04K,573,1796,2369,0.24187420852680455
15939,2017-05-01,04L,239,921,1160,0.20603448275862069
15940,2017-05-01,04M,148,518,666,0.2222222222222222
15941,2017-05-01,04N,196,761,957,0.20480668756530826
15942,2017-05-01,04Q,684,477,1161,0.5891472868217055
15943,2017-05-01,04R,1311,2516,3827,0.342565978573295
15944,2017-05-01,04V,1881,1650,3531,0.5327102803738317
15945,2017-05-01,04X,915,1734,2649,0.34541336353340885
15946,2017-05-01,04Y,662,643,1305,0.5072796934865901
15947,2017-05-01,05A,1607,2285,3892,0.4128982528263104
15948,2017-05-01,05C,1064,2123,3187,0.33385629118293064
15949,2017-05-01,05D,911,495,1406,0.6479374110953058
15950,2017-05-01,05F,682,1228,1910,0.35706806282722514
15951,2017-05-01,05G,1367,1060,2427,0.5632468067573135
15952,2017-05-01,05H,800,1031,1831,0.4369197160021846
15953,2017-05-01,05J,1060,871,1931,0.5489383738995339
15954,2017-05-01,05L,1908,2332,4240,0.45
15955,2017-05-01,05N,1627,1355,2982,0.54560697518444
15956,2017-05-01,05P,642,1347,1989,0.32277526395173456
15957,2017-05-01,05Q,1140,920,2060,0.5533980582524272
15958,2017-05-01,05R,980,1794,2774,0.35328046142754144
15959,2017-05-01,05T,1519,1621,3140,0.4837579617834395
15960,2017-05-01,05V,804,754,1558,0.5160462130937099
15961,2017-05-01,05W,1451,1268,2719,0.5336520779698418
15962,2017-05-01,05X,661,837,1498,0.44125500667556744
15963,2017-05-01,05Y,1277,1645,2922,0.43702943189596166
15964,2017-05-01,06A,1094,1120,2214,0.4941282746160795
15965,2017-05-01,06D,598,771,1369,0.4368151935719503
15966,2017-05-01,06F,1124,2771,3895,0.28857509627727856
15967,2017-05-01,06H,4858,3540,8398,0.578471064539176
15968,2017-05-01,06K,2630,3440,6070,0.4332784184514003
15969,2017-05-01,06L,2115,1509,3624,0.5836092715231788
15970,2017-05-01,06M,1482,1283,2765,0.5359855334538879
15971,2017-05-01,06N,2445,3376,5821,0.42003092252190344
15972,2017-05-01,06P,677,985,1662,0.4073405535499398
15973,2017-05-01,06Q,2174,1322,3496,0.6218535469107551
15974,2017-05-01,06T,1889,1893,3782,0.4994711792702274
15975,2017-05-01,06V,1148,948,2096,0.5477099236641222
15976,2017-05-01,06W,1348,949,2297,0.586852416195037
15977,2017-05-01,06Y,1139,805,1944,0.5859053497942387
15978,2017-05-01,07G,804,465,1269,0.6335697399527187
15979,2017-05-01,07H,1452,1465,2917,0.4977716832362016
15980,2017-05-01,07J,904,684,1588,0.5692695214105793
15981,2017-05-01,07K,1398,771,2169,0.6445366528354081
15982,2017-05-01,07L,699,443,1142,0.6120840630472855
15983,2017-05-01,07M,1103,1377,2480,0.44475806451612904
15984,2017-05-01,07N,1252,841,2093,0.5981844242713807
15985,2017-05-01,07P,646,931,1577,0.40963855421686746
15986,2017-05-01,07Q,1323,1150,2473,0.5349777598059038
15987,2017-05-01,07R,452,923,1375,0.3287272727272727
15988,2017-05-01,07T,416,1001,1417,0.29357798165137616
15989,2017-05-01,07V,845,1700,2545,0.3320235756385069
15990,2017-05-01,07W,1019,1124,2143,0.4755016332244517
15991,2017-05-01,07X,1004,938,1942,0.5169927909371782
15992,2017-05-01,07Y,823,806,1629,0.5052179251074279
15993,2017-05-01,08A,965,782,1747,0.5523755008586148
15994,2017-05-01,08C,446,789,1235,0.3611336032388664
15995,2017-05-01,08D,615,777,1392,0.4418103448275862
15996,2017-05-01,08E,836,894,1730,0.48323699421965316
15997,2017-05-01,08F,1309,846,2155,0.6074245939675174
15998,2017-05-01,08G,451,1426,1877,0.2402770378263186
15999,2017-05-01,08H,451,1039,1490,0.30268456375838926
16000,2017-05-01,08J,752,721,1473,0.5105227427019687
16001,2017-05-01,08K,802,1121,1923,0.4170566822672907
16002,2017-05-01,08L,704,1158,1862,0.37808807733619765
16003,2017-05-01,08M,1103,760,1863,0.5920558239398819
16004,2017-05-01,08N,1111,712,1823,0.6094349972572682
16005,2017-05-01,08P,893,706,1599,0.5584740462789243
16006,2017-05-01,08Q,581,924,1505,0.386046511627907
16007,2017-05-01,08R,677,632,1309,0.5171886936592819
16008,2017-05-01,08T,655,1075,1730,0.3786127167630058
16009,2017-05-01,08V,1082,1041,2123,0.5096561469618465
16010,2017-05-01,08W,925,800,1725,0.5362318840579711
16011,2017-05-01,08X,1013,1284,2297,0.44101001306051374
16012,2017-05-01,08Y,559,737,1296,0.43132716049382713
16013,2017-05-01,09A,430,918,1348,0.3189910979228487
16014,2017-05-01,09C,665,596,1261,0.5273592386994449
16015,2017-05-01,09D,940,1334,2274,0.4133685136323659
16016,2017-05-01,09E,1207,1051,2258,0.5345438441098317
16017,2017-05-01,09F,745,1147,1892,0.3937632135306554
16018,2017-05-01,09G,3124,2230,5354,0.5834889802017184
16019,2017-05-01,09H,478,394,872,0.5481651376146789
16020,2017-05-01,09J,1416,1254,2670,0.5303370786516854
16021,2017-05-01,09L,625,829,1454,0.4298486932599725
16022,2017-05-01,09N,769,1047,1816,0.42345814977973567
16023,2017-05-01,09P,624,1274,1898,0.3287671232876712
16024,2017-05-01,09W,1262,1012,2274,0.5549692172383466
16025,2017-05-01,09X,864,1038,1902,0.45425867507886436
16026,2017-05-01,09Y,813,2002,2815,0.288809946714032
16027,2017-05-01,10A,994,1009,2003,0.4962556165751373
16028,2017-05-01,10C,410,425,835,0.49101796407185627
16029,2017-05-01,10D,577,536,1113,0.518418688230009
16030,2017-05-01,10E,617,683,1300,0.4746153846153846
16031,2017-05-01,10G,348,813,1161,0.2997416020671835
16032,2017-05-01,10H,1113,2104,3217,0.34597451041342864
16033,2017-05-01,10J,820,1046,1866,0.43944265809217575
16034,2017-05-01,10K,1061,851,1912,0.5549163179916318
16035,2017-05-01,10L,865,722,1587,0.5450535601764335
16036,2017-05-01,10M,292,573,865,0.3375722543352601
16037,2017-05-01,10N,264,624,888,0.2972972972972973
16038,2017-05-01,10Q,3069,3157,6226,0.4929328621908127
16039,2017-05-01,10R,1223,790,2013,0.6075509190263289
16040,2017-05-01,10T,379,603,982,0.3859470468431772
16041,2017-05-01,10V,1133,763,1896,0.5975738396624473
16042,2017-05-01,10W,378,684,1062,0.3559322033898305
16043,2017-05-01,10X,1112,883,1995,0.5573934837092732
16044,2017-05-01,10Y,840,1407,2247,0.37383177570093457
16045,2017-05-01,11A,2653,2170,4823,0.5500725689404935
16046,2017-05-01,11C,547,842,1389,0.3938084953203744
16047,2017-05-01,11D,548,695,1243,0.44086886564762673
16048,2017-05-01,11E,734,1084,1818,0.40374037403740376
16049,2017-05-01,11H,2192,1895,4087,0.536334719843406
16050,2017-05-01,11J,3679,4320,7999,0.45993249156144517
16051,2017-05-01,11M,3504,2421,5925,0.5913924050632912
16052,2017-05-01,11N,2390,3419,5809,0.4114305388190739
16053,2017-05-01,11T,1271,1075,2346,0.5417732310315431
16054,2017-05-01,11X,2290,2304,4594,0.49847627340008704
16055,2017-05-01,12A,1256,1058,2314,0.5427830596369922
16056,2017-05-01,12D,917,1099,2016,0.4548611111111111
16057,2017-05-01,12F,1704,1856,3560,0.4786516853932584
16058,2017-05-01,13P,1817,3742,5559,0.32685734844396475
16059,2017-05-01,13T,2192,2322,4514,0.48560035445281347
16060,2017-05-01,14L,2428,2296,4724,0.5139712108382727
16061,2017-05-01,99A,1706,2246,3952,0.4316801619433198
16062,2017-05-01,99C,1313,943,2256,0.5820035460992907
16063,2017-05-01,99D,976,966,1942,0.5025746652935118
16064,2017-05-01,99E,1564,779,2343,0.6675202731540759
16065,2017-05-01,99F,1019,541,1560,0.6532051282051282
16066,2017-05-01,99G,770,576,1346,0.5720653789004457
16067,2017-05-01,99H,1065,1645,2710,0.3929889298892989
16068,2017-05-01,99J,2566,2047,4613,0.5562540646000433
16069,2017-05-01,99K,706,970,1676,0.4212410501193317
16070,2017-05-01,99M,832,1144,1976,0.42105263157894735
16071,2017-05-01,99N,2550,2629,5179,0.49237304498938017
16072,2017-05-01,99P,4932,3802,8734,0.5646897183421112
16073,2017-05-01,99Q,1668,1184,2852,0.5848527349228612
16074,2017-06-01,00C,565,552,1117,0.5058191584601611
16075,2017-06-01,00D,1154,1984,3138,0.36775015933715743
16076,2017-06-01,00J,1047,1437,2484,0.4214975845410628
16077,2017-06-01,00K,1238,1480,2718,0.4554819720382634
16078,2017-06-01,00L,1433,2191,3624,0.3954194260485651
16079,2017-06-01,00M,1433,1600,3033,0.47246950214309263
16080,2017-06-01,00N,998,847,1845,0.5409214092140922
16081,2017-06-01,00P,1402,1564,2966,0.4726904922454484
16082,2017-06-01,00Q,588,800,1388,0.42363112391930835
16083,2017-06-01,00R,820,954,1774,0.46223224351747466
16084,2017-06-01,00T,1612,1306,2918,0.5524331734064428
16085,2017-06-01,00V,798,1190,1988,0.4014084507042254
16086,2017-06-01,00X,799,737,1536,0.5201822916666666
16087,2017-06-01,00Y,1310,1386,2696,0.48590504451038574
16088,2017-06-01,01A,1414,2033,3447,0.41021177835799244
16089,2017-06-01,01C,544,1084,1628,0.33415233415233414
16090,2017-06-01,01D,817,1134,1951,0.4187596104561763
16091,2017-06-01,01E,830,776,1606,0.5168119551681195
16092,2017-06-01,01F,696,696,1392,0.5
16093,2017-06-01,01G,1067,1428,2495,0.4276553106212425
16094,2017-06-01,01H,1852,1430,3282,0.5642900670322973
16095,2017-06-01,01J,765,960,1725,0.4434782608695652
16096,2017-06-01,01K,1444,1874,3318,0.43520192887281495
16097,2017-06-01,01R,499,890,1389,0.3592512598992081
16098,2017-06-01,01T,549,816,1365,0.4021978021978022
16099,2017-06-01,01V,564,707,1271,0.4437450826121164
16100,2017-06-01,01W,1676,1308,2984,0.561662198391421
16101,2017-06-01,01X,1146,1238,2384,0.48070469798657717
16102,2017-06-01,01Y,514,1519,2033,0.2528283325135268
16103,2017-06-01,02A,884,1070,1954,0.4524053224155578
16104,2017-06-01,02D,280,567,847,0.3305785123966942
16105,2017-06-01,02E,718,988,1706,0.4208675263774912
16106,2017-06-01,02F,1003,1364,2367,0.42374313476975073
16107,2017-06-01,02G,522,519,1041,0.5014409221902018
16108,2017-06-01,02H,1387,1736,3123,0.4441242395132885
16109,2017-06-01,02M,692,904,1596,0.43358395989974935
16110,2017-06-01,02N,611,1046,1657,0.3687386843693422
16111,2017-06-01,02P,931,1676,2607,0.35711545838128117
16112,2017-06-01,02Q,384,763,1147,0.33478639930252835
16113,2017-06-01,02R,1747,1314,3061,0.5707285200914733
16114,2017-06-01,02T,972,1108,2080,0.4673076923076923
16115,2017-06-01,02V,562,1249,1811,0.3103257868580895
16116,2017-06-01,02W,492,394,886,0.5553047404063205
16117,2017-06-01,02X,1267,1660,2927,0.432866416125726
16118,2017-06-01,02Y,1874,1126,3000,0.6246666666666667
16119,2017-06-01,03A,1285,1045,2330,0.5515021459227468
16120,2017-06-01,03C,742,1911,2653,0.2796833773087071
16121,2017-06-01,03D,462,887,1349,0.3424759080800593
16122,2017-06-01,03E,600,703,1303,0.4604758250191865
16123,2017-06-01,03F,1581,958,2539,0.6226860968885388
16124,2017-06-01,03G,695,1679,2374,0.2927548441449031
16125,2017-06-01,03H,1127,520,1647,0.684274438372799
16126,2017-06-01,03J,1019,781,1800,0.5661111111111111
16127,2017-06-01,03K,892,546,1438,0.6203059805285118
16128,2017-06-01,03L,760,1802,2562,0.2966432474629196
16129,2017-06-01,03M,750,537,1287,0.5827505827505828
16130,2017-06-01,03N,2633,2171,4804,0.5480849292256453
16131,2017-06-01,03Q,1586,1353,2939,0.5396393331064988
16132,2017-06-01,03R,1562,2061,3623,0.4311344189897875
16133,2017-06-01,03T,1779,952,2731,0.6514097400219699
16134,2017-06-01,03V,343,383,726,0.4724517906336088
16135,2017-06-01,03W,1340,2006,3346,0.4004781829049611
16136,2017-06-01,03X,161,521,682,0.23607038123167157
16137,2017-06-01,03Y,421,801,1222,0.3445171849427169
16138,2017-06-01,04C,1330,1316,2646,0.5026455026455027
16139,2017-06-01,04D,1273,804,2077,0.6129032258064516
16140,2017-06-01,04E,484,1318,1802,0.2685904550499445
16141,2017-06-01,04F,1089,1336,2425,0.4490721649484536
16142,2017-06-01,04G,2712,4202,6914,0.3922476135377495
16143,2017-06-01,04H,297,833,1130,0.2628318584070796
16144,2017-06-01,04J,1033,2155,3188,0.3240276035131744
16145,2017-06-01,04K,597,1845,2442,0.24447174447174447
16146,2017-06-01,04L,217,956,1173,0.18499573742540495
16147,2017-06-01,04M,140,511,651,0.21505376344086022
16148,2017-06-01,04N,201,779,980,0.20510204081632652
16149,2017-06-01,04Q,742,543,1285,0.5774319066147859
16150,2017-06-01,04R,1283,2867,4150,0.3091566265060241
16151,2017-06-01,04V,1683,1942,3625,0.46427586206896554
16152,2017-06-01,04X,904,1736,2640,0.3424242424242424
16153,2017-06-01,04Y,744,724,1468,0.5068119891008175
16154,2017-06-01,05A,1628,2505,4133,0.393902734091459
16155,2017-06-01,05C,1007,2218,3225,0.31224806201550387
16156,2017-06-01,05D,865,534,1399,0.6182987848463188
16157,2017-06-01,05F,664,1221,1885,0.3522546419098143
16158,2017-06-01,05G,1334,1024,2358,0.5657336726039016
16159,2017-06-01,05H,765,1065,1830,0.4180327868852459
16160,2017-06-01,05J,893,1095,1988,0.4491951710261569
16161,2017-06-01,05L,1989,2312,4301,0.4624505928853755
16162,2017-06-01,05N,1713,1405,3118,0.5493906350224503
16163,2017-06-01,05P,667,1391,2058,0.3241010689990282
16164,2017-06-01,05Q,1181,1006,2187,0.5400091449474166
16165,2017-06-01,05R,1011,1904,2915,0.34682675814751285
16166,2017-06-01,05T,1438,1914,3352,0.42899761336515513
16167,2017-06-01,05V,763,870,1633,0.4672382118799755
16168,2017-06-01,05W,1430,1223,2653,0.5390124387485865
16169,2017-06-01,05X,712,954,1666,0.42737094837935174
16170,2017-06-01,05Y,1200,1670,2870,0.4181184668989547
16171,2017-06-01,06A,1141,1243,2384,0.4786073825503356
16172,2017-06-01,06D,560,779,1339,0.41822255414488424
16173,2017-06-01,06F,1119,2884,4003,0.2795403447414439
16174,2017-06-01,06H,4732,3561,8293,0.5706017122874714
16175,2017-06-01,06K,2457,3662,6119,0.4015361987252819
16176,2017-06-01,06L,2087,1620,3707,0.5629889398435393
16177,2017-06-01,06M,1377,1461,2838,0.48520084566596194
16178,2017-06-01,06N,2130,3630,5760,0.3697916666666667
16179,2017-06-01,06P,655,956,1611,0.4065797641216636
16180,2017-06-01,06Q,2200,1450,3650,0.6027397260273972
16181,2017-06-01,06T,1956,1932,3888,0.5030864197530864
16182,2017-06-01,06V,1144,953,2097,0.5455412494039104
16183,2017-06-01,06W,1363,867,2230,0.6112107623318386
16184,2017-06-01,06Y,1212,762,1974,0.6139817629179332
16185,2017-06-01,07G,813,474,1287,0.6317016317016317
16186,2017-06-01,07H,1344,1651,2995,0.44874791318864776
16187,2017-06-01,07J,947,720,1667,0.5680863827234554
16188,2017-06-01,07K,1390,778,2168,0.6411439114391144
16189,2017-06-01,07L,603,593,1196,0.504180602006689
16190,2017-06-01,07M,1011,1356,2367,0.42712294043092525
16191,2017-06-01,07N,1382,891,2273,0.6080070391553014
16192,2017-06-01,07P,599,893,1492,0.4014745308310992
16193,2017-06-01,07Q,1047,1436,2483,0.4216673378977044
16194,2017-06-01,07R,455,960,1415,0.3215547703180212
16195,2017-06-01,07T,412,1001,1413,0.2915782024062279
16196,2017-06-01,07V,809,1817,2626,0.3080731150038081
16197,2017-06-01,07W,808,1259,2067,0.39090469279148526
16198,2017-06-01,07X,962,1013,1975,0.4870886075949367
16199,2017-06-01,07Y,749,885,1634,0.4583843329253366
16200,2017-06-01,08A,811,873,1684,0.4815914489311164
16201,2017-06-01,08C,399,783,1182,0.33756345177664976
16202,2017-06-01,08D,579,806,1385,0.4180505415162455
16203,2017-06-01,08E,829,939,1768,0.4688914027149321
16204,2017-06-01,08F,1202,853,2055,0.5849148418491484
16205,2017-06-01,08G,446,1401,1847,0.24147265836491608
16206,2017-06-01,08H,405,1014,1419,0.2854122621564482
16207,2017-06-01,08J,721,709,1430,0.5041958041958042
16208,2017-06-01,08K,770,1198,1968,0.391260162601626
16209,2017-06-01,08L,661,1220,1881,0.3514088250930356
16210,2017-06-01,08M,823,979,1802,0.4567147613762486
16211,2017-06-01,08N,1099,719,1818,0.6045104510451045
16212,2017-06-01,08P,904,711,1615,0.5597523219814241
16213,2017-06-01,08Q,526,1061,1587,0.3314429741650914
16214,2017-06-01,08R,625,614,1239,0.5044390637610977
16215,2017-06-01,08T,603,1064,1667,0.36172765446910615
16216,2017-06-01,08V,892,1096,1988,0.448692152917505
16217,2017-06-01,08W,817,794,1611,0.5071384233395406
16218,2017-06-01,08X,986,1345,2331,0.42299442299442297
16219,2017-06-01,08Y,463,818,1281,0.36143637782982047
16220,2017-06-01,09A,367,888,1255,0.29243027888446216
16221,2017-06-01,09C,543,674,1217,0.44617912900575185
16222,2017-06-01,09D,917,1488,2405,0.3812889812889813
16223,2017-06-01,09E,1192,1117,2309,0.516240796881767
16224,2017-06-01,09F,720,1354,2074,0.3471552555448409
16225,2017-06-01,09G,3251,2251,5502,0.5908760450745184
16226,2017-06-01,09H,490,404,894,0.5480984340044742
16227,2017-06-01,09J,1510,1270,2780,0.5431654676258992
16228,2017-06-01,09L,628,865,1493,0.420629604822505
16229,2017-06-01,09N,713,1094,1807,0.3945766463752075
16230,2017-06-01,09P,561,1387,1948,0.2879876796714579
16231,2017-06-01,09W,1217,1059,2276,0.5347100175746925
16232,2017-06-01,09X,903,1077,1980,0.45606060606060606
16233,2017-06-01,09Y,750,2031,2781,0.2696871628910464
16234,2017-06-01,10A,1026,1026,2052,0.5
16235,2017-06-01,10C,410,471,881,0.46538024971623154
16236,2017-06-01,10D,492,611,1103,0.4460562103354488
16237,2017-06-01,10E,566,690,1256,0.45063694267515925
16238,2017-06-01,10G,311,772,1083,0.2871652816251154
16239,2017-06-01,10H,985,2228,3213,0.30656707127295363
16240,2017-06-01,10J,810,1252,2062,0.39282250242483024
16241,2017-06-01,10K,960,984,1944,0.49382716049382713
16242,2017-06-01,10L,924,707,1631,0.5665236051502146
16243,2017-06-01,10M,263,650,913,0.28806133625410735
16244,2017-06-01,10N,300,652,952,0.31512605042016806
16245,2017-06-01,10Q,3003,3467,6470,0.4641421947449768
16246,2017-06-01,10R,1153,799,1952,0.5906762295081968
16247,2017-06-01,10T,365,668,1033,0.35333978702807356
16248,2017-06-01,10V,1168,886,2054,0.5686465433300877
16249,2017-06-01,10W,297,715,1012,0.29347826086956524
16250,2017-06-01,10X,1144,850,1994,0.5737211634904714
16251,2017-06-01,10Y,734,1487,2221,0.3304817649707339
16252,2017-06-01,11A,2736,2330,5066,0.5400710619818397
16253,2017-06-01,11C,535,851,1386,0.386002886002886
16254,2017-06-01,11D,548,768,1316,0.41641337386018235
16255,2017-06-01,11E,767,1208,1975,0.3883544303797468
16256,2017-06-01,11H,2011,2077,4088,0.4919275929549902
16257,2017-06-01,11J,3441,4549,7990,0.43066332916145184
16258,2017-06-01,11M,3082,2830,5912,0.5213125845737483
16259,2017-06-01,11N,2343,3384,5727,0.40911471974855945
16260,2017-06-01,11T,1254,1118,2372,0.5286677908937606
16261,2017-06-01,11X,2118,2484,4602,0.4602346805736636
16262,2017-06-01,12A,1268,1135,2403,0.5276737411568873
16263,2017-06-01,12D,856,1196,2052,0.4171539961013645
16264,2017-06-01,12F,1785,2050,3835,0.4654498044328553
16265,2017-06-01,13P,1758,3900,5658,0.3107104984093319
16266,2017-06-01,13T,1728,2918,4646,0.3719328454584589
16267,2017-06-01,14L,2471,2386,4857,0.5087502573605106
16268,2017-06-01,99A,1715,2448,4163,0.41196252702378094
16269,2017-06-01,99C,1162,1157,2319,0.5010780508840017
16270,2017-06-01,99D,990,983,1973,0.501773948302078
16271,2017-06-01,99E,1561,795,2356,0.6625636672325976
16272,2017-06-01,99F,1013,681,1694,0.5979929161747344
16273,2017-06-01,99G,753,613,1366,0.5512445095168375
16274,2017-06-01,99H,944,1774,2718,0.34731420161883736
16275,2017-06-01,99J,2541,2351,4892,0.5194194603434178
16276,2017-06-01,99K,727,1026,1753,0.414717626925271
16277,2017-06-01,99M,794,1281,2075,0.38265060240963855
16278,2017-06-01,99N,2547,2817,5364,0.4748322147651007
16279,2017-06-01,99P,4870,4242,9112,0.5344600526777875
16280,2017-06-01,99Q,1655,1195,2850,0.5807017543859649
16281,2017-07-01,00C,493,777,1270,0.38818897637795274
16282,2017-07-01,00D,1061,2201,3262,0.3252605763335377
16283,2017-07-01,00J,914,1451,2365,0.3864693446088795
16284,2017-07-01,00K,996,1648,2644,0.3767019667170953
16285,2017-07-01,00L,1304,2317,3621,0.36012151339409004
16286,2017-07-01,00M,1256,1745,3001,0.4185271576141286
16287,2017-07-01,00N,761,983,1744,0.4363532110091743
16288,2017-07-01,00P,1243,1573,2816,0.44140625
16289,2017-07-01,00Q,641,886,1527,0.4197773411918795
16290,2017-07-01,00R,838,956,1794,0.46711259754738016
16291,2017-07-01,00T,1642,1297,2939,0.558693433140524
16292,2017-07-01,00V,811,1202,2013,0.40288127173373073
16293,2017-07-01,00X,756,766,1522,0.4967148488830486
16294,2017-07-01,00Y,1277,1559,2836,0.4502820874471086
16295,2017-07-01,01A,1330,2064,3394,0.3918680023571008
16296,2017-07-01,01C,468,1143,1611,0.2905027932960894
16297,2017-07-01,01D,790,1180,1970,0.4010152284263959
16298,2017-07-01,01E,760,734,1494,0.5087014725568942
16299,2017-07-01,01F,605,756,1361,0.44452608376193975
16300,2017-07-01,01G,1125,1412,2537,0.4434371304690579
16301,2017-07-01,01H,1568,1765,3333,0.47044704470447046
16302,2017-07-01,01J,719,957,1676,0.42899761336515513
16303,2017-07-01,01K,1417,1989,3406,0.41603053435114506
16304,2017-07-01,01R,434,911,1345,0.3226765799256506
16305,2017-07-01,01T,534,810,1344,0.39732142857142855
16306,2017-07-01,01V,542,711,1253,0.432561851556265
16307,2017-07-01,01W,1542,1466,3008,0.5126329787234043
16308,2017-07-01,01X,1097,1317,2414,0.4544324772162386
16309,2017-07-01,01Y,441,1686,2127,0.2073342736248237
16310,2017-07-01,02A,826,1140,1966,0.4201424211597152
16311,2017-07-01,02D,236,571,807,0.29244114002478316
16312,2017-07-01,02E,730,1134,1864,0.3916309012875536
16313,2017-07-01,02F,983,1494,2477,0.39685102947113443
16314,2017-07-01,02G,523,472,995,0.5256281407035176
16315,2017-07-01,02H,1299,2035,3334,0.38962207558488304
16316,2017-07-01,02M,669,975,1644,0.40693430656934304
16317,2017-07-01,02N,598,1013,1611,0.3711980136561142
16318,2017-07-01,02P,914,1725,2639,0.3463433118605532
16319,2017-07-01,02Q,414,747,1161,0.35658914728682173
16320,2017-07-01,02R,1765,1371,3136,0.5628188775510204
16321,2017-07-01,02T,1064,1126,2190,0.4858447488584475
16322,2017-07-01,02V,546,1273,1819,0.3001649257833975
16323,2017-07-01,02W,474,385,859,0.5518044237485448
16324,2017-07-01,02X,1367,1607,2974,0.4596503026227303
16325,2017-07-01,02Y,1818,1179,2997,0.6066066066066066
16326,2017-07-01,03A,1163,984,2147,0.5416860735910572
16327,2017-07-01,03C,691,1869,2560,0.269921875
16328,2017-07-01,03D,448,850,1298,0.34514637904468415
16329,2017-07-01,03E,543,763,1306,0.41577335375191427
16330,2017-07-01,03F,1462,936,2398,0.609674728940784
16331,2017-07-01,03G,667,1635,2302,0.289748045178106
16332,2017-07-01,03H,1163,525,1688,0.6889810426540285
16333,2017-07-01,03J,950,802,1752,0.5422374429223744
16334,2017-07-01,03K,879,570,1449,0.6066252587991718
16335,2017-07-01,03L,786,1781,2567,0.30619400077911957
16336,2017-07-01,03M,677,600,1277,0.5301487862176977
16337,2017-07-01,03N,2469,2685,5154,0.4790454016298021
16338,2017-07-01,03Q,1469,1519,2988,0.4916331994645248
16339,2017-07-01,03R,1535,2153,3688,0.41621475054229934
16340,2017-07-01,03T,1651,1025,2676,0.616965620328849
16341,2017-07-01,03V,333,414,747,0.4457831325301205
16342,2017-07-01,03W,1370,2045,3415,0.4011713030746706
16343,2017-07-01,03X,152,529,681,0.22320117474302498
16344,2017-07-01,03Y,401,779,1180,0.3398305084745763
16345,2017-07-01,04C,1308,1529,2837,0.4610504053577723
16346,2017-07-01,04D,1250,862,2112,0.5918560606060606
16347,2017-07-01,04E,494,1440,1934,0.25542916235780766
16348,2017-07-01,04F,935,1601,2536,0.36869085173501576
16349,2017-07-01,04G,2627,4312,6939,0.3785848104914253
16350,2017-07-01,04H,339,860,1199,0.2827356130108424
16351,2017-07-01,04J,1011,2372,3383,0.2988471770617795
16352,2017-07-01,04K,555,1845,2400,0.23125
16353,2017-07-01,04L,219,940,1159,0.18895599654874892
16354,2017-07-01,04M,132,542,674,0.19584569732937684
16355,2017-07-01,04N,181,744,925,0.19567567567567568
16356,2017-07-01,04Q,707,484,1191,0.5936188077246012
16357,2017-07-01,04R,1165,3085,4250,0.2741176470588235
16358,2017-07-01,04V,1355,2136,3491,0.38814093382984816
16359,2017-07-01,04X,963,1871,2834,0.33980239943542695
16360,2017-07-01,04Y,736,660,1396,0.5272206303724928
16361,2017-07-01,05A,1434,2613,4047,0.3543365455893254
16362,2017-07-01,05C,1009,2256,3265,0.3090352220520674
16363,2017-07-01,05D,872,528,1400,0.6228571428571429
16364,2017-07-01,05F,671,1255,1926,0.34839044652128764
16365,2017-07-01,05G,1251,1030,2281,0.5484436650591845
16366,2017-07-01,05H,773,1107,1880,0.41117021276595744
16367,2017-07-01,05J,818,1294,2112,0.3873106060606061
16368,2017-07-01,05L,1797,2395,4192,0.4286736641221374
16369,2017-07-01,05N,1746,1363,3109,0.5615953682856224
16370,2017-07-01,05P,644,1393,2037,0.3161512027491409
16371,2017-07-01,05Q,1104,1009,2113,0.522479886417416
16372,2017-07-01,05R,949,1979,2928,0.3241120218579235
16373,2017-07-01,05T,1337,1930,3267,0.40924395469850017
16374,2017-07-01,05V,744,835,1579,0.47118429385687144
16375,2017-07-01,05W,1505,1150,2655,0.5668549905838042
16376,2017-07-01,05X,721,853,1574,0.45806861499364676
16377,2017-07-01,05Y,1246,1673,2919,0.42685851318944845
16378,2017-07-01,06A,1036,1185,2221,0.4664565511031067
16379,2017-07-01,06D,506,813,1319,0.38362395754359363
16380,2017-07-01,06F,1055,2895,3950,0.2670886075949367
16381,2017-07-01,06H,4392,3795,8187,0.5364602418468304
16382,2017-07-01,06K,2385,3875,6260,0.38099041533546324
16383,2017-07-01,06L,1885,1809,3694,0.510286951813752
16384,2017-07-01,06M,1369,1401,2770,0.4942238267148014
16385,2017-07-01,06N,2085,3668,5753,0.36241960716148097
16386,2017-07-01,06P,682,976,1658,0.41133896260554886
16387,2017-07-01,06Q,2096,1440,3536,0.5927601809954751
16388,2017-07-01,06T,1904,2072,3976,0.4788732394366197
16389,2017-07-01,06V,1178,978,2156,0.5463821892393321
16390,2017-07-01,06W,1333,1023,2356,0.5657894736842105
16391,2017-07-01,06Y,1237,899,2136,0.579119850187266
16392,2017-07-01,07G,783,458,1241,0.6309427880741337
16393,2017-07-01,07H,1238,1735,2973,0.4164143962327615
16394,2017-07-01,07J,986,810,1796,0.5489977728285078
16395,2017-07-01,07K,1440,800,2240,0.6428571428571429
16396,2017-07-01,07L,548,631,1179,0.46480067854113655
16397,2017-07-01,07M,1064,1470,2534,0.4198895027624309
16398,2017-07-01,07N,1364,977,2341,0.5826569841947885
16399,2017-07-01,07P,544,1017,1561,0.3484945547725817
16400,2017-07-01,07Q,978,1511,2489,0.3929288871032543
16401,2017-07-01,07R,439,1025,1464,0.2998633879781421
16402,2017-07-01,07T,389,1034,1423,0.2733661278988053
16403,2017-07-01,07V,693,2045,2738,0.2531044558071585
16404,2017-07-01,07W,749,1430,2179,0.343735658558972
16405,2017-07-01,07X,919,1089,2008,0.45766932270916333
16406,2017-07-01,07Y,576,944,1520,0.37894736842105264
16407,2017-07-01,08A,675,967,1642,0.4110840438489647
16408,2017-07-01,08C,394,892,1286,0.30637636080870917
16409,2017-07-01,08D,560,879,1439,0.3891591382904795
16410,2017-07-01,08E,767,926,1693,0.45304193738924986
16411,2017-07-01,08F,1130,1077,2207,0.5120072496601722
16412,2017-07-01,08G,439,1484,1923,0.22828913156526262
16413,2017-07-01,08H,400,1047,1447,0.27643400138217
16414,2017-07-01,08J,725,781,1506,0.4814077025232404
16415,2017-07-01,08K,649,1274,1923,0.3374934997399896
16416,2017-07-01,08L,699,1317,2016,0.34672619047619047
16417,2017-07-01,08M,722,1243,1965,0.36743002544529263
16418,2017-07-01,08N,978,918,1896,0.5158227848101266
16419,2017-07-01,08P,797,870,1667,0.47810437912417514
16420,2017-07-01,08Q,420,1006,1426,0.29453015427769985
16421,2017-07-01,08R,709,699,1408,0.5035511363636364
16422,2017-07-01,08T,640,1123,1763,0.3630175836642087
16423,2017-07-01,08V,852,1188,2040,0.4176470588235294
16424,2017-07-01,08W,681,1118,1799,0.37854363535297386
16425,2017-07-01,08X,905,1505,2410,0.3755186721991701
16426,2017-07-01,08Y,435,853,1288,0.33773291925465837
16427,2017-07-01,09A,415,1047,1462,0.28385772913816687
16428,2017-07-01,09C,549,705,1254,0.43779904306220097
16429,2017-07-01,09D,816,1475,2291,0.3561763422086425
16430,2017-07-01,09E,1097,1142,2239,0.4899508709245199
16431,2017-07-01,09F,616,1427,2043,0.30151737640724424
16432,2017-07-01,09G,3260,2349,5609,0.581208771617044
16433,2017-07-01,09H,492,418,910,0.5406593406593406
16434,2017-07-01,09J,1450,1258,2708,0.5354505169867061
16435,2017-07-01,09L,609,884,1493,0.40790354989953115
16436,2017-07-01,09N,707,1084,1791,0.39475153545505304
16437,2017-07-01,09P,423,1417,1840,0.2298913043478261
16438,2017-07-01,09W,1233,1088,2321,0.5312365359758725
16439,2017-07-01,09X,888,1027,1915,0.4637075718015666
16440,2017-07-01,09Y,772,2230,3002,0.25716189207195206
16441,2017-07-01,10A,898,1145,2043,0.43954968184043075
16442,2017-07-01,10C,395,496,891,0.44332210998877664
16443,2017-07-01,10D,501,639,1140,0.4394736842105263
16444,2017-07-01,10E,599,737,1336,0.44835329341317365
16445,2017-07-01,10G,272,854,1126,0.24156305506216696
16446,2017-07-01,10H,871,2347,3218,0.2706650093225606
16447,2017-07-01,10J,752,1301,2053,0.36629322942036047
16448,2017-07-01,10K,899,1052,1951,0.46078933880061507
16449,2017-07-01,10L,1009,789,1798,0.5611790878754171
16450,2017-07-01,10M,247,670,917,0.2693565976008724
16451,2017-07-01,10N,254,678,932,0.27253218884120173
16452,2017-07-01,10Q,2899,3882,6781,0.42751806518212654
16453,2017-07-01,10R,1192,879,2071,0.5755673587638822
16454,2017-07-01,10T,367,709,1076,0.34107806691449816
16455,2017-07-01,10V,1000,1026,2026,0.49358341559723595
16456,2017-07-01,10W,242,732,974,0.24845995893223818
16457,2017-07-01,10X,1104,971,2075,0.5320481927710843
16458,2017-07-01,10Y,649,1557,2206,0.2941976427923844
16459,2017-07-01,11A,2820,2380,5200,0.5423076923076923
16460,2017-07-01,11C,456,911,1367,0.3335771762984638
16461,2017-07-01,11D,529,775,1304,0.40567484662576686
16462,2017-07-01,11E,716,1158,1874,0.3820704375667022
16463,2017-07-01,11H,1965,2089,4054,0.4847064627528367
16464,2017-07-01,11J,3194,4844,8038,0.3973625279920378
16465,2017-07-01,11M,2959,3090,6049,0.48917176392792194
16466,2017-07-01,11N,2362,3622,5984,0.3947192513368984
16467,2017-07-01,11T,1133,1163,2296,0.49346689895470386
16468,2017-07-01,11X,2049,2559,4608,0.4446614583333333
16469,2017-07-01,12A,1226,1095,2321,0.5282205945713054
16470,2017-07-01,12D,801,1273,2074,0.3862102217936355
16471,2017-07-01,12F,1685,1980,3665,0.4597544338335607
16472,2017-07-01,13P,1850,3918,5768,0.3207350901525659
16473,2017-07-01,13T,1625,2923,4548,0.35729991204925243
16474,2017-07-01,14L,2391,2418,4809,0.49719276356830944
16475,2017-07-01,99A,1637,2282,3919,0.41770859913243175
16476,2017-07-01,99C,957,1342,2299,0.41626794258373206
16477,2017-07-01,99D,967,1014,1981,0.48813730439172137
16478,2017-07-01,99E,1687,810,2497,0.6756107328794554
16479,2017-07-01,99F,938,606,1544,0.6075129533678757
16480,2017-07-01,99G,746,615,1361,0.5481263776634827
16481,2017-07-01,99H,913,1866,2779,0.32853544440446203
16482,2017-07-01,99J,2516,2384,4900,0.5134693877551021
16483,2017-07-01,99K,689,1063,1752,0.3932648401826484
16484,2017-07-01,99M,761,1232,1993,0.3818364274962368
16485,2017-07-01,99N,2397,3042,5439,0.44070601213458355
16486,2017-07-01,99P,4618,4725,9343,0.4942737878625709
16487,2017-07-01,99Q,1645,1338,2983,0.5514582634931278
16488,2017-08-01,00C,455,743,1198,0.3797996661101836
16489,2017-08-01,00D,992,2334,3326,0.29825616355983164
16490,2017-08-01,00J,891,1560,2451,0.3635250917992656
16491,2017-08-01,00K,1008,1684,2692,0.37444279346210996
16492,2017-08-01,00L,1328,2493,3821,0.3475529965977493
16493,2017-08-01,00M,1296,1949,3245,0.39938366718027735
16494,2017-08-01,00N,773,1081,1854,0.41693635382955774
16495,2017-08-01,00P,1210,1847,3057,0.39581288845273144
16496,2017-08-01,00Q,554,929,1483,0.3735670937289278
16497,2017-08-01,00R,803,996,1799,0.4463590883824347
16498,2017-08-01,00T,1636,1370,3006,0.5442448436460412
16499,2017-08-01,00V,711,1267,1978,0.35945399393326594
16500,2017-08-01,00X,732,807,1539,0.4756335282651072
16501,2017-08-01,00Y,1200,1717,2917,0.411381556393555
16502,2017-08-01,01A,1279,2255,3534,0.3619128466327108
16503,2017-08-01,01C,386,1208,1594,0.24215809284818068
16504,2017-08-01,01D,729,1307,2036,0.3580550098231827
16505,2017-08-01,01E,743,814,1557,0.47719974309569685
16506,2017-08-01,01F,577,787,1364,0.42302052785923755
16507,2017-08-01,01G,1069,1595,2664,0.40127627627627627
16508,2017-08-01,01H,1367,2116,3483,0.39247774906689636
16509,2017-08-01,01J,764,1039,1803,0.42373821408763174
16510,2017-08-01,01K,1450,2100,3550,0.4084507042253521
16511,2017-08-01,01R,433,1050,1483,0.29197572488199597
16512,2017-08-01,01T,557,849,1406,0.3961593172119488
16513,2017-08-01,01V,557,836,1393,0.39985642498205315
16514,2017-08-01,01W,1472,1510,2982,0.4936284372904091
16515,2017-08-01,01X,1087,1419,2506,0.4337589784517159
16516,2017-08-01,01Y,424,1637,2061,0.2057253760310529
16517,2017-08-01,02A,883,1189,2072,0.42615830115830117
16518,2017-08-01,02D,251,644,895,0.28044692737430166
16519,2017-08-01,02E,719,1091,1810,0.39723756906077345
16520,2017-08-01,02F,938,1490,2428,0.38632619439868204
16521,2017-08-01,02G,504,469,973,0.5179856115107914
16522,2017-08-01,02H,1065,2074,3139,0.33928002548582353
16523,2017-08-01,02M,626,998,1624,0.3854679802955665
16524,2017-08-01,02N,617,1068,1685,0.3661721068249258
16525,2017-08-01,02P,855,1848,2703,0.316315205327414
16526,2017-08-01,02Q,407,824,1231,0.330625507717303
16527,2017-08-01,02R,1671,1372,3043,0.5491291488662504
16528,2017-08-01,02T,976,1104,2080,0.46923076923076923
16529,2017-08-01,02V,524,1321,1845,0.2840108401084011
16530,2017-08-01,02W,436,418,854,0.5105386416861827
16531,2017-08-01,02X,1267,1661,2928,0.4327185792349727
16532,2017-08-01,02Y,1881,1344,3225,0.5832558139534884
16533,2017-08-01,03A,1122,1198,2320,0.4836206896551724
16534,2017-08-01,03C,606,2047,2653,0.2284206558612891
16535,2017-08-01,03D,509,990,1499,0.33955970647098066
16536,2017-08-01,03E,601,778,1379,0.43582306018854244
16537,2017-08-01,03F,1409,1056,2465,0.5716024340770791
16538,2017-08-01,03G,621,1677,2298,0.27023498694516973
16539,2017-08-01,03H,1141,612,1753,0.6508841985168283
16540,2017-08-01,03J,912,837,1749,0.5214408233276158
16541,2017-08-01,03K,892,541,1433,0.6224703419399861
16542,2017-08-01,03L,785,1711,2496,0.3145032051282051
16543,2017-08-01,03M,786,670,1456,0.5398351648351648
16544,2017-08-01,03N,2389,2751,5140,0.46478599221789885
16545,2017-08-01,03Q,1365,1681,3046,0.4481286933683519
16546,2017-08-01,03R,1465,2303,3768,0.3888004246284501
16547,2017-08-01,03T,1760,1024,2784,0.632183908045977
16548,2017-08-01,03V,300,388,688,0.436046511627907
16549,2017-08-01,03W,1250,2247,3497,0.35744924220760654
16550,2017-08-01,03X,156,552,708,0.22033898305084745
16551,2017-08-01,03Y,393,784,1177,0.3338997451146984
16552,2017-08-01,04C,1268,1492,2760,0.45942028985507244
16553,2017-08-01,04D,1359,875,2234,0.608325872873769
16554,2017-08-01,04E,494,1387,1881,0.26262626262626265
16555,2017-08-01,04F,898,1641,2539,0.35368255218589995
16556,2017-08-01,04G,2674,4414,7088,0.37725733634311515
16557,2017-08-01,04H,317,797,1114,0.2845601436265709
16558,2017-08-01,04J,947,2314,3261,0.29040171726464276
16559,2017-08-01,04K,541,1877,2418,0.22373862696443342
16560,2017-08-01,04L,224,1000,1224,0.1830065359477124
16561,2017-08-01,04M,163,555,718,0.22701949860724233
16562,2017-08-01,04N,208,869,1077,0.19312906220984216
16563,2017-08-01,04Q,755,558,1313,0.575019040365575
16564,2017-08-01,04R,1205,3059,4264,0.2825984990619137
16565,2017-08-01,04V,1438,2386,3824,0.3760460251046025
16566,2017-08-01,04X,868,1752,2620,0.33129770992366414
16567,2017-08-01,04Y,670,751,1421,0.47149894440534834
16568,2017-08-01,05A,1503,2629,4132,0.3637463697967086
16569,2017-08-01,05C,1040,2416,3456,0.30092592592592593
16570,2017-08-01,05D,915,585,1500,0.61
16571,2017-08-01,05F,641,1304,1945,0.3295629820051414
16572,2017-08-01,05G,1333,1136,2469,0.5398946942081815
16573,2017-08-01,05H,771,1073,1844,0.4181127982646421
16574,2017-08-01,05J,793,1262,2055,0.3858880778588808
16575,2017-08-01,05L,1921,2519,4440,0.4326576576576577
16576,2017-08-01,05N,1732,1516,3248,0.5332512315270936
16577,2017-08-01,05P,642,1313,1955,0.32838874680306906
16578,2017-08-01,05Q,1104,1146,2250,0.49066666666666664
16579,2017-08-01,05R,1020,2055,3075,0.33170731707317075
16580,2017-08-01,05T,1428,1954,3382,0.4222353636901242
16581,2017-08-01,05V,758,857,1615,0.4693498452012384
16582,2017-08-01,05W,1514,1216,2730,0.5545787545787546
16583,2017-08-01,05X,667,826,1493,0.44675150703281985
16584,2017-08-01,05Y,1216,1807,3023,0.4022494211048627
16585,2017-08-01,06A,964,1323,2287,0.4215128989943157
16586,2017-08-01,06D,521,911,1432,0.3638268156424581
16587,2017-08-01,06F,1123,3154,4277,0.26256722001402855
16588,2017-08-01,06H,4578,4392,8970,0.5103678929765886
16589,2017-08-01,06K,2346,3927,6273,0.37398373983739835
16590,2017-08-01,06L,1900,2002,3902,0.486929779600205
16591,2017-08-01,06M,1357,1558,2915,0.4655231560891938
16592,2017-08-01,06N,2088,3912,6000,0.348
16593,2017-08-01,06P,682,1091,1773,0.38465877044557245
16594,2017-08-01,06Q,2210,1560,3770,0.5862068965517241
16595,2017-08-01,06T,1870,2034,3904,0.47899590163934425
16596,2017-08-01,06V,1245,1061,2306,0.5398959236773634
16597,2017-08-01,06W,1340,1055,2395,0.5594989561586639
16598,2017-08-01,06Y,1311,878,2189,0.5989036089538602
16599,2017-08-01,07G,814,490,1304,0.6242331288343558
16600,2017-08-01,07H,1249,1862,3111,0.4014786242365799
16601,2017-08-01,07J,962,747,1709,0.5629022820362786
16602,2017-08-01,07K,1430,891,2321,0.6161137440758294
16603,2017-08-01,07L,508,752,1260,0.4031746031746032
16604,2017-08-01,07M,1098,1586,2684,0.4090909090909091
16605,2017-08-01,07N,1336,1006,2342,0.5704526046114432
16606,2017-08-01,07P,531,1081,1612,0.3294044665012407
16607,2017-08-01,07Q,922,1606,2528,0.3647151898734177
16608,2017-08-01,07R,397,973,1370,0.28978102189781024
16609,2017-08-01,07T,414,1037,1451,0.28532046864231564
16610,2017-08-01,07V,666,2156,2822,0.23600283486888732
16611,2017-08-01,07W,640,1446,2086,0.3068072866730585
16612,2017-08-01,07X,948,1187,2135,0.44402810304449647
16613,2017-08-01,07Y,532,1060,1592,0.3341708542713568
16614,2017-08-01,08A,705,1046,1751,0.402627070245574
16615,2017-08-01,08C,351,810,1161,0.3023255813953488
16616,2017-08-01,08D,478,996,1474,0.3242876526458616
16617,2017-08-01,08E,704,935,1639,0.42953020134228187
16618,2017-08-01,08F,922,1403,2325,0.3965591397849462
16619,2017-08-01,08G,417,1446,1863,0.22383252818035426
16620,2017-08-01,08H,391,1041,1432,0.27304469273743015
16621,2017-08-01,08J,620,815,1435,0.43205574912891986
16622,2017-08-01,08K,565,1428,1993,0.2834922227797291
16623,2017-08-01,08L,729,1327,2056,0.3545719844357977
16624,2017-08-01,08M,635,1375,2010,0.31592039800995025
16625,2017-08-01,08N,946,991,1937,0.48838409912235414
16626,2017-08-01,08P,698,960,1658,0.4209891435464415
16627,2017-08-01,08Q,470,1135,1605,0.29283489096573206
16628,2017-08-01,08R,649,692,1341,0.48396718866517524
16629,2017-08-01,08T,631,1148,1779,0.3546936481169196
16630,2017-08-01,08V,803,1248,2051,0.3915163334958557
16631,2017-08-01,08W,562,1161,1723,0.3261752756819501
16632,2017-08-01,08X,803,1684,2487,0.3228789706473663
16633,2017-08-01,08Y,397,798,1195,0.3322175732217573
16634,2017-08-01,09A,351,997,1348,0.2603857566765579
16635,2017-08-01,09C,532,776,1308,0.40672782874617736
16636,2017-08-01,09D,818,1618,2436,0.33579638752052543
16637,2017-08-01,09E,1103,1286,2389,0.4616994558392633
16638,2017-08-01,09F,591,1407,1998,0.2957957957957958
16639,2017-08-01,09G,3378,2447,5825,0.5799141630901288
16640,2017-08-01,09H,502,434,936,0.5363247863247863
16641,2017-08-01,09J,1566,1327,2893,0.541306602143104
16642,2017-08-01,09L,584,928,1512,0.3862433862433862
16643,2017-08-01,09N,697,1197,1894,0.36800422386483633
16644,2017-08-01,09P,442,1572,2014,0.21946375372393248
16645,2017-08-01,09W,1276,1166,2442,0.5225225225225225
16646,2017-08-01,09X,897,1173,2070,0.43333333333333335
16647,2017-08-01,09Y,684,2461,3145,0.21748807631160572
16648,2017-08-01,10A,899,1333,2232,0.4027777777777778
16649,2017-08-01,10C,384,530,914,0.4201312910284464
16650,2017-08-01,10D,517,653,1170,0.44188034188034186
16651,2017-08-01,10E,596,720,1316,0.45288753799392095
16652,2017-08-01,10G,281,853,1134,0.24779541446208111
16653,2017-08-01,10H,884,2399,3283,0.2692659153213524
16654,2017-08-01,10J,711,1321,2032,0.3499015748031496
16655,2017-08-01,10K,877,1231,2108,0.41603415559772294
16656,2017-08-01,10L,978,769,1747,0.5598168288494562
16657,2017-08-01,10M,217,716,933,0.23258306538049303
16658,2017-08-01,10N,242,647,889,0.2722159730033746
16659,2017-08-01,10Q,2521,3974,6495,0.38814472671285605
16660,2017-08-01,10R,1187,911,2098,0.5657769304099142
16661,2017-08-01,10T,319,805,1124,0.28380782918149466
16662,2017-08-01,10V,942,1224,2166,0.43490304709141275
16663,2017-08-01,10W,254,744,998,0.2545090180360721
16664,2017-08-01,10X,1042,948,1990,0.5236180904522613
16665,2017-08-01,10Y,669,1683,2352,0.2844387755102041
16666,2017-08-01,11A,2791,2549,5340,0.5226591760299626
16667,2017-08-01,11C,408,914,1322,0.3086232980332829
16668,2017-08-01,11D,532,888,1420,0.37464788732394366
16669,2017-08-01,11E,704,1213,1917,0.36724047991653624
16670,2017-08-01,11H,1918,2282,4200,0.45666666666666667
16671,2017-08-01,11J,2762,5676,8438,0.32732875088883623
16672,2017-08-01,11M,3002,3326,6328,0.47439949431099876
16673,2017-08-01,11N,2378,3920,6298,0.3775801841854557
16674,2017-08-01,11T,1228,1217,2445,0.5022494887525563
16675,2017-08-01,11X,2030,2621,4651,0.43646527628466997
16676,2017-08-01,12A,1213,1134,2347,0.5168299957392416
16677,2017-08-01,12D,798,1314,2112,0.3778409090909091
16678,2017-08-01,12F,1724,2028,3752,0.4594882729211087
16679,2017-08-01,13P,1715,4072,5787,0.29635389666493867
16680,2017-08-01,13T,1568,3001,4569,0.34318231560516527
16681,2017-08-01,14L,2457,2482,4939,0.4974691233043126
16682,2017-08-01,99A,1706,2621,4327,0.394268546336954
16683,2017-08-01,99C,895,1316,2211,0.40479421076436
16684,2017-08-01,99D,933,1098,2031,0.45937961595273263
16685,2017-08-01,99E,1701,856,2557,0.6652326945639421
16686,2017-08-01,99F,1047,643,1690,0.6195266272189349
16687,2017-08-01,99G,858,616,1474,0.582089552238806
16688,2017-08-01,99H,985,1900,2885,0.341421143847487
16689,2017-08-01,99J,2387,2664,5051,0.4725796871906553
16690,2017-08-01,99K,711,1125,1836,0.3872549019607843
16691,2017-08-01,99M,844,1308,2152,0.39219330855018586
16692,2017-08-01,99N,2518,3145,5663,0.4446406498322444
16693,2017-08-01,99P,4491,5207,9698,0.4630851722004537
16694,2017-08-01,99Q,1686,1384,3070,0.549185667752443
16695,2017-09-01,00C,409,767,1176,0.34778911564625853
16696,2017-09-01,00D,905,2310,3215,0.28149300155520995
16697,2017-09-01,00J,797,1666,2463,0.32358911896061715
16698,2017-09-01,00K,1021,1704,2725,0.3746788990825688
16699,2017-09-01,00L,1166,2366,3532,0.3301245753114383
16700,2017-09-01,00M,1215,1862,3077,0.3948651283717907
16701,2017-09-01,00N,698,1081,1779,0.39235525576166386
16702,2017-09-01,00P,1123,1747,2870,0.39128919860627176
16703,2017-09-01,00Q,561,927,1488,0.37701612903225806
16704,2017-09-01,00R,811,939,1750,0.4634285714285714
16705,2017-09-01,00T,1591,1282,2873,0.5537765402018796
16706,2017-09-01,00V,624,1367,1991,0.3134103465595178
16707,2017-09-01,00X,653,809,1462,0.4466484268125855
16708,2017-09-01,00Y,1105,1699,2804,0.3940798858773181
16709,2017-09-01,01A,1286,2266,3552,0.36204954954954954
16710,2017-09-01,01C,430,1127,1557,0.2761721258831085
16711,2017-09-01,01D,632,1284,1916,0.3298538622129436
16712,2017-09-01,01E,734,842,1576,0.46573604060913704
16713,2017-09-01,01F,567,711,1278,0.44366197183098594
16714,2017-09-01,01G,1015,1610,2625,0.38666666666666666
16715,2017-09-01,01H,1165,2203,3368,0.34590261282660334
16716,2017-09-01,01J,716,983,1699,0.4214243672748676
16717,2017-09-01,01K,1367,2140,3507,0.38979184488166524
16718,2017-09-01,01R,398,1052,1450,0.27448275862068966
16719,2017-09-01,01T,520,925,1445,0.35986159169550175
16720,2017-09-01,01V,509,801,1310,0.3885496183206107
16721,2017-09-01,01W,1368,1417,2785,0.4912028725314183
16722,2017-09-01,01X,963,1267,2230,0.4318385650224215
16723,2017-09-01,01Y,436,1666,2102,0.20742150333016174
16724,2017-09-01,02A,845,1180,2025,0.41728395061728396
16725,2017-09-01,02D,173,590,763,0.22673656618610746
16726,2017-09-01,02E,690,1100,1790,0.3854748603351955
16727,2017-09-01,02F,1006,1560,2566,0.392049883086516
16728,2017-09-01,02G,520,462,982,0.5295315682281059
16729,2017-09-01,02H,1024,2166,3190,0.32100313479623827
16730,2017-09-01,02M,609,962,1571,0.38765117759388923
16731,2017-09-01,02N,562,991,1553,0.36188023180940115
16732,2017-09-01,02P,913,1958,2871,0.31800766283524906
16733,2017-09-01,02Q,357,773,1130,0.315929203539823
16734,2017-09-01,02R,1782,1328,3110,0.5729903536977492
16735,2017-09-01,02T,963,1073,2036,0.4729862475442043
16736,2017-09-01,02V,482,1293,1775,0.27154929577464787
16737,2017-09-01,02W,520,407,927,0.5609492988133765
16738,2017-09-01,02X,1244,1677,2921,0.42588154741526874
16739,2017-09-01,02Y,1790,1330,3120,0.5737179487179487
16740,2017-09-01,03A,1119,1115,2234,0.500895255147717
16741,2017-09-01,03C,697,1960,2657,0.26232593150169364
16742,2017-09-01,03D,432,887,1319,0.32752084912812734
16743,2017-09-01,03E,600,817,1417,0.4234297812279464
16744,2017-09-01,03F,1327,1068,2395,0.554070981210856
16745,2017-09-01,03G,659,1775,2434,0.27074774034511095
16746,2017-09-01,03H,1166,512,1678,0.6948748510131109
16747,2017-09-01,03J,920,878,1798,0.5116796440489433
16748,2017-09-01,03K,889,558,1447,0.6143745680718729
16749,2017-09-01,03L,747,1723,2470,0.30242914979757085
16750,2017-09-01,03M,699,645,1344,0.5200892857142857
16751,2017-09-01,03N,2265,2781,5046,0.44887039239001186
16752,2017-09-01,03Q,1461,1690,3151,0.46366232941923197
16753,2017-09-01,03R,1489,2213,3702,0.402215018908698
16754,2017-09-01,03T,1706,1021,2727,0.6255958929226256
16755,2017-09-01,03V,299,374,673,0.4442793462109955
16756,2017-09-01,03W,1167,2158,3325,0.35097744360902255
16757,2017-09-01,03X,163,545,708,0.23022598870056496
16758,2017-09-01,03Y,354,803,1157,0.3059636992221262
16759,2017-09-01,04C,1227,1554,2781,0.4412081984897519
16760,2017-09-01,04D,1300,876,2176,0.5974264705882353
16761,2017-09-01,04E,462,1365,1827,0.25287356321839083
16762,2017-09-01,04F,887,1580,2467,0.3595460072963113
16763,2017-09-01,04G,2634,4318,6952,0.3788837744533947
16764,2017-09-01,04H,328,812,1140,0.28771929824561404
16765,2017-09-01,04J,1056,2274,3330,0.3171171171171171
16766,2017-09-01,04K,569,1837,2406,0.23649210307564422
16767,2017-09-01,04L,236,982,1218,0.19376026272577998
16768,2017-09-01,04M,155,548,703,0.22048364153627312
16769,2017-09-01,04N,197,790,987,0.19959473150962512
16770,2017-09-01,04Q,744,651,1395,0.5333333333333333
16771,2017-09-01,04R,1130,3058,4188,0.26981852913085
16772,2017-09-01,04V,1459,2299,3758,0.3882384246939862
16773,2017-09-01,04X,820,1766,2586,0.317092034029389
16774,2017-09-01,04Y,681,778,1459,0.46675805346127486
16775,2017-09-01,05A,1437,2539,3976,0.3614185110663984
16776,2017-09-01,05C,1061,2201,3262,0.3252605763335377
16777,2017-09-01,05D,915,658,1573,0.5816910362364908
16778,2017-09-01,05F,637,1391,2028,0.3141025641025641
16779,2017-09-01,05G,1264,1085,2349,0.5381013197105151
16780,2017-09-01,05H,766,1126,1892,0.4048625792811839
16781,2017-09-01,05J,795,1280,2075,0.38313253012048193
16782,2017-09-01,05L,1915,2619,4534,0.4223643581826202
16783,2017-09-01,05N,1711,1487,3198,0.5350218886804252
16784,2017-09-01,05P,677,1373,2050,0.3302439024390244
16785,2017-09-01,05Q,1002,1146,2148,0.4664804469273743
16786,2017-09-01,05R,1022,1967,2989,0.34192037470725994
16787,2017-09-01,05T,1197,2075,3272,0.3658312958435208
16788,2017-09-01,05V,744,882,1626,0.4575645756457565
16789,2017-09-01,05W,1519,1193,2712,0.5601032448377581
16790,2017-09-01,05X,712,785,1497,0.4756179024716099
16791,2017-09-01,05Y,1210,1700,2910,0.41580756013745707
16792,2017-09-01,06A,966,1272,2238,0.4316353887399464
16793,2017-09-01,06D,521,925,1446,0.3603042876901798
16794,2017-09-01,06F,1066,3087,4153,0.25668191668673246
16795,2017-09-01,06H,4512,4208,8720,0.5174311926605505
16796,2017-09-01,06K,2167,4193,6360,0.3407232704402516
16797,2017-09-01,06L,1804,1980,3784,0.47674418604651164
16798,2017-09-01,06M,1347,1590,2937,0.4586312563840654
16799,2017-09-01,06N,1934,3864,5798,0.33356329768885823
16800,2017-09-01,06P,620,1106,1726,0.35921205098493625
16801,2017-09-01,06Q,2002,1602,3604,0.5554938956714761
16802,2017-09-01,06T,1921,2090,4011,0.47893293443031665
16803,2017-09-01,06V,1185,1075,2260,0.5243362831858407
16804,2017-09-01,06W,1343,1095,2438,0.5508613617719442
16805,2017-09-01,06Y,1297,871,2168,0.5982472324723247
16806,2017-09-01,07G,899,461,1360,0.6610294117647059
16807,2017-09-01,07H,1056,1931,2987,0.3535319718781386
16808,2017-09-01,07J,1002,762,1764,0.5680272108843537
16809,2017-09-01,07K,1478,827,2305,0.6412147505422994
16810,2017-09-01,07L,518,762,1280,0.4046875
16811,2017-09-01,07M,944,1707,2651,0.35609204073934364
16812,2017-09-01,07N,1364,1010,2374,0.5745577085088458
16813,2017-09-01,07P,477,1149,1626,0.2933579335793358
16814,2017-09-01,07Q,825,1662,2487,0.33172496984318456
16815,2017-09-01,07R,390,1084,1474,0.2645861601085482
16816,2017-09-01,07T,431,1101,1532,0.28133159268929503
16817,2017-09-01,07V,670,2138,2808,0.2386039886039886
16818,2017-09-01,07W,667,1515,2182,0.3056828597616865
16819,2017-09-01,07X,827,1259,2086,0.39645254074784275
16820,2017-09-01,07Y,568,1057,1625,0.3495384615384615
16821,2017-09-01,08A,675,1011,1686,0.400355871886121
16822,2017-09-01,08C,363,872,1235,0.29392712550607286
16823,2017-09-01,08D,462,992,1454,0.3177441540577717
16824,2017-09-01,08E,707,964,1671,0.42309994015559543
16825,2017-09-01,08F,944,1375,2319,0.40707201379905134
16826,2017-09-01,08G,400,1464,1864,0.2145922746781116
16827,2017-09-01,08H,427,1089,1516,0.2816622691292876
16828,2017-09-01,08J,569,868,1437,0.3959638135003479
16829,2017-09-01,08K,625,1397,2022,0.30909990108803165
16830,2017-09-01,08L,700,1277,1977,0.35407182599898834
16831,2017-09-01,08M,754,1325,2079,0.36267436267436265
16832,2017-09-01,08N,915,986,1901,0.4813256180957391
16833,2017-09-01,08P,654,940,1594,0.410288582183187
16834,2017-09-01,08Q,443,1116,1559,0.2841565105837075
16835,2017-09-01,08R,664,711,1375,0.4829090909090909
16836,2017-09-01,08T,615,1183,1798,0.3420467185761958
16837,2017-09-01,08V,745,1379,2124,0.3507532956685499
16838,2017-09-01,08W,584,1173,1757,0.3323847467273762
16839,2017-09-01,08X,741,1707,2448,0.30269607843137253
16840,2017-09-01,08Y,409,949,1358,0.3011782032400589
16841,2017-09-01,09A,347,1093,1440,0.24097222222222223
16842,2017-09-01,09C,577,779,1356,0.42551622418879054
16843,2017-09-01,09D,741,1669,2410,0.3074688796680498
16844,2017-09-01,09E,1033,1255,2288,0.451486013986014
16845,2017-09-01,09F,586,1470,2056,0.2850194552529183
16846,2017-09-01,09G,3018,2633,5651,0.5340647672978234
16847,2017-09-01,09H,471,459,930,0.5064516129032258
16848,2017-09-01,09J,1516,1179,2695,0.5625231910946197
16849,2017-09-01,09L,530,995,1525,0.3475409836065574
16850,2017-09-01,09N,638,1125,1763,0.3618831537152581
16851,2017-09-01,09P,395,1573,1968,0.20071138211382114
16852,2017-09-01,09W,1291,1212,2503,0.5157810627247303
16853,2017-09-01,09X,855,1130,1985,0.43073047858942065
16854,2017-09-01,09Y,638,2276,2914,0.2189430336307481
16855,2017-09-01,10A,903,1243,2146,0.4207828518173346
16856,2017-09-01,10C,394,513,907,0.43439911797133407
16857,2017-09-01,10D,522,661,1183,0.44125105663567205
16858,2017-09-01,10E,574,773,1347,0.4261321455085375
16859,2017-09-01,10G,338,900,1238,0.2730210016155089
16860,2017-09-01,10H,828,2584,3412,0.24267291910902697
16861,2017-09-01,10J,649,1370,2019,0.3214462605250124
16862,2017-09-01,10K,761,1217,1978,0.38473205257836196
16863,2017-09-01,10L,978,845,1823,0.5364783324190894
16864,2017-09-01,10M,233,634,867,0.2687427912341407
16865,2017-09-01,10N,262,689,951,0.2754994742376446
16866,2017-09-01,10Q,2374,4259,6633,0.3579074325342982
16867,2017-09-01,10R,1113,863,1976,0.5632591093117408
16868,2017-09-01,10T,320,713,1033,0.30977734753146174
16869,2017-09-01,10V,805,1163,1968,0.4090447154471545
16870,2017-09-01,10W,235,765,1000,0.235
16871,2017-09-01,10X,1067,1045,2112,0.5052083333333334
16872,2017-09-01,10Y,588,1615,2203,0.26690876078075354
16873,2017-09-01,11A,2808,2550,5358,0.5240761478163494
16874,2017-09-01,11C,423,917,1340,0.3156716417910448
16875,2017-09-01,11D,489,822,1311,0.37299771167048057
16876,2017-09-01,11E,663,1168,1831,0.3620972146368105
16877,2017-09-01,11H,1768,2346,4114,0.4297520661157025
16878,2017-09-01,11J,2543,5876,8419,0.3020548758759948
16879,2017-09-01,11M,2965,3325,6290,0.4713831478537361
16880,2017-09-01,11N,2340,3794,6134,0.38148027388327355
16881,2017-09-01,11T,1181,1262,2443,0.4834220221039705
16882,2017-09-01,11X,2011,2530,4541,0.44285399691697863
16883,2017-09-01,12A,1208,1114,2322,0.5202411714039621
16884,2017-09-01,12D,855,1312,2167,0.39455468389478543
16885,2017-09-01,12F,1673,1988,3661,0.4569789674952199
16886,2017-09-01,13P,1851,4106,5957,0.31072687594426723
16887,2017-09-01,13T,1584,3111,4695,0.33738019169329075
16888,2017-09-01,14L,2316,2555,4871,0.4754670498870868
16889,2017-09-01,99A,1618,2525,4143,0.39053825730147235
16890,2017-09-01,99C,819,1390,2209,0.3707559981892259
16891,2017-09-01,99D,909,1081,1990,0.45678391959799
16892,2017-09-01,99E,1625,840,2465,0.6592292089249493
16893,2017-09-01,99F,1050,619,1669,0.6291192330736968
16894,2017-09-01,99G,830,661,1491,0.556673373574782
16895,2017-09-01,99H,871,1842,2713,0.32104681164762255
16896,2017-09-01,99J,2231,2758,4989,0.44718380436961314
16897,2017-09-01,99K,630,1185,1815,0.34710743801652894
16898,2017-09-01,99M,771,1316,2087,0.36942980354575944
16899,2017-09-01,99N,2457,3189,5646,0.4351753453772582
16900,2017-09-01,99P,4163,5063,9226,0.4512247994797312
16901,2017-09-01,99Q,1666,1357,3023,0.5511081706913662
16902,2017-10-01,00C,413,762,1175,0.35148936170212763
16903,2017-10-01,00D,892,2386,3278,0.27211714460036607
16904,2017-10-01,00J,822,1675,2497,0.32919503404084904
16905,2017-10-01,00K,945,1736,2681,0.3524804177545692
16906,2017-10-01,00L,1198,2449,3647,0.3284891691801481
16907,2017-10-01,00M,1160,1944,3104,0.37371134020618557
16908,2017-10-01,00N,694,1128,1822,0.3809001097694841
16909,2017-10-01,00P,1113,1897,3010,0.3697674418604651
16910,2017-10-01,00Q,571,1008,1579,0.3616212792906903
16911,2017-10-01,00R,820,956,1776,0.4617117117117117
16912,2017-10-01,00T,1663,1316,2979,0.55824102047667
16913,2017-10-01,00V,602,1455,2057,0.2926592124453087
16914,2017-10-01,00X,706,861,1567,0.4505424377791959
16915,2017-10-01,00Y,1128,1649,2777,0.40619373424558874
16916,2017-10-01,01A,1216,2343,3559,0.34166900814835627
16917,2017-10-01,01C,359,1206,1565,0.22939297124600638
16918,2017-10-01,01D,543,1423,1966,0.27619532044760936
16919,2017-10-01,01E,730,878,1608,0.4539800995024876
16920,2017-10-01,01F,462,847,1309,0.35294117647058826
16921,2017-10-01,01G,990,1715,2705,0.3659889094269871
16922,2017-10-01,01H,948,2348,3296,0.28762135922330095
16923,2017-10-01,01J,729,1070,1799,0.40522512506948305
16924,2017-10-01,01K,1057,2505,3562,0.2967434025828186
16925,2017-10-01,01R,395,1019,1414,0.27934936350777934
16926,2017-10-01,01T,515,919,1434,0.3591352859135286
16927,2017-10-01,01V,473,867,1340,0.3529850746268657
16928,2017-10-01,01W,1432,1588,3020,0.4741721854304636
16929,2017-10-01,01X,905,1428,2333,0.387912558936991
16930,2017-10-01,01Y,436,1656,2092,0.2084130019120459
16931,2017-10-01,02A,877,1234,2111,0.41544291804831834
16932,2017-10-01,02D,214,590,804,0.26616915422885573
16933,2017-10-01,02E,696,1189,1885,0.36923076923076925
16934,2017-10-01,02F,964,1547,2511,0.3839107925129431
16935,2017-10-01,02G,499,519,1018,0.4901768172888016
16936,2017-10-01,02H,1029,2156,3185,0.3230769230769231
16937,2017-10-01,02M,620,1014,1634,0.379436964504284
16938,2017-10-01,02N,586,1114,1700,0.3447058823529412
16939,2017-10-01,02P,875,2096,2971,0.2945136317738135
16940,2017-10-01,02Q,366,796,1162,0.31497418244406195
16941,2017-10-01,02R,1765,1394,3159,0.5587211142766698
16942,2017-10-01,02T,984,1199,2183,0.45075584058634904
16943,2017-10-01,02V,488,1333,1821,0.26798462383305877
16944,2017-10-01,02W,502,444,946,0.5306553911205074
16945,2017-10-01,02X,1222,1708,2930,0.41706484641638225
16946,2017-10-01,02Y,1795,1344,3139,0.5718381650207073
16947,2017-10-01,03A,1136,1146,2282,0.49780893952673094
16948,2017-10-01,03C,656,2166,2822,0.23245924875974486
16949,2017-10-01,03D,462,942,1404,0.32905982905982906
16950,2017-10-01,03E,591,777,1368,0.43201754385964913
16951,2017-10-01,03F,1410,1103,2513,0.5610823716673299
16952,2017-10-01,03G,679,1785,2464,0.2755681818181818
16953,2017-10-01,03H,1158,608,1766,0.6557191392978482
16954,2017-10-01,03J,905,827,1732,0.5225173210161663
16955,2017-10-01,03K,906,618,1524,0.594488188976378
16956,2017-10-01,03L,764,1786,2550,0.2996078431372549
16957,2017-10-01,03M,681,723,1404,0.48504273504273504
16958,2017-10-01,03N,2231,3147,5378,0.41483822982521384
16959,2017-10-01,03Q,1311,1797,3108,0.4218146718146718
16960,2017-10-01,03R,1468,2323,3791,0.3872329200738591
16961,2017-10-01,03T,1705,1051,2756,0.6186502177068215
16962,2017-10-01,03V,297,418,715,0.4153846153846154
16963,2017-10-01,03W,1271,2250,3521,0.3609769951718262
16964,2017-10-01,03X,169,486,655,0.2580152671755725
16965,2017-10-01,03Y,378,813,1191,0.31738035264483627
16966,2017-10-01,04C,1139,1639,2778,0.41000719942404606
16967,2017-10-01,04D,1275,1075,2350,0.5425531914893617
16968,2017-10-01,04E,499,1396,1895,0.2633245382585752
16969,2017-10-01,04F,939,1660,2599,0.3612928049249711
16970,2017-10-01,04G,2567,4356,6923,0.370793008811209
16971,2017-10-01,04H,349,832,1181,0.2955122777307367
16972,2017-10-01,04J,992,2275,3267,0.3036424854606673
16973,2017-10-01,04K,548,2166,2714,0.2019159911569639
16974,2017-10-01,04L,212,988,1200,0.17666666666666667
16975,2017-10-01,04M,117,580,697,0.1678622668579627
16976,2017-10-01,04N,198,842,1040,0.19038461538461537
16977,2017-10-01,04Q,650,577,1227,0.5297473512632437
16978,2017-10-01,04R,1087,3182,4269,0.25462637620051537
16979,2017-10-01,04V,1433,2541,3974,0.3605938600905888
16980,2017-10-01,04X,905,1829,2734,0.331016825164594
16981,2017-10-01,04Y,607,830,1437,0.42240779401530965
16982,2017-10-01,05A,1353,2782,4135,0.3272067714631197
16983,2017-10-01,05C,1034,2183,3217,0.32141746969225987
16984,2017-10-01,05D,918,628,1546,0.5937904269081501
16985,2017-10-01,05F,620,1257,1877,0.3303143313798615
16986,2017-10-01,05G,1426,1147,2573,0.5542168674698795
16987,2017-10-01,05H,766,1190,1956,0.39161554192229037
16988,2017-10-01,05J,756,1314,2070,0.3652173913043478
16989,2017-10-01,05L,1870,2700,4570,0.40919037199124725
16990,2017-10-01,05N,1771,1519,3290,0.5382978723404256
16991,2017-10-01,05P,626,1435,2061,0.30373605046094126
16992,2017-10-01,05Q,1094,1223,2317,0.4721622788088045
16993,2017-10-01,05R,1029,2034,3063,0.33594515181194906
16994,2017-10-01,05T,1225,2150,3375,0.362962962962963
16995,2017-10-01,05V,729,909,1638,0.44505494505494503
16996,2017-10-01,05W,1423,1227,2650,0.5369811320754717
16997,2017-10-01,05X,709,825,1534,0.4621903520208605
16998,2017-10-01,05Y,1213,1709,2922,0.41512662559890484
16999,2017-10-01,06A,980,1372,2352,0.4166666666666667
17000,2017-10-01,06D,464,953,1417,0.3274523641496119
17001,2017-10-01,06F,1156,3206,4362,0.2650160476845484
17002,2017-10-01,06H,4379,4477,8856,0.49446702800361336
17003,2017-10-01,06K,1936,4364,6300,0.3073015873015873
17004,2017-10-01,06L,1687,2039,3726,0.45276435856146
17005,2017-10-01,06M,1284,1635,2919,0.4398766700924974
17006,2017-10-01,06N,1773,4317,6090,0.2911330049261084
17007,2017-10-01,06P,568,1116,1684,0.33729216152019004
17008,2017-10-01,06Q,2126,1630,3756,0.566027689030884
17009,2017-10-01,06T,1867,2225,4092,0.4562561094819159
17010,2017-10-01,06V,1118,1090,2208,0.5063405797101449
17011,2017-10-01,06W,1339,1217,2556,0.5238654147104851
17012,2017-10-01,06Y,1256,1000,2256,0.5567375886524822
17013,2017-10-01,07G,818,475,1293,0.6326372776488786
17014,2017-10-01,07H,1114,2031,3145,0.35421303656597775
17015,2017-10-01,07J,1028,822,1850,0.5556756756756757
17016,2017-10-01,07K,1441,961,2402,0.5999167360532889
17017,2017-10-01,07L,439,764,1203,0.3649210307564422
17018,2017-10-01,07M,907,1718,2625,0.3455238095238095
17019,2017-10-01,07N,1293,1034,2327,0.5556510528577567
17020,2017-10-01,07P,517,1236,1753,0.29492298916143755
17021,2017-10-01,07Q,757,1695,2452,0.30872756933115825
17022,2017-10-01,07R,431,1151,1582,0.2724399494310999
17023,2017-10-01,07T,433,1145,1578,0.2743979721166033
17024,2017-10-01,07V,670,2119,2789,0.24022947292936536
17025,2017-10-01,07W,690,1490,2180,0.3165137614678899
17026,2017-10-01,07X,850,1352,2202,0.3860127157129882
17027,2017-10-01,07Y,538,1102,1640,0.3280487804878049
17028,2017-10-01,08A,689,1061,1750,0.39371428571428574
17029,2017-10-01,08C,343,895,1238,0.2770597738287561
17030,2017-10-01,08D,514,1179,1693,0.303603071470762
17031,2017-10-01,08E,723,1085,1808,0.39988938053097345
17032,2017-10-01,08F,904,1398,2302,0.39270199826238056
17033,2017-10-01,08G,422,1468,1890,0.22328042328042327
17034,2017-10-01,08H,399,1140,1539,0.25925925925925924
17035,2017-10-01,08J,563,957,1520,0.3703947368421053
17036,2017-10-01,08K,559,1526,2085,0.26810551558753
17037,2017-10-01,08L,688,1317,2005,0.343142144638404
17038,2017-10-01,08M,679,1401,2080,0.3264423076923077
17039,2017-10-01,08N,889,1046,1935,0.4594315245478036
17040,2017-10-01,08P,669,1006,1675,0.39940298507462685
17041,2017-10-01,08Q,388,1217,1605,0.24174454828660435
17042,2017-10-01,08R,660,790,1450,0.45517241379310347
17043,2017-10-01,08T,602,1218,1820,0.33076923076923076
17044,2017-10-01,08V,738,1384,2122,0.3477851083883129
17045,2017-10-01,08W,503,1213,1716,0.2931235431235431
17046,2017-10-01,08X,813,1920,2733,0.29747530186608123
17047,2017-10-01,08Y,406,970,1376,0.29505813953488375
17048,2017-10-01,09A,342,1152,1494,0.2289156626506024
17049,2017-10-01,09C,593,812,1405,0.4220640569395018
17050,2017-10-01,09D,735,1814,2549,0.2883483719105532
17051,2017-10-01,09E,995,1286,2281,0.4362121876370013
17052,2017-10-01,09F,594,1494,2088,0.28448275862068967
17053,2017-10-01,09G,2677,2740,5417,0.49418497323241645
17054,2017-10-01,09H,513,471,984,0.5213414634146342
17055,2017-10-01,09J,1505,1338,2843,0.5293703833978192
17056,2017-10-01,09L,523,1013,1536,0.3404947916666667
17057,2017-10-01,09N,659,1279,1938,0.34004127966976266
17058,2017-10-01,09P,488,1557,2045,0.23863080684596577
17059,2017-10-01,09W,1251,1203,2454,0.5097799511002445
17060,2017-10-01,09X,819,1292,2111,0.3879677877783041
17061,2017-10-01,09Y,683,2199,2882,0.2369882026370576
17062,2017-10-01,10A,947,1280,2227,0.42523574315222273
17063,2017-10-01,10C,350,537,887,0.3945885005636979
17064,2017-10-01,10D,537,671,1208,0.4445364238410596
17065,2017-10-01,10E,568,745,1313,0.4325971058644326
17066,2017-10-01,10G,305,836,1141,0.26730937773882557
17067,2017-10-01,10H,866,2524,3390,0.25545722713864305
17068,2017-10-01,10J,603,1434,2037,0.2960235640648012
17069,2017-10-01,10K,689,1342,2031,0.3392417528311177
17070,2017-10-01,10L,909,759,1668,0.5449640287769785
17071,2017-10-01,10M,202,691,893,0.22620380739081747
17072,2017-10-01,10N,224,729,953,0.23504721930745015
17073,2017-10-01,10Q,2244,4646,6890,0.32568940493468795
17074,2017-10-01,10R,1045,1079,2124,0.4919962335216573
17075,2017-10-01,10T,338,692,1030,0.32815533980582523
17076,2017-10-01,10V,729,1349,2078,0.35081809432146294
17077,2017-10-01,10W,235,861,1096,0.21441605839416059
17078,2017-10-01,10X,1010,1271,2281,0.44278825076720735
17079,2017-10-01,10Y,660,1721,2381,0.2771944561108778
17080,2017-10-01,11A,2695,2499,5194,0.5188679245283019
17081,2017-10-01,11C,453,912,1365,0.33186813186813185
17082,2017-10-01,11D,475,908,1383,0.34345625451916123
17083,2017-10-01,11E,722,1229,1951,0.37006663249615585
17084,2017-10-01,11H,1853,2425,4278,0.4331463300607761
17085,2017-10-01,11J,2362,5985,8347,0.28297591949203305
17086,2017-10-01,11M,2783,3569,6352,0.4381297229219144
17087,2017-10-01,11N,2397,3978,6375,0.376
17088,2017-10-01,11T,1145,1334,2479,0.4618797902379992
17089,2017-10-01,11X,1859,2572,4431,0.4195441209659219
17090,2017-10-01,12A,1120,1145,2265,0.49448123620309054
17091,2017-10-01,12D,818,1373,2191,0.3733455043359197
17092,2017-10-01,12F,1626,2200,3826,0.42498693152117095
17093,2017-10-01,13P,1792,4180,5972,0.3000669792364367
17094,2017-10-01,13T,1583,3286,4869,0.3251180940644896
17095,2017-10-01,14L,2564,2696,5260,0.4874524714828897
17096,2017-10-01,99A,1687,2743,4430,0.3808126410835214
17097,2017-10-01,99C,875,1349,2224,0.39343525179856115
17098,2017-10-01,99D,777,1196,1973,0.3938165230613279
17099,2017-10-01,99E,1604,918,2522,0.6360031720856463
17100,2017-10-01,99F,991,769,1760,0.5630681818181819
17101,2017-10-01,99G,816,701,1517,0.5379037574159525
17102,2017-10-01,99H,930,1923,2853,0.32597266035751843
17103,2017-10-01,99J,2136,2991,5127,0.4166179052077238
17104,2017-10-01,99K,548,1199,1747,0.31368059530623926
17105,2017-10-01,99M,798,1361,2159,0.3696155627605373
17106,2017-10-01,99N,2222,3085,5307,0.4186922931976635
17107,2017-10-01,99P,4085,5667,9752,0.4188884331419196
17108,2017-10-01,99Q,1544,1442,2986,0.5170797052913597
17109,2017-11-01,00C,450,727,1177,0.3823279524214104
17110,2017-11-01,00D,813,2359,3172,0.2563051702395965
17111,2017-11-01,00J,736,1670,2406,0.3059019118869493
17112,2017-11-01,00K,936,1661,2597,0.36041586445899115
17113,2017-11-01,00L,1135,2384,3519,0.3225348110258596
17114,2017-11-01,00M,1150,1895,3045,0.37766830870279144
17115,2017-11-01,00N,653,1120,1773,0.36830231246474904
17116,2017-11-01,00P,1015,1808,2823,0.35954658165072617
17117,2017-11-01,00Q,488,894,1382,0.35311143270622286
17118,2017-11-01,00R,835,873,1708,0.4888758782201405
17119,2017-11-01,00T,1584,1369,2953,0.5364036572976634
17120,2017-11-01,00V,497,1495,1992,0.24949799196787148
17121,2017-11-01,00X,680,841,1521,0.4470742932281394
17122,2017-11-01,00Y,1097,1580,2677,0.4097870750840493
17123,2017-11-01,01A,1086,2275,3361,0.3231181196072597
17124,2017-11-01,01C,395,1193,1588,0.24874055415617127
17125,2017-11-01,01D,480,1300,1780,0.2696629213483146
17126,2017-11-01,01E,679,799,1478,0.459404600811908
17127,2017-11-01,01F,497,846,1343,0.37006701414743115
17128,2017-11-01,01G,986,1721,2707,0.3642408570373107
17129,2017-11-01,01H,885,2379,3264,0.2711397058823529
17130,2017-11-01,01J,644,1126,1770,0.3638418079096045
17131,2017-11-01,01K,963,2356,3319,0.290147634829768
17132,2017-11-01,01R,338,953,1291,0.2618125484120837
17133,2017-11-01,01T,469,835,1304,0.35966257668711654
17134,2017-11-01,01V,482,891,1373,0.3510560815731974
17135,2017-11-01,01W,1372,1604,2976,0.46102150537634407
17136,2017-11-01,01X,839,1389,2228,0.3765709156193896
17137,2017-11-01,01Y,382,1556,1938,0.19711042311661506
17138,2017-11-01,02A,870,1170,2040,0.4264705882352941
17139,2017-11-01,02D,192,607,799,0.24030037546933666
17140,2017-11-01,02E,655,1218,1873,0.34970635344367323
17141,2017-11-01,02F,941,1451,2392,0.3933946488294314
17142,2017-11-01,02G,514,451,965,0.5326424870466321
17143,2017-11-01,02H,1004,2184,3188,0.31493099121706397
17144,2017-11-01,02M,586,1040,1626,0.36039360393603936
17145,2017-11-01,02N,535,1059,1594,0.335633626097867
17146,2017-11-01,02P,770,1880,2650,0.29056603773584905
17147,2017-11-01,02Q,332,808,1140,0.2912280701754386
17148,2017-11-01,02R,1656,1325,2981,0.5555182824555518
17149,2017-11-01,02T,883,1076,1959,0.4507401735579377
17150,2017-11-01,02V,440,1260,1700,0.25882352941176473
17151,2017-11-01,02W,525,411,936,0.5608974358974359
17152,2017-11-01,02X,1128,1622,2750,0.4101818181818182
17153,2017-11-01,02Y,1661,1301,2962,0.5607697501688048
17154,2017-11-01,03A,1118,1137,2255,0.4957871396895787
17155,2017-11-01,03C,607,2150,2757,0.22016684802321365
17156,2017-11-01,03D,387,846,1233,0.31386861313868614
17157,2017-11-01,03E,523,718,1241,0.42143432715551976
17158,2017-11-01,03F,1208,1063,2271,0.531924262439454
17159,2017-11-01,03G,627,1668,2295,0.27320261437908494
17160,2017-11-01,03H,1111,656,1767,0.6287492925863045
17161,2017-11-01,03J,901,838,1739,0.5181138585393904
17162,2017-11-01,03K,849,598,1447,0.5867311679336559
17163,2017-11-01,03L,692,1619,2311,0.29943747295543055
17164,2017-11-01,03M,588,681,1269,0.46335697399527187
17165,2017-11-01,03N,2033,2989,5022,0.40481879729191556
17166,2017-11-01,03Q,1200,1789,2989,0.4014720642355303
17167,2017-11-01,03R,1352,2285,3637,0.37173494638438276
17168,2017-11-01,03T,1584,991,2575,0.6151456310679612
17169,2017-11-01,03V,323,394,717,0.4504881450488145
17170,2017-11-01,03W,1102,2218,3320,0.33192771084337347
17171,2017-11-01,03X,175,476,651,0.26881720430107525
17172,2017-11-01,03Y,371,771,1142,0.3248686514886165
17173,2017-11-01,04C,1109,1669,2778,0.3992080633549316
17174,2017-11-01,04D,1100,1041,2141,0.5137786081270435
17175,2017-11-01,04E,493,1414,1907,0.2585212375458836
17176,2017-11-01,04F,945,1715,2660,0.35526315789473684
17177,2017-11-01,04G,2601,4513,7114,0.36561709305594603
17178,2017-11-01,04H,329,836,1165,0.28240343347639485
17179,2017-11-01,04J,960,2252,3212,0.298879202988792
17180,2017-11-01,04K,525,2067,2592,0.2025462962962963
17181,2017-11-01,04L,208,892,1100,0.1890909090909091
17182,2017-11-01,04M,157,596,753,0.20849933598937584
17183,2017-11-01,04N,191,774,965,0.19792746113989637
17184,2017-11-01,04Q,583,688,1271,0.45869394177812745
17185,2017-11-01,04R,1075,3034,4109,0.2616208323192991
17186,2017-11-01,04V,1372,2344,3716,0.36921420882669537
17187,2017-11-01,04X,837,1754,2591,0.32304129679660365
17188,2017-11-01,04Y,606,802,1408,0.4303977272727273
17189,2017-11-01,05A,1345,2736,4081,0.32957608429306545
17190,2017-11-01,05C,1018,2196,3214,0.31673926571250777
17191,2017-11-01,05D,831,603,1434,0.5794979079497908
17192,2017-11-01,05F,579,1319,1898,0.30505795574288724
17193,2017-11-01,05G,1291,1123,2414,0.5347970173985087
17194,2017-11-01,05H,761,1091,1852,0.4109071274298056
17195,2017-11-01,05J,685,1237,1922,0.35639958376690944
17196,2017-11-01,05L,1791,2698,4489,0.3989752728892849
17197,2017-11-01,05N,1727,1383,3110,0.5553054662379421
17198,2017-11-01,05P,625,1370,1995,0.3132832080200501
17199,2017-11-01,05Q,1122,1101,2223,0.50472334682861
17200,2017-11-01,05R,971,1989,2960,0.32804054054054055
17201,2017-11-01,05T,1202,2111,3313,0.36281316027769395
17202,2017-11-01,05V,729,842,1571,0.464035646085296
17203,2017-11-01,05W,1442,1287,2729,0.5283986808354708
17204,2017-11-01,05X,717,830,1547,0.46347769877181644
17205,2017-11-01,05Y,1087,1773,2860,0.38006993006993006
17206,2017-11-01,06A,928,1388,2316,0.4006908462867012
17207,2017-11-01,06D,442,896,1338,0.3303437967115097
17208,2017-11-01,06F,941,3006,3947,0.23840891816569545
17209,2017-11-01,06H,4127,4376,8503,0.4853581089027402
17210,2017-11-01,06K,1885,4239,6124,0.30780535597648595
17211,2017-11-01,06L,1635,2211,3846,0.4251170046801872
17212,2017-11-01,06M,1269,1605,2874,0.44154488517745305
17213,2017-11-01,06N,1696,4110,5806,0.29211160868067515
17214,2017-11-01,06P,576,1058,1634,0.3525091799265606
17215,2017-11-01,06Q,1865,1513,3378,0.5521018354055655
17216,2017-11-01,06T,1691,2059,3750,0.45093333333333335
17217,2017-11-01,06V,1085,1127,2212,0.49050632911392406
17218,2017-11-01,06W,1258,1147,2405,0.5230769230769231
17219,2017-11-01,06Y,1150,1003,2153,0.5341384115188109
17220,2017-11-01,07G,758,489,1247,0.6078588612670409
17221,2017-11-01,07H,1025,1942,2967,0.3454668014829794
17222,2017-11-01,07J,1012,800,1812,0.5584988962472406
17223,2017-11-01,07K,1277,1025,2302,0.554735013032146
17224,2017-11-01,07L,474,752,1226,0.3866231647634584
17225,2017-11-01,07M,831,1654,2485,0.33440643863179076
17226,2017-11-01,07N,1284,985,2269,0.5658880564125165
17227,2017-11-01,07P,483,1201,1684,0.28681710213776723
17228,2017-11-01,07Q,731,1531,2262,0.32316534040671974
17229,2017-11-01,07R,409,1095,1504,0.27194148936170215
17230,2017-11-01,07T,410,1050,1460,0.2808219178082192
17231,2017-11-01,07V,587,2070,2657,0.22092585622882951
17232,2017-11-01,07W,699,1407,2106,0.3319088319088319
17233,2017-11-01,07X,757,1394,2151,0.3519293351929335
17234,2017-11-01,07Y,553,981,1534,0.3604954367666232
17235,2017-11-01,08A,629,986,1615,0.3894736842105263
17236,2017-11-01,08C,314,946,1260,0.2492063492063492
17237,2017-11-01,08D,443,1082,1525,0.2904918032786885
17238,2017-11-01,08E,679,1069,1748,0.38844393592677345
17239,2017-11-01,08F,895,1288,2183,0.40998625744388456
17240,2017-11-01,08G,430,1428,1858,0.23143164693218515
17241,2017-11-01,08H,394,1094,1488,0.2647849462365591
17242,2017-11-01,08J,505,965,1470,0.3435374149659864
17243,2017-11-01,08K,538,1550,2088,0.25766283524904215
17244,2017-11-01,08L,596,1311,1907,0.31253277399056106
17245,2017-11-01,08M,642,1326,1968,0.32621951219512196
17246,2017-11-01,08N,880,1027,1907,0.46145778710015734
17247,2017-11-01,08P,596,1020,1616,0.3688118811881188
17248,2017-11-01,08Q,396,1243,1639,0.24161073825503357
17249,2017-11-01,08R,609,768,1377,0.4422657952069717
17250,2017-11-01,08T,612,1177,1789,0.3420905533817775
17251,2017-11-01,08V,672,1336,2008,0.3346613545816733
17252,2017-11-01,08W,472,1239,1711,0.27586206896551724
17253,2017-11-01,08X,693,1807,2500,0.2772
17254,2017-11-01,08Y,365,925,1290,0.28294573643410853
17255,2017-11-01,09A,301,1045,1346,0.2236255572065379
17256,2017-11-01,09C,512,764,1276,0.4012539184952978
17257,2017-11-01,09D,597,1689,2286,0.26115485564304464
17258,2017-11-01,09E,844,1364,2208,0.3822463768115942
17259,2017-11-01,09F,510,1422,1932,0.2639751552795031
17260,2017-11-01,09G,2658,2920,5578,0.47651487988526353
17261,2017-11-01,09H,432,483,915,0.4721311475409836
17262,2017-11-01,09J,1407,1356,2763,0.509229098805646
17263,2017-11-01,09L,518,1031,1549,0.3344092963202066
17264,2017-11-01,09N,651,1245,1896,0.34335443037974683
17265,2017-11-01,09P,441,1491,1932,0.22826086956521738
17266,2017-11-01,09W,1222,1188,2410,0.5070539419087137
17267,2017-11-01,09X,853,1172,2025,0.4212345679012346
17268,2017-11-01,09Y,666,2196,2862,0.23270440251572327
17269,2017-11-01,10A,864,1259,2123,0.406971267074894
17270,2017-11-01,10C,363,552,915,0.39672131147540984
17271,2017-11-01,10D,492,598,1090,0.45137614678899085
17272,2017-11-01,10E,552,743,1295,0.42625482625482625
17273,2017-11-01,10G,281,828,1109,0.2533814247069432
17274,2017-11-01,10H,819,2403,3222,0.2541899441340782
17275,2017-11-01,10J,607,1356,1963,0.3092205807437596
17276,2017-11-01,10K,667,1229,1896,0.3517932489451477
17277,2017-11-01,10L,892,720,1612,0.5533498759305211
17278,2017-11-01,10M,205,663,868,0.23617511520737328
17279,2017-11-01,10N,237,645,882,0.2687074829931973
17280,2017-11-01,10Q,2124,4334,6458,0.3288943945493961
17281,2017-11-01,10R,890,1032,1922,0.4630593132154006
17282,2017-11-01,10T,339,651,990,0.3424242424242424
17283,2017-11-01,10V,672,1319,1991,0.3375188347564038
17284,2017-11-01,10W,234,848,1082,0.21626617375231053
17285,2017-11-01,10X,947,1095,2042,0.46376101860920665
17286,2017-11-01,10Y,604,1609,2213,0.2729326705829191
17287,2017-11-01,11A,2571,2570,5141,0.5000972573429294
17288,2017-11-01,11C,443,918,1361,0.32549595885378396
17289,2017-11-01,11D,426,869,1295,0.32895752895752894
17290,2017-11-01,11E,636,1249,1885,0.3374005305039788
17291,2017-11-01,11H,1722,2479,4201,0.4099024041894787
17292,2017-11-01,11J,2266,5702,7968,0.2843875502008032
17293,2017-11-01,11M,2643,3470,6113,0.43235727138884344
17294,2017-11-01,11N,2268,3672,5940,0.38181818181818183
17295,2017-11-01,11T,1041,1219,2260,0.46061946902654866
17296,2017-11-01,11X,1721,2403,4124,0.4173132880698351
17297,2017-11-01,12A,1182,1145,2327,0.507950150408251
17298,2017-11-01,12D,772,1284,2056,0.3754863813229572
17299,2017-11-01,12F,1543,2056,3599,0.4287302028341206
17300,2017-11-01,13P,1612,4010,5622,0.28673070081821417
17301,2017-11-01,13T,1517,3075,4592,0.33035714285714285
17302,2017-11-01,14L,2304,2713,5017,0.4592385887980865
17303,2017-11-01,99A,1534,2594,4128,0.37160852713178294
17304,2017-11-01,99C,819,1248,2067,0.39622641509433965
17305,2017-11-01,99D,743,1216,1959,0.37927514037774374
17306,2017-11-01,99E,1503,964,2467,0.6092419943250912
17307,2017-11-01,99F,894,744,1638,0.5457875457875457
17308,2017-11-01,99G,780,691,1471,0.53025152957172
17309,2017-11-01,99H,886,1887,2773,0.31950955643707174
17310,2017-11-01,99J,1939,2910,4849,0.3998762631470406
17311,2017-11-01,99K,553,1145,1698,0.32567726737338043
17312,2017-11-01,99M,805,1281,2086,0.3859060402684564
17313,2017-11-01,99N,1978,3452,5430,0.3642725598526704
17314,2017-11-01,99P,3838,5529,9367,0.40973630831643004
17315,2017-11-01,99Q,1370,1495,2865,0.4781849912739965
